FIPS,Date,Population,Employed,Unemployed,UnemploymentRate
1001,1/1/19,26082,25100,982,3.8
1003,1/1/19,94645,90888,3757,4
1005,1/1/19,8411,7989,422,5
1007,1/1/19,8638,8264,374,4.3
1009,1/1/19,25051,24102,949,3.8
1011,1/1/19,4715,4470,245,5.2
1013,1/1/19,9139,8683,456,5
1015,1/1/19,46296,43901,2395,5.2
1017,1/1/19,15636,15004,632,4
1019,1/1/19,11567,11093,474,4.1
1021,1/1/19,19595,18841,754,3.8
1023,1/1/19,4974,4683,291,5.9
1025,1/1/19,7712,7135,577,7.5
1027,1/1/19,6096,5838,258,4.2
1029,1/1/19,5824,5534,290,5
1031,1/1/19,21350,20437,913,4.3
1033,1/1/19,23592,22391,1201,5.1
1035,1/1/19,4510,4271,239,5.3
1037,1/1/19,4514,4324,190,4.2
1039,1/1/19,15615,14854,761,4.9
1041,1/1/19,6343,6070,273,4.3
1043,1/1/19,38331,37004,1327,3.5
1045,1/1/19,20584,19650,934,4.5
1047,1/1/19,14843,13735,1108,7.5
1049,1/1/19,30425,29184,1241,4.1
1051,1/1/19,37496,36133,1363,3.6
1053,1/1/19,14556,13871,685,4.7
1055,1/1/19,42839,40935,1904,4.4
1057,1/1/19,6563,6280,283,4.3
1059,1/1/19,14539,13974,565,3.9
1061,1/1/19,10828,10350,478,4.4
1063,1/1/19,2858,2666,192,6.7
1065,1/1/19,5948,5632,316,5.3
1067,1/1/19,6863,6516,347,5.1
1069,1/1/19,45943,43972,1971,4.3
1071,1/1/19,23442,22368,1074,4.6
1073,1/1/19,317388,304826,12562,4
1075,1/1/19,5787,5544,243,4.2
1077,1/1/19,42392,40461,1931,4.6
1079,1/1/19,14191,13539,652,4.6
1081,1/1/19,75812,72886,2926,3.9
1083,1/1/19,43446,41806,1640,3.8
1085,1/1/19,3606,3320,286,7.9
1087,1/1/19,7779,7318,461,5.9
1089,1/1/19,183847,177176,6671,3.6
1091,1/1/19,7695,7310,385,5
1093,1/1/19,12856,12245,611,4.8
1095,1/1/19,43535,41984,1551,3.6
1097,1/1/19,189805,180274,9531,5
1099,1/1/19,7324,6840,484,6.6
1101,1/1/19,105867,101385,4482,4.2
1103,1/1/19,57824,55726,2098,3.6
1105,1/1/19,3386,3164,222,6.6
1107,1/1/19,7780,7411,369,4.7
1109,1/1/19,15359,14664,695,4.5
1111,1/1/19,9442,9059,383,4.1
1113,1/1/19,24031,23049,982,4.1
1115,1/1/19,40281,38754,1527,3.8
1117,1/1/19,115166,111603,3563,3.1
1119,1/1/19,4723,4453,270,5.7
1121,1/1/19,35832,34213,1619,4.5
1123,1/1/19,17982,17212,770,4.3
1125,1/1/19,103807,99978,3829,3.7
1127,1/1/19,25220,24058,1162,4.6
1129,1/1/19,6836,6389,447,6.5
1131,1/1/19,2765,2489,276,10
1133,1/1/19,9813,9355,458,4.7
2013,1/1/19,1759,1685,74,4.2
2016,1/1/19,4062,3924,138,3.4
2020,1/1/19,148049,140162,7887,5.3
2050,1/1/19,7055,6154,901,12.8
2060,1/1/19,237,199,38,16
2068,1/1/19,565,443,122,21.6
2070,1/1/19,1784,1623,161,9
2090,1/1/19,44741,41992,2749,6.1
2100,1/1/19,863,737,126,14.6
2105,1/1/19,1013,822,191,18.9
2110,1/1/19,16380,15517,863,5.3
2122,1/1/19,25390,23254,2136,8.4
2130,1/1/19,6271,5783,488,7.8
2150,1/1/19,5540,5020,520,9.4
2158,1/1/19,2775,2233,542,19.5
2164,1/1/19,609,533,76,12.5
2170,1/1/19,47470,43798,3672,7.7
2180,1/1/19,4118,3656,462,11.2
2185,1/1/19,3559,3350,209,5.9
2188,1/1/19,2796,2439,357,12.8
2195,1/1/19,1306,1135,171,13.1
2198,1/1/19,2752,2402,350,12.7
2220,1/1/19,3879,3673,206,5.3
2230,1/1/19,603,476,127,21.1
2240,1/1/19,2768,2463,305,11
2261,1/1/19,4066,3632,434,10.7
2275,1/1/19,957,863,94,9.8
2282,1/1/19,229,208,21,9.2
2290,1/1/19,2474,2085,389,15.7
4001,1/1/19,20760,18423,2337,11.3
4003,1/1/19,50071,46832,3239,6.5
4005,1/1/19,75917,70660,5257,6.9
4007,1/1/19,21528,20160,1368,6.4
4009,1/1/19,15127,14264,863,5.7
4011,1/1/19,4454,4250,204,4.6
4012,1/1/19,9646,9019,627,6.5
4013,1/1/19,2267023,2165161,101862,4.5
4015,1/1/19,86020,80480,5540,6.4
4017,1/1/19,40751,37090,3661,9
4019,1/1/19,493385,469270,24115,4.9
4021,1/1/19,185464,175513,9951,5.4
4023,1/1/19,20065,18418,1647,8.2
4025,1/1/19,104693,99456,5237,5
4027,1/1/19,101052,87004,14048,13.9
5001,1/1/19,9279,8904,375,4
5003,1/1/19,7802,7306,496,6.4
5005,1/1/19,16220,15392,828,5.1
5007,1/1/19,133327,128973,4354,3.3
5009,1/1/19,15793,15195,598,3.8
5011,1/1/19,4529,4289,240,5.3
5013,1/1/19,2446,2307,139,5.7
5015,1/1/19,12172,11547,625,5.1
5017,1/1/19,3323,3049,274,8.2
5019,1/1/19,9542,9130,412,4.3
5021,1/1/19,5728,5359,369,6.4
5023,1/1/19,9057,8553,504,5.6
5025,1/1/19,3194,3039,155,4.9
5027,1/1/19,9159,8703,456,5
5029,1/1/19,8107,7695,412,5.1
5031,1/1/19,54310,52475,1835,3.4
5033,1/1/19,26531,25482,1049,4
5035,1/1/19,21023,20006,1017,4.8
5037,1/1/19,7318,6933,385,5.3
5039,1/1/19,2842,2684,158,5.6
5041,1/1/19,5479,5197,282,5.1
5043,1/1/19,7880,7400,480,6.1
5045,1/1/19,61784,59548,2236,3.6
5047,1/1/19,7330,7044,286,3.9
5049,1/1/19,4867,4608,259,5.3
5051,1/1/19,40647,38780,1867,4.6
5053,1/1/19,8323,8010,313,3.8
5055,1/1/19,19780,18964,816,4.1
5057,1/1/19,9982,9547,435,4.4
5059,1/1/19,13697,13119,578,4.2
5061,1/1/19,5757,5533,224,3.9
5063,1/1/19,16408,15661,747,4.6
5065,1/1/19,4926,4583,343,7
5067,1/1/19,5874,5439,435,7.4
5069,1/1/19,27466,25749,1717,6.3
5071,1/1/19,10349,9799,550,5.3
5073,1/1/19,2482,2345,137,5.5
5075,1/1/19,6840,6514,326,4.8
5077,1/1/19,2870,2709,161,5.6
5079,1/1/19,3908,3713,195,5
5081,1/1/19,5433,5133,300,5.5
5083,1/1/19,8520,8105,415,4.9
5085,1/1/19,34041,32828,1213,3.6
5087,1/1/19,7244,7011,233,3.2
5089,1/1/19,6576,6245,331,5
5091,1/1/19,19421,18401,1020,5.3
5093,1/1/19,17125,16171,954,5.6
5095,1/1/19,2777,2646,131,4.7
5097,1/1/19,2943,2763,180,6.1
5099,1/1/19,3649,3507,142,3.9
5101,1/1/19,3308,3151,157,4.7
5103,1/1/19,9804,9167,637,6.5
5105,1/1/19,4250,4032,218,5.1
5107,1/1/19,6491,6047,444,6.8
5109,1/1/19,4232,4028,204,4.8
5111,1/1/19,10080,9652,428,4.2
5113,1/1/19,8047,7646,401,5
5115,1/1/19,28912,27400,1512,5.2
5117,1/1/19,3564,3369,195,5.5
5119,1/1/19,187970,180718,7252,3.9
5121,1/1/19,7150,6815,335,4.7
5123,1/1/19,8167,7655,512,6.3
5125,1/1/19,58502,56490,2012,3.4
5127,1/1/19,4317,4130,187,4.3
5129,1/1/19,2793,2646,147,5.3
5131,1/1/19,55808,53658,2150,3.9
5133,1/1/19,5528,5222,306,5.5
5135,1/1/19,5763,5404,359,6.2
5137,1/1/19,4706,4397,309,6.6
5139,1/1/19,15872,14968,904,5.7
5141,1/1/19,5717,5346,371,6.5
5143,1/1/19,121221,117667,3554,2.9
5145,1/1/19,33598,31746,1852,5.5
5147,1/1/19,2796,2618,178,6.4
5149,1/1/19,8469,8025,444,5.2
6001,1/1/19,842877,813986,28891,3.4
6003,1/1/19,717,687,30,4.2
6005,1/1/19,14587,13865,722,4.9
6007,1/1/19,100023,93161,6862,6.9
6009,1/1/19,20928,19913,1015,4.8
6011,1/1/19,10678,8571,2107,19.7
6013,1/1/19,561524,540929,20595,3.7
6015,1/1/19,9677,8970,707,7.3
6017,1/1/19,92251,88273,3978,4.3
6019,1/1/19,449808,409514,40294,9
6021,1/1/19,12964,11916,1048,8.1
6023,1/1/19,62376,59496,2880,4.6
6025,1/1/19,72194,58851,13343,18.5
6027,1/1/19,8685,8264,421,4.8
6029,1/1/19,392172,356892,35280,9
6031,1/1/19,58147,52491,5656,9.7
6033,1/1/19,29195,27276,1919,6.6
6035,1/1/19,9965,9365,600,6
6037,1/1/19,5094153,4837140,257013,5
6039,1/1/19,63068,57655,5413,8.6
6041,1/1/19,139175,135353,3822,2.7
6043,1/1/19,7167,6657,510,7.1
6045,1/1/19,38859,36806,2053,5.3
6047,1/1/19,116231,104524,11707,10.1
6049,1/1/19,3074,2720,354,11.5
6051,1/1/19,9144,8781,363,4
6053,1/1/19,210730,189403,21327,10.1
6055,1/1/19,71451,68576,2875,4
6057,1/1/19,49377,47367,2010,4.1
6059,1/1/19,1622747,1569604,53143,3.3
6061,1/1/19,187974,180951,7023,3.7
6063,1/1/19,7535,6668,867,11.5
6065,1/1/19,1107838,1055200,52638,4.8
6067,1/1/19,712574,681475,31099,4.4
6069,1/1/19,31414,29382,2032,6.5
6071,1/1/19,970552,927684,42868,4.4
6073,1/1/19,1592001,1531396,60605,3.8
6075,1/1/19,576013,560906,15107,2.6
6077,1/1/19,326840,303431,23409,7.2
6079,1/1/19,140327,135403,4924,3.5
6081,1/1/19,454586,443404,11182,2.5
6083,1/1/19,213047,201828,11219,5.3
6085,1/1/19,1049023,1018507,30516,2.9
6087,1/1/19,138565,129485,9080,6.6
6089,1/1/19,74687,70108,4579,6.1
6091,1/1/19,1256,1164,92,7.3
6093,1/1/19,17033,15469,1564,9.2
6095,1/1/19,209567,199807,9760,4.7
6097,1/1/19,257353,248749,8604,3.3
6099,1/1/19,242174,224318,17856,7.4
6101,1/1/19,44614,40245,4369,9.8
6103,1/1/19,25589,23774,1815,7.1
6105,1/1/19,4568,4231,337,7.4
6107,1/1/19,204329,181023,23306,11.4
6109,1/1/19,21110,19910,1200,5.7
6111,1/1/19,423431,404857,18574,4.4
6113,1/1/19,108649,102752,5897,5.4
6115,1/1/19,29583,27255,2328,7.9
8001,1/1/19,271280,260846,10434,3.8
8003,1/1/19,8346,7950,396,4.7
8005,1/1/19,362683,350149,12534,3.5
8007,1/1/19,6669,6382,287,4.3
8009,1/1/19,2093,2039,54,2.6
8011,1/1/19,1820,1745,75,4.1
8013,1/1/19,192618,186784,5834,3
8014,1/1/19,39876,38613,1263,3.2
8015,1/1/19,9409,9100,309,3.3
8017,1/1/19,1109,1086,23,2.1
8019,1/1/19,6008,5814,194,3.2
8021,1/1/19,3969,3756,213,5.4
8023,1/1/19,1801,1701,100,5.6
8025,1/1/19,1501,1420,81,5.4
8027,1/1/19,1986,1911,75,3.8
8029,1/1/19,14084,13417,667,4.7
8031,1/1/19,415024,400332,14692,3.5
8033,1/1/19,1081,1042,39,3.6
8035,1/1/19,192925,187077,5848,3
8037,1/1/19,38923,37883,1040,2.7
8039,1/1/19,14966,14516,450,3
8041,1/1/19,337564,323046,14518,4.3
8043,1/1/19,15054,14096,958,6.4
8045,1/1/19,33664,32428,1236,3.7
8047,1/1/19,3745,3639,106,2.8
8049,1/1/19,10602,10304,298,2.8
8051,1/1/19,11538,11197,341,3
8053,1/1/19,373,359,14,3.8
8055,1/1/19,2506,2289,217,8.7
8057,1/1/19,873,839,34,3.9
8059,1/1/19,333399,322242,11157,3.3
8061,1/1/19,885,867,18,2
8063,1/1/19,4185,4094,91,2.2
8065,1/1/19,5249,5116,133,2.5
8067,1/1/19,31678,30510,1168,3.7
8069,1/1/19,201194,194703,6491,3.2
8071,1/1/19,6503,6150,353,5.4
8073,1/1/19,2399,2325,74,3.1
8075,1/1/19,11041,10697,344,3.1
8077,1/1/19,75813,72040,3773,5
8079,1/1/19,595,581,14,2.4
8081,1/1/19,7562,7209,353,4.7
8083,1/1/19,12665,11766,899,7.1
8085,1/1/19,21574,20593,981,4.5
8087,1/1/19,16170,15652,518,3.2
8089,1/1/19,8320,7852,468,5.6
8091,1/1/19,2300,2207,93,4
8093,1/1/19,11105,10705,400,3.6
8095,1/1/19,2452,2396,56,2.3
8097,1/1/19,11495,11188,307,2.7
8099,1/1/19,6114,5886,228,3.7
8101,1/1/19,75567,71495,4072,5.4
8103,1/1/19,2900,2739,161,5.6
8105,1/1/19,5204,4886,318,6.1
8107,1/1/19,17199,16759,440,2.6
8109,1/1/19,3408,3216,192,5.6
8111,1/1/19,488,466,22,4.5
8113,1/1/19,6283,6131,152,2.4
8115,1/1/19,1156,1127,29,2.5
8117,1/1/19,25838,25323,515,2
8119,1/1/19,12629,12109,520,4.1
8121,1/1/19,2964,2892,72,2.4
8123,1/1/19,165772,160333,5439,3.3
8125,1/1/19,5994,5865,129,2.2
9001,1/1/19,477533,456112,21421,4.5
9003,1/1/19,479235,456983,22252,4.6
9005,1/1/19,104894,100089,4805,4.6
9007,1/1/19,92999,89102,3897,4.2
9009,1/1/19,455701,433995,21706,4.8
9011,1/1/19,135796,129604,6192,4.6
9013,1/1/19,86514,82864,3650,4.2
9015,1/1/19,63824,60497,3327,5.2
10001,1/1/19,79294,76090,3204,4
10003,1/1/19,300932,290053,10879,3.6
10005,1/1/19,103155,98357,4798,4.7
11001,1/1/19,405356,380285,25071,6.2
12001,1/1/19,138103,133050,5053,3.7
12003,1/1/19,11613,11169,444,3.8
12005,1/1/19,82853,77743,5110,6.2
12007,1/1/19,10838,10419,419,3.9
12009,1/1/19,278274,267408,10866,3.9
12011,1/1/19,1027387,989000,38387,3.7
12013,1/1/19,4804,4536,268,5.6
12015,1/1/19,71717,68569,3148,4.4
12017,1/1/19,47371,44593,2778,5.9
12019,1/1/19,105562,101598,3964,3.8
12021,1/1/19,184149,177647,6502,3.5
12023,1/1/19,29412,28232,1180,4
12027,1/1/19,14291,13666,625,4.4
12029,1/1/19,5832,5568,264,4.5
12031,1/1/19,481538,462811,18727,3.9
12033,1/1/19,142705,137027,5678,4
12035,1/1/19,46323,44174,2149,4.6
12037,1/1/19,4502,4265,237,5.3
12039,1/1/19,18511,17604,907,4.9
12041,1/1/19,7095,6803,292,4.1
12043,1/1/19,5553,5326,227,4.1
12045,1/1/19,5718,5282,436,7.6
12047,1/1/19,4236,4012,224,5.3
12049,1/1/19,8819,8339,480,5.4
12051,1/1/19,16075,15155,920,5.7
12053,1/1/19,70788,67201,3587,5.1
12055,1/1/19,36311,34359,1952,5.4
12057,1/1/19,739049,711571,27478,3.7
12059,1/1/19,6803,6491,312,4.6
12061,1/1/19,65424,62522,2902,4.4
12063,1/1/19,17104,16293,811,4.7
12065,1/1/19,5594,5369,225,4
12067,1/1/19,2909,2805,104,3.6
12069,1/1/19,155540,149379,6161,4
12071,1/1/19,345363,332392,12971,3.8
12073,1/1/19,154647,148805,5842,3.8
12075,1/1/19,16741,15984,757,4.5
12077,1/1/19,2620,2501,119,4.5
12079,1/1/19,7317,6986,331,4.5
12081,1/1/19,179315,172639,6676,3.7
12083,1/1/19,136277,129844,6433,4.7
12085,1/1/19,73331,70531,2800,3.8
12086,1/1/19,1395959,1353773,42186,3
12087,1/1/19,46267,45061,1206,2.6
12089,1/1/19,40399,38929,1470,3.6
12091,1/1/19,93175,89936,3239,3.5
12093,1/1/19,17846,17110,736,4.1
12095,1/1/19,745657,719142,26515,3.6
12097,1/1/19,180327,173161,7166,4
12099,1/1/19,729206,701058,28148,3.9
12101,1/1/19,233925,224030,9895,4.2
12103,1/1/19,485296,467658,17638,3.6
12105,1/1/19,301063,287766,13297,4.4
12107,1/1/19,26462,25086,1376,5.2
12109,1/1/19,129852,125535,4317,3.3
12111,1/1/19,143682,136944,6738,4.7
12113,1/1/19,81089,78083,3006,3.7
12115,1/1/19,188354,181328,7026,3.7
12117,1/1/19,249914,241057,8857,3.5
12119,1/1/19,32213,30434,1779,5.5
12121,1/1/19,17872,17134,738,4.1
12123,1/1/19,7954,7597,357,4.5
12125,1/1/19,4607,4439,168,3.6
12127,1/1/19,250282,239810,10472,4.2
12129,1/1/19,14837,14302,535,3.6
12131,1/1/19,30397,29276,1121,3.7
12133,1/1/19,9563,9116,447,4.7
13001,1/1/19,9404,8946,458,4.9
13003,1/1/19,4778,4622,156,3.3
13005,1/1/19,5059,4856,203,4
13007,1/1/19,1222,1150,72,5.9
13009,1/1/19,17437,16540,897,5.1
13011,1/1/19,9613,9293,320,3.3
13013,1/1/19,40030,38660,1370,3.4
13015,1/1/19,50280,48194,2086,4.1
13017,1/1/19,5455,5067,388,7.1
13019,1/1/19,7583,7267,316,4.2
13021,1/1/19,68338,65052,3286,4.8
13023,1/1/19,4590,4297,293,6.4
13025,1/1/19,7233,6872,361,5
13027,1/1/19,7054,6774,280,4
13029,1/1/19,18214,17555,659,3.6
13031,1/1/19,36759,35046,1713,4.7
13033,1/1/19,9370,8692,678,7.2
13035,1/1/19,10708,10234,474,4.4
13037,1/1/19,2339,2246,93,4
13039,1/1/19,20876,19942,934,4.5
13043,1/1/19,5558,5347,211,3.8
13045,1/1/19,54839,52538,2301,4.2
13047,1/1/19,33286,32044,1242,3.7
13049,1/1/19,4809,4593,216,4.5
13051,1/1/19,139132,133567,5565,4
13053,1/1/19,2049,1914,135,6.6
13055,1/1/19,10363,9905,458,4.4
13057,1/1/19,134349,129936,4413,3.3
13059,1/1/19,59338,56784,2554,4.3
13061,1/1/19,901,829,72,8
13063,1/1/19,137141,129969,7172,5.2
13065,1/1/19,2801,2664,137,4.9
13067,1/1/19,421122,405804,15318,3.6
13069,1/1/19,19106,18175,931,4.9
13071,1/1/19,22129,21300,829,3.7
13073,1/1/19,75006,72193,2813,3.8
13075,1/1/19,8032,7709,323,4
13077,1/1/19,73989,71310,2679,3.6
13079,1/1/19,5681,5423,258,4.5
13081,1/1/19,9438,8967,471,5
13083,1/1/19,8125,7809,316,3.9
13085,1/1/19,12219,11794,425,3.5
13087,1/1/19,11840,11291,549,4.6
13089,1/1/19,396112,379363,16749,4.2
13091,1/1/19,7189,6710,479,6.7
13093,1/1/19,5179,4941,238,4.6
13095,1/1/19,38371,36162,2209,5.8
13097,1/1/19,72539,69481,3058,4.2
13099,1/1/19,4361,4140,221,5.1
13101,1/1/19,1979,1916,63,3.2
13103,1/1/19,30771,29704,1067,3.5
13105,1/1/19,7836,7375,461,5.9
13107,1/1/19,8508,7917,591,6.9
13109,1/1/19,4904,4708,196,4
13111,1/1/19,11387,10929,458,4
13113,1/1/19,57493,55367,2126,3.7
13115,1/1/19,44397,42118,2279,5.1
13117,1/1/19,120863,116896,3967,3.3
13119,1/1/19,10243,9822,421,4.1
13121,1/1/19,552484,529051,23433,4.2
13123,1/1/19,11777,11258,519,4.4
13125,1/1/19,1294,1237,57,4.4
13127,1/1/19,38878,37230,1648,4.2
13129,1/1/19,27791,26622,1169,4.2
13131,1/1/19,10787,10369,418,3.9
13133,1/1/19,7018,6660,358,5.1
13135,1/1/19,484587,466992,17595,3.6
13137,1/1/19,19163,18382,781,4.1
13139,1/1/19,101643,98187,3456,3.4
13141,1/1/19,2520,2347,173,6.9
13143,1/1/19,12430,11941,489,3.9
13145,1/1/19,16724,16110,614,3.7
13147,1/1/19,11669,11150,519,4.4
13149,1/1/19,5214,5009,205,3.9
13151,1/1/19,114695,109727,4968,4.3
13153,1/1/19,70273,67356,2917,4.2
13155,1/1/19,3421,3201,220,6.4
13157,1/1/19,36288,35083,1205,3.3
13159,1/1/19,6928,6647,281,4.1
13161,1/1/19,6192,5844,348,5.6
13163,1/1/19,6686,6275,411,6.1
13165,1/1/19,3201,2961,240,7.5
13167,1/1/19,4170,3979,191,4.6
13169,1/1/19,13784,13260,524,3.8
13171,1/1/19,8166,7781,385,4.7
13173,1/1/19,3767,3591,176,4.7
13175,1/1/19,19588,18596,992,5.1
13177,1/1/19,14706,14140,566,3.8
13179,1/1/19,25876,24757,1119,4.3
13181,1/1/19,3618,3432,186,5.1
13183,1/1/19,8126,7795,331,4.1
13185,1/1/19,51315,49114,2201,4.3
13187,1/1/19,16580,15951,629,3.8
13189,1/1/19,8935,8341,594,6.6
13191,1/1/19,6170,5897,273,4.4
13193,1/1/19,4883,4583,300,6.1
13195,1/1/19,13320,12824,496,3.7
13197,1/1/19,3354,3163,191,5.7
13199,1/1/19,8879,8408,471,5.3
13201,1/1/19,2783,2676,107,3.8
13205,1/1/19,8625,8174,451,5.2
13207,1/1/19,13084,12566,518,4
13209,1/1/19,3855,3612,243,6.3
13211,1/1/19,9223,8875,348,3.8
13213,1/1/19,15759,14753,1006,6.4
13215,1/1/19,78263,73620,4643,5.9
13217,1/1/19,51918,49451,2467,4.8
13219,1/1/19,19534,18935,599,3.1
13221,1/1/19,7014,6734,280,4
13223,1/1/19,85237,82146,3091,3.6
13225,1/1/19,11942,11314,628,5.3
13227,1/1/19,15147,14581,566,3.7
13229,1/1/19,8751,8395,356,4.1
13231,1/1/19,8834,8509,325,3.7
13233,1/1/19,18388,17532,856,4.7
13235,1/1/19,4083,3892,191,4.7
13237,1/1/19,8249,7766,483,5.9
13239,1/1/19,809,759,50,6.2
13241,1/1/19,6956,6645,311,4.5
13243,1/1/19,2636,2475,161,6.1
13245,1/1/19,85665,80549,5116,6
13247,1/1/19,44486,42367,2119,4.8
13249,1/1/19,2171,2063,108,5
13251,1/1/19,5168,4843,325,6.3
13253,1/1/19,3073,2908,165,5.4
13255,1/1/19,28591,27121,1470,5.1
13257,1/1/19,10822,10283,539,5
13259,1/1/19,2425,2287,138,5.7
13261,1/1/19,12576,11819,757,6
13263,1/1/19,2828,2680,148,5.2
13265,1/1/19,573,535,38,6.6
13267,1/1/19,9777,9311,466,4.8
13269,1/1/19,2837,2667,170,6
13271,1/1/19,4410,3987,423,9.6
13273,1/1/19,3572,3314,258,7.2
13275,1/1/19,16973,16161,812,4.8
13277,1/1/19,19756,18897,859,4.3
13279,1/1/19,11845,11076,769,6.5
13281,1/1/19,3780,3559,221,5.8
13283,1/1/19,2739,2571,168,6.1
13285,1/1/19,36875,35493,1382,3.7
13287,1/1/19,3201,3053,148,4.6
13289,1/1/19,2922,2727,195,6.7
13291,1/1/19,10307,9901,406,3.9
13293,1/1/19,11302,10798,504,4.5
13295,1/1/19,31166,29857,1309,4.2
13297,1/1/19,45614,43934,1680,3.7
13299,1/1/19,15647,14959,688,4.4
13301,1/1/19,2820,2647,173,6.1
13303,1/1/19,7095,6724,371,5.2
13305,1/1/19,11466,10892,574,5
13307,1/1/19,1026,956,70,6.8
13309,1/1/19,1685,1547,138,8.2
13311,1/1/19,15965,15401,564,3.5
13313,1/1/19,44341,41611,2730,6.2
13315,1/1/19,2798,2655,143,5.1
13317,1/1/19,3844,3646,198,5.2
13319,1/1/19,3914,3739,175,4.5
13321,1/1/19,9035,8549,486,5.4
15001,1/1/19,90263,87050,3213,3.6
15003,1/1/19,453323,440926,12397,2.7
15007,1/1/19,36443,35400,1043,2.9
15009,1/1/19,87637,85165,2472,2.8
16001,1/1/19,250407,242312,8095,3.2
16003,1/1/19,1716,1567,149,8.7
16005,1/1/19,41806,40227,1579,3.8
16007,1/1/19,2885,2732,153,5.3
16009,1/1/19,4002,3790,212,5.3
16011,1/1/19,22831,21959,872,3.8
16013,1/1/19,12574,12164,410,3.3
16015,1/1/19,3511,3300,211,6
16017,1/1/19,20099,18954,1145,5.7
16019,1/1/19,55959,54055,1904,3.4
16021,1/1/19,5196,4845,351,6.8
16023,1/1/19,1344,1291,53,3.9
16025,1/1/19,681,652,29,4.3
16027,1/1/19,102563,98018,4545,4.4
16029,1/1/19,3896,3737,159,4.1
16031,1/1/19,11668,11297,371,3.2
16033,1/1/19,348,329,19,5.5
16035,1/1/19,2872,2643,229,8
16037,1/1/19,2020,1877,143,7.1
16039,1/1/19,11282,10746,536,4.8
16041,1/1/19,6883,6659,224,3.3
16043,1/1/19,7601,7329,272,3.6
16045,1/1/19,8161,7787,374,4.6
16047,1/1/19,8099,7787,312,3.9
16049,1/1/19,6362,5935,427,6.7
16051,1/1/19,13616,13146,470,3.5
16053,1/1/19,12024,11564,460,3.8
16055,1/1/19,78700,74710,3990,5.1
16057,1/1/19,20284,19604,680,3.4
16059,1/1/19,3474,3203,271,7.8
16061,1/1/19,1557,1437,120,7.7
16063,1/1/19,2729,2566,163,6
16065,1/1/19,21465,20955,510,2.4
16067,1/1/19,10872,10476,396,3.6
16069,1/1/19,20863,20075,788,3.8
16071,1/1/19,2278,2199,79,3.5
16073,1/1/19,5243,4963,280,5.3
16075,1/1/19,11469,10907,562,4.9
16077,1/1/19,3746,3549,197,5.3
16079,1/1/19,5267,4855,412,7.8
16081,1/1/19,6168,5987,181,2.9
16083,1/1/19,40990,39382,1608,3.9
16085,1/1/19,5585,5242,343,6.1
16087,1/1/19,4494,4233,261,5.8
17001,1/1/19,32475,30982,1493,4.6
17003,1/1/19,2067,1912,155,7.5
17005,1/1/19,7800,7356,444,5.7
17007,1/1/19,26805,24815,1990,7.4
17009,1/1/19,2942,2849,93,3.2
17011,1/1/19,17310,16091,1219,7
17013,1/1/19,2328,2176,152,6.5
17015,1/1/19,7205,6743,462,6.4
17017,1/1/19,6137,5779,358,5.8
17019,1/1/19,104837,99436,5401,5.2
17021,1/1/19,14641,13692,949,6.5
17023,1/1/19,7720,7233,487,6.3
17025,1/1/19,6552,6141,411,6.3
17027,1/1/19,20416,19486,930,4.6
17029,1/1/19,24468,23158,1310,5.4
17031,1/1/19,2591416,2468130,123286,4.8
17033,1/1/19,8581,8035,546,6.4
17035,1/1/19,6163,5828,335,5.4
17037,1/1/19,55100,52048,3052,5.5
17039,1/1/19,7519,7013,506,6.7
17041,1/1/19,10088,9611,477,4.7
17043,1/1/19,506276,487339,18937,3.7
17045,1/1/19,9198,8656,542,5.9
17047,1/1/19,2721,2566,155,5.7
17049,1/1/19,19295,18409,886,4.6
17051,1/1/19,9864,9203,661,6.7
17053,1/1/19,6242,5851,391,6.3
17055,1/1/19,16466,15242,1224,7.4
17057,1/1/19,15241,14015,1226,8
17059,1/1/19,2356,2207,149,6.3
17061,1/1/19,5958,5601,357,6
17063,1/1/19,25704,24000,1704,6.6
17065,1/1/19,4485,4243,242,5.4
17067,1/1/19,8373,7865,508,6.1
17069,1/1/19,1326,1201,125,9.4
17071,1/1/19,3614,3333,281,7.8
17073,1/1/19,25153,23511,1642,6.5
17075,1/1/19,14254,13367,887,6.2
17077,1/1/19,27799,26347,1452,5.2
17079,1/1/19,4603,4315,288,6.3
17081,1/1/19,17700,16659,1041,5.9
17083,1/1/19,11043,10352,691,6.3
17085,1/1/19,10779,10055,724,6.7
17087,1/1/19,4226,3833,393,9.3
17089,1/1/19,274781,257109,17672,6.4
17091,1/1/19,56146,52132,4014,7.1
17093,1/1/19,68579,65536,3043,4.4
17095,1/1/19,21695,20204,1491,6.9
17097,1/1/19,378176,355492,22684,6
17099,1/1/19,55739,51263,4476,8
17101,1/1/19,6026,5596,430,7.1
17103,1/1/19,17771,16795,976,5.5
17105,1/1/19,16359,15406,953,5.8
17107,1/1/19,12748,12004,744,5.8
17109,1/1/19,13512,12768,744,5.5
17111,1/1/19,165768,158167,7601,4.6
17113,1/1/19,88092,83668,4424,5
17115,1/1/19,48896,45633,3263,6.7
17117,1/1/19,23116,21672,1444,6.2
17119,1/1/19,134422,127351,7071,5.3
17121,1/1/19,17912,16881,1031,5.8
17123,1/1/19,5392,5013,379,7
17125,1/1/19,6317,5825,492,7.8
17127,1/1/19,5629,5203,426,7.6
17129,1/1/19,6564,6178,386,5.9
17131,1/1/19,8239,7581,658,8
17133,1/1/19,18749,17966,783,4.2
17135,1/1/19,11918,10983,935,7.8
17137,1/1/19,16398,15456,942,5.7
17139,1/1/19,7563,7217,346,4.6
17141,1/1/19,25496,23771,1725,6.8
17143,1/1/19,85880,80012,5868,6.8
17145,1/1/19,8400,7834,566,6.7
17147,1/1/19,8320,7857,463,5.6
17149,1/1/19,6977,6517,460,6.6
17151,1/1/19,1708,1580,128,7.5
17153,1/1/19,1976,1788,188,9.5
17155,1/1/19,3075,2836,239,7.8
17157,1/1/19,14308,13585,723,5.1
17159,1/1/19,7228,6829,399,5.5
17161,1/1/19,71902,67178,4724,6.6
17163,1/1/19,126892,119514,7378,5.8
17165,1/1/19,9808,9116,692,7.1
17167,1/1/19,101554,95965,5589,5.5
17169,1/1/19,3242,3044,198,6.1
17171,1/1/19,2517,2315,202,8
17173,1/1/19,10719,10124,595,5.6
17175,1/1/19,2552,2353,199,7.8
17177,1/1/19,21528,20242,1286,6
17179,1/1/19,64531,60464,4067,6.3
17181,1/1/19,7453,6805,648,8.7
17183,1/1/19,33114,30938,2176,6.6
17185,1/1/19,5685,5391,294,5.2
17187,1/1/19,8593,8127,466,5.4
17189,1/1/19,10157,9817,340,3.3
17191,1/1/19,6858,6409,449,6.5
17193,1/1/19,6714,6383,331,4.9
17195,1/1/19,28809,27136,1673,5.8
17197,1/1/19,357722,339455,18267,5.1
17199,1/1/19,31893,30028,1865,5.8
17201,1/1/19,141462,132075,9387,6.6
17203,1/1/19,18934,17882,1052,5.6
18001,1/1/19,17448,16850,598,3.4
18003,1/1/19,185702,178592,7110,3.8
18005,1/1/19,44989,43493,1496,3.3
18007,1/1/19,4586,4385,201,4.4
18009,1/1/19,5177,4898,279,5.4
18011,1/1/19,36234,35065,1169,3.2
18013,1/1/19,7727,7412,315,4.1
18015,1/1/19,10289,9871,418,4.1
18017,1/1/19,18032,17200,832,4.6
18019,1/1/19,61842,59249,2593,4.2
18021,1/1/19,12140,11583,557,4.6
18023,1/1/19,17220,16617,603,3.5
18025,1/1/19,4946,4635,311,6.3
18027,1/1/19,16704,16121,583,3.5
18029,1/1/19,25850,24646,1204,4.7
18031,1/1/19,15363,14765,598,3.9
18033,1/1/19,22678,21877,801,3.5
18035,1/1/19,54843,52157,2686,4.9
18037,1/1/19,23128,22398,730,3.2
18039,1/1/19,115366,110819,4547,3.9
18041,1/1/19,9059,8547,512,5.7
18043,1/1/19,41779,40075,1704,4.1
18045,1/1/19,8048,7673,375,4.7
18047,1/1/19,11386,10851,535,4.7
18049,1/1/19,9864,9425,439,4.5
18051,1/1/19,19442,18819,623,3.2
18053,1/1/19,31157,29669,1488,4.8
18055,1/1/19,13929,13135,794,5.7
18057,1/1/19,183632,177708,5924,3.2
18059,1/1/19,40274,38796,1478,3.7
18061,1/1/19,20403,19524,879,4.3
18063,1/1/19,90029,86861,3168,3.5
18065,1/1/19,22214,21259,955,4.3
18067,1/1/19,37176,35376,1800,4.8
18069,1/1/19,18321,17498,823,4.5
18071,1/1/19,22940,22146,794,3.5
18073,1/1/19,16441,15585,856,5.2
18075,1/1/19,9634,9233,401,4.2
18077,1/1/19,15308,14656,652,4.3
18079,1/1/19,13575,12921,654,4.8
18081,1/1/19,82957,80083,2874,3.5
18083,1/1/19,18587,17837,750,4
18085,1/1/19,42558,41009,1549,3.6
18087,1/1/19,20202,19416,786,3.9
18089,1/1/19,232150,218123,14027,6
18091,1/1/19,48159,45409,2750,5.7
18093,1/1/19,21378,20390,988,4.6
18095,1/1/19,59373,56507,2866,4.8
18097,1/1/19,490663,470853,19810,4
18099,1/1/19,23312,22303,1009,4.3
18101,1/1/19,5341,5153,188,3.5
18103,1/1/19,15633,14891,742,4.7
18105,1/1/19,70698,67586,3112,4.4
18107,1/1/19,18810,18082,728,3.9
18109,1/1/19,36438,34928,1510,4.1
18111,1/1/19,7039,6636,403,5.7
18113,1/1/19,23866,22847,1019,4.3
18115,1/1/19,3194,3045,149,4.7
18117,1/1/19,8871,8483,388,4.4
18119,1/1/19,9478,8968,510,5.4
18121,1/1/19,6982,6643,339,4.9
18123,1/1/19,9354,8933,421,4.5
18125,1/1/19,6120,5861,259,4.2
18127,1/1/19,87326,83157,4169,4.8
18129,1/1/19,13687,13208,479,3.5
18131,1/1/19,6585,6336,249,3.8
18133,1/1/19,16813,16062,751,4.5
18135,1/1/19,11286,10744,542,4.8
18137,1/1/19,14329,13700,629,4.4
18139,1/1/19,8993,8659,334,3.7
18141,1/1/19,137537,131472,6065,4.4
18143,1/1/19,10606,10120,486,4.6
18145,1/1/19,23154,22298,856,3.7
18147,1/1/19,10406,9950,456,4.4
18149,1/1/19,9940,9342,598,6
18151,1/1/19,20597,19872,725,3.5
18153,1/1/19,8497,8002,495,5.8
18155,1/1/19,5044,4824,220,4.4
18157,1/1/19,99487,95710,3777,3.8
18159,1/1/19,9342,9015,327,3.5
18161,1/1/19,3551,3404,147,4.1
18163,1/1/19,95151,91532,3619,3.8
18165,1/1/19,7107,6605,502,7.1
18167,1/1/19,48752,46014,2738,5.6
18169,1/1/19,14920,14297,623,4.2
18171,1/1/19,4197,4037,160,3.8
18173,1/1/19,33263,32047,1216,3.7
18175,1/1/19,13772,13144,628,4.6
18177,1/1/19,31151,29745,1406,4.5
18179,1/1/19,14449,13917,532,3.7
18181,1/1/19,13498,12976,522,3.9
18183,1/1/19,17787,17121,666,3.7
19001,1/1/19,4204,4074,130,3.1
19003,1/1/19,2166,2117,49,2.3
19005,1/1/19,7488,7050,438,5.8
19007,1/1/19,6022,5718,304,5
19009,1/1/19,3233,3125,108,3.3
19011,1/1/19,13629,13099,530,3.9
19013,1/1/19,69063,66529,2534,3.7
19015,1/1/19,14851,14412,439,3
19017,1/1/19,13943,13532,411,2.9
19019,1/1/19,11356,10932,424,3.7
19021,1/1/19,11755,11477,278,2.4
19023,1/1/19,7915,7552,363,4.6
19025,1/1/19,4286,4140,146,3.4
19027,1/1/19,10898,10654,244,2.2
19029,1/1/19,6954,6676,278,4
19031,1/1/19,10928,10552,376,3.4
19033,1/1/19,23533,22714,819,3.5
19035,1/1/19,6231,6048,183,2.9
19037,1/1/19,6599,6332,267,4
19039,1/1/19,4948,4749,199,4
19041,1/1/19,8602,8291,311,3.6
19043,1/1/19,10330,9685,645,6.2
19045,1/1/19,22790,21786,1004,4.4
19047,1/1/19,8275,7852,423,5.1
19049,1/1/19,49040,47914,1126,2.3
19051,1/1/19,4239,4088,151,3.6
19053,1/1/19,4388,4259,129,2.9
19055,1/1/19,10515,10172,343,3.3
19057,1/1/19,19387,18517,870,4.5
19059,1/1/19,9334,8849,485,5.2
19061,1/1/19,56443,54405,2038,3.6
19063,1/1/19,5280,5097,183,3.5
19065,1/1/19,10785,10252,533,4.9
19067,1/1/19,9049,8735,314,3.5
19069,1/1/19,5772,5577,195,3.4
19071,1/1/19,3726,3621,105,2.8
19073,1/1/19,5430,5304,126,2.3
19075,1/1/19,6600,6358,242,3.7
19077,1/1/19,5646,5417,229,4.1
19079,1/1/19,6973,6713,260,3.7
19081,1/1/19,5944,5785,159,2.7
19083,1/1/19,8221,7857,364,4.4
19085,1/1/19,7370,7130,240,3.3
19087,1/1/19,9758,9444,314,3.2
19089,1/1/19,5323,5094,229,4.3
19091,1/1/19,5190,5012,178,3.4
19093,1/1/19,4246,4123,123,2.9
19095,1/1/19,10633,10289,344,3.2
19097,1/1/19,11138,10638,500,4.5
19099,1/1/19,19587,18856,731,3.7
19101,1/1/19,9980,9691,289,2.9
19103,1/1/19,86127,84200,1927,2.2
19105,1/1/19,10864,10358,506,4.7
19107,1/1/19,5295,5067,228,4.3
19109,1/1/19,8502,8245,257,3
19111,1/1/19,16083,15377,706,4.4
19113,1/1/19,122168,117866,4302,3.5
19115,1/1/19,6028,5794,234,3.9
19117,1/1/19,4674,4560,114,2.4
19119,1/1/19,7068,6900,168,2.4
19121,1/1/19,8618,8175,443,5.1
19123,1/1/19,11772,11441,331,2.8
19125,1/1/19,17907,17427,480,2.7
19127,1/1/19,18334,17033,1301,7.1
19129,1/1/19,7352,7150,202,2.7
19131,1/1/19,6277,6144,133,2.1
19133,1/1/19,4492,4314,178,4
19135,1/1/19,4040,3873,167,4.1
19137,1/1/19,5031,4866,165,3.3
19139,1/1/19,21575,20770,805,3.7
19141,1/1/19,8264,8037,227,2.7
19143,1/1/19,3581,3498,83,2.3
19145,1/1/19,6461,6273,188,2.9
19147,1/1/19,4843,4705,138,2.8
19149,1/1/19,14798,14406,392,2.6
19151,1/1/19,4307,4196,111,2.6
19153,1/1/19,266989,257646,9343,3.5
19155,1/1/19,48204,46697,1507,3.1
19157,1/1/19,9786,9430,356,3.6
19159,1/1/19,2535,2439,96,3.8
19161,1/1/19,5325,5145,180,3.4
19163,1/1/19,88487,85056,3431,3.9
19165,1/1/19,6727,6542,185,2.8
19167,1/1/19,21145,20572,573,2.7
19169,1/1/19,57139,55955,1184,2.1
19171,1/1/19,9674,9202,472,4.9
19173,1/1/19,3245,3174,71,2.2
19175,1/1/19,6283,6006,277,4.4
19177,1/1/19,3716,3586,130,3.5
19179,1/1/19,17923,17224,699,3.9
19181,1/1/19,28106,27182,924,3.3
19183,1/1/19,12140,11723,417,3.4
19185,1/1/19,2840,2739,101,3.6
19187,1/1/19,19335,18580,755,3.9
19189,1/1/19,5121,4968,153,3
19191,1/1/19,11412,10820,592,5.2
19193,1/1/19,55519,53611,1908,3.4
19195,1/1/19,4213,4046,167,4
19197,1/1/19,6584,6366,218,3.3
20001,1/1/19,6436,6178,258,4
20003,1/1/19,4020,3858,162,4
20005,1/1/19,7052,6721,331,4.7
20007,1/1/19,2309,2248,61,2.6
20009,1/1/19,13697,13162,535,3.9
20011,1/1/19,6827,6488,339,5
20013,1/1/19,5412,5224,188,3.5
20015,1/1/19,32151,30992,1159,3.6
20017,1/1/19,1446,1400,46,3.2
20019,1/1/19,1414,1346,68,4.8
20021,1/1/19,10080,9698,382,3.8
20023,1/1/19,1318,1282,36,2.7
20025,1/1/19,1069,1041,28,2.6
20027,1/1/19,3786,3647,139,3.7
20029,1/1/19,3754,3617,137,3.6
20031,1/1/19,4052,3809,243,6
20033,1/1/19,858,833,25,2.9
20035,1/1/19,16278,15678,600,3.7
20037,1/1/19,18820,17999,821,4.4
20039,1/1/19,1243,1202,41,3.3
20041,1/1/19,8985,8607,378,4.2
20043,1/1/19,4131,3967,164,4
20045,1/1/19,63869,61661,2208,3.5
20047,1/1/19,1494,1449,45,3
20049,1/1/19,1178,1128,50,4.2
20051,1/1/19,16916,16463,453,2.7
20053,1/1/19,2718,2639,79,2.9
20055,1/1/19,20800,20268,532,2.6
20057,1/1/19,17052,16574,478,2.8
20059,1/1/19,14013,13459,554,4
20061,1/1/19,11239,10651,588,5.2
20063,1/1/19,1454,1419,35,2.4
20065,1/1/19,1117,1077,40,3.6
20067,1/1/19,3224,3125,99,3.1
20069,1/1/19,3287,3214,73,2.2
20071,1/1/19,825,807,18,2.2
20073,1/1/19,3202,3081,121,3.8
20075,1/1/19,1647,1612,35,2.1
20077,1/1/19,2796,2717,79,2.8
20079,1/1/19,16841,16264,577,3.4
20081,1/1/19,2253,2198,55,2.4
20083,1/1/19,973,947,26,2.7
20085,1/1/19,7137,6881,256,3.6
20087,1/1/19,10044,9674,370,3.7
20089,1/1/19,1303,1263,40,3.1
20091,1/1/19,335229,324659,10570,3.2
20093,1/1/19,2048,2000,48,2.3
20095,1/1/19,3412,3293,119,3.5
20097,1/1/19,1302,1266,36,2.8
20099,1/1/19,10199,9783,416,4.1
20101,1/1/19,774,753,21,2.7
20103,1/1/19,36230,34746,1484,4.1
20105,1/1/19,1772,1721,51,2.9
20107,1/1/19,4443,4119,324,7.3
20109,1/1/19,1632,1592,40,2.5
20111,1/1/19,16548,15860,688,4.2
20113,1/1/19,16809,16369,440,2.6
20115,1/1/19,6062,5869,193,3.2
20117,1/1/19,5472,5285,187,3.4
20119,1/1/19,2166,2110,56,2.6
20121,1/1/19,17367,16661,706,4.1
20123,1/1/19,3441,3355,86,2.5
20125,1/1/19,14715,14052,663,4.5
20127,1/1/19,2968,2879,89,3
20129,1/1/19,1157,1117,40,3.5
20131,1/1/19,5413,5263,150,2.8
20133,1/1/19,6046,5752,294,4.9
20135,1/1/19,1333,1295,38,2.9
20137,1/1/19,2710,2644,66,2.4
20139,1/1/19,7965,7590,375,4.7
20141,1/1/19,2065,2010,55,2.7
20143,1/1/19,3024,2928,96,3.2
20145,1/1/19,2893,2789,104,3.6
20147,1/1/19,2705,2621,84,3.1
20149,1/1/19,11769,11339,430,3.7
20151,1/1/19,4903,4753,150,3.1
20153,1/1/19,1490,1455,35,2.3
20155,1/1/19,29431,28345,1086,3.7
20157,1/1/19,2272,2204,68,3
20159,1/1/19,5186,5017,169,3.3
20161,1/1/19,33092,31947,1145,3.5
20163,1/1/19,2551,2460,91,3.6
20165,1/1/19,1603,1548,55,3.4
20167,1/1/19,3380,3268,112,3.3
20169,1/1/19,30201,29158,1043,3.5
20171,1/1/19,2824,2766,58,2.1
20173,1/1/19,248819,238819,10000,4
20175,1/1/19,9585,9264,321,3.3
20177,1/1/19,89827,86282,3545,3.9
20179,1/1/19,1433,1395,38,2.7
20181,1/1/19,2885,2801,84,2.9
20183,1/1/19,2029,1974,55,2.7
20185,1/1/19,2031,1976,55,2.7
20187,1/1/19,987,962,25,2.5
20189,1/1/19,2566,2492,74,2.9
20191,1/1/19,10829,10411,418,3.9
20193,1/1/19,4329,4220,109,2.5
20195,1/1/19,1415,1365,50,3.5
20197,1/1/19,3653,3506,147,4
20199,1/1/19,810,787,23,2.8
20201,1/1/19,2901,2797,104,3.6
20203,1/1/19,1438,1407,31,2.2
20205,1/1/19,3938,3769,169,4.3
20207,1/1/19,1584,1498,86,5.4
20209,1/1/19,76884,72913,3971,5.2
21001,1/1/19,7064,6637,427,6
21003,1/1/19,8825,8432,393,4.5
21005,1/1/19,11660,11199,461,4
21007,1/1/19,3496,3240,256,7.3
21009,1/1/19,18724,17738,986,5.3
21011,1/1/19,4643,4269,374,8.1
21013,1/1/19,8473,7918,555,6.6
21015,1/1/19,70153,67472,2681,3.8
21017,1/1/19,9626,9189,437,4.5
21019,1/1/19,17810,16628,1182,6.6
21021,1/1/19,12616,11995,621,4.9
21023,1/1/19,3835,3582,253,6.6
21025,1/1/19,3578,3281,297,8.3
21027,1/1/19,7851,7351,500,6.4
21029,1/1/19,42467,40582,1885,4.4
21031,1/1/19,5051,4770,281,5.6
21033,1/1/19,5420,5127,293,5.4
21035,1/1/19,18681,17858,823,4.4
21037,1/1/19,50306,48277,2029,4
21039,1/1/19,2179,2070,109,5
21041,1/1/19,5295,5058,237,4.5
21043,1/1/19,9968,8913,1055,10.6
21045,1/1/19,6736,6423,313,4.6
21047,1/1/19,24456,23130,1326,5.4
21049,1/1/19,16979,16227,752,4.4
21051,1/1/19,5187,4813,374,7.2
21053,1/1/19,3895,3645,250,6.4
21055,1/1/19,3792,3562,230,6.1
21057,1/1/19,3121,2936,185,5.9
21059,1/1/19,47030,45001,2029,4.3
21061,1/1/19,4778,4475,303,6.3
21063,1/1/19,2057,1835,222,10.8
21065,1/1/19,5329,5019,310,5.8
21067,1/1/19,172500,166332,6168,3.6
21069,1/1/19,6164,5777,387,6.3
21071,1/1/19,10999,10232,767,7
21073,1/1/19,24462,23473,989,4
21075,1/1/19,2077,1886,191,9.2
21077,1/1/19,4050,3857,193,4.8
21079,1/1/19,7654,7266,388,5.1
21081,1/1/19,11666,11069,597,5.1
21083,1/1/19,15652,14840,812,5.2
21085,1/1/19,10863,10273,590,5.4
21087,1/1/19,5080,4846,234,4.6
21089,1/1/19,13421,12372,1049,7.8
21091,1/1/19,3946,3777,169,4.3
21093,1/1/19,48777,46615,2162,4.4
21095,1/1/19,6623,6124,499,7.5
21097,1/1/19,8637,8219,418,4.8
21099,1/1/19,7950,7557,393,4.9
21101,1/1/19,21890,20998,892,4.1
21103,1/1/19,8165,7825,340,4.2
21105,1/1/19,1771,1664,107,6
21107,1/1/19,18307,17418,889,4.9
21109,1/1/19,4066,3758,308,7.6
21111,1/1/19,396934,379961,16973,4.3
21113,1/1/19,26229,25171,1058,4
21115,1/1/19,6753,6231,522,7.7
21117,1/1/19,86889,83374,3515,4
21119,1/1/19,4397,4081,316,7.2
21121,1/1/19,9898,9277,621,6.3
21123,1/1/19,5971,5668,303,5.1
21125,1/1/19,24603,23301,1302,5.3
21127,1/1/19,5125,4694,431,8.4
21129,1/1/19,2074,1943,131,6.3
21131,1/1/19,2590,2421,169,6.5
21133,1/1/19,6253,5788,465,7.4
21135,1/1/19,4716,4208,508,10.8
21137,1/1/19,9428,8869,559,5.9
21139,1/1/19,3671,3369,302,8.2
21141,1/1/19,12487,11973,514,4.1
21143,1/1/19,2999,2806,193,6.4
21145,1/1/19,28796,27141,1655,5.7
21147,1/1/19,4710,4379,331,7
21149,1/1/19,4188,3972,216,5.2
21151,1/1/19,46803,44900,1903,4.1
21153,1/1/19,3065,2634,431,14.1
21155,1/1/19,9666,9260,406,4.2
21157,1/1/19,14700,13807,893,6.1
21159,1/1/19,2731,2538,193,7.1
21161,1/1/19,7145,6654,491,6.9
21163,1/1/19,12217,11600,617,5.1
21165,1/1/19,2344,2128,216,9.2
21167,1/1/19,9775,9282,493,5
21169,1/1/19,4046,3850,196,4.8
21171,1/1/19,4664,4454,210,4.5
21173,1/1/19,11621,10903,718,6.2
21175,1/1/19,4535,4213,322,7.1
21177,1/1/19,10422,9723,699,6.7
21179,1/1/19,22922,21661,1261,5.5
21181,1/1/19,3230,3070,160,5
21183,1/1/19,9770,9199,571,5.8
21185,1/1/19,33035,31858,1177,3.6
21187,1/1/19,5053,4751,302,6
21189,1/1/19,1143,1049,94,8.2
21191,1/1/19,6950,6620,330,4.7
21193,1/1/19,8121,7602,519,6.4
21195,1/1/19,19877,18637,1240,6.2
21197,1/1/19,4964,4633,331,6.7
21199,1/1/19,26257,24886,1371,5.2
21201,1/1/19,810,756,54,6.7
21203,1/1/19,6631,6279,352,5.3
21205,1/1/19,10246,9640,606,5.9
21207,1/1/19,6174,5750,424,6.9
21209,1/1/19,28722,27633,1089,3.8
21211,1/1/19,25238,24337,901,3.6
21213,1/1/19,8851,8479,372,4.2
21215,1/1/19,10128,9740,388,3.8
21217,1/1/19,12565,12007,558,4.4
21219,1/1/19,5327,5100,227,4.3
21221,1/1/19,5909,5596,313,5.3
21223,1/1/19,3850,3665,185,4.8
21225,1/1/19,6063,5764,299,4.9
21227,1/1/19,63801,61073,2728,4.3
21229,1/1/19,6141,5867,274,4.5
21231,1/1/19,7432,6910,522,7
21233,1/1/19,5732,5488,244,4.3
21235,1/1/19,13650,12916,734,5.4
21237,1/1/19,1912,1743,169,8.8
21239,1/1/19,14600,14119,481,3.3
22001,1/1/19,23515,22160,1355,5.8
22003,1/1/19,8795,8235,560,6.4
22005,1/1/19,63873,61046,2827,4.4
22007,1/1/19,8849,8228,621,7
22009,1/1/19,14901,13973,928,6.2
22011,1/1/19,14338,13526,812,5.7
22013,1/1/19,5471,5112,359,6.6
22015,1/1/19,57238,54657,2581,4.5
22017,1/1/19,102893,97015,5878,5.7
22019,1/1/19,105875,101389,4486,4.2
22021,1/1/19,3829,3565,264,6.9
22023,1/1/19,3925,3772,153,3.9
22025,1/1/19,3265,3027,238,7.3
22027,1/1/19,5786,5460,326,5.6
22029,1/1/19,6844,6357,487,7.1
22031,1/1/19,10774,10110,664,6.2
22033,1/1/19,230060,219356,10704,4.7
22035,1/1/19,1909,1690,219,11.5
22037,1/1/19,7943,7548,395,5
22039,1/1/19,11796,11082,714,6.1
22041,1/1/19,7172,6582,590,8.2
22043,1/1/19,8096,7573,523,6.5
22045,1/1/19,27644,26036,1608,5.8
22047,1/1/19,14023,13141,882,6.3
22049,1/1/19,6711,6372,339,5.1
22051,1/1/19,211878,202258,9620,4.5
22053,1/1/19,13018,12349,669,5.1
22055,1/1/19,112118,106898,5220,4.7
22057,1/1/19,41165,39084,2081,5.1
22059,1/1/19,6584,6302,282,4.3
22061,1/1/19,21834,20565,1269,5.8
22063,1/1/19,68509,65506,3003,4.4
22065,1/1/19,3433,3131,302,8.8
22067,1/1/19,10022,9089,933,9.3
22069,1/1/19,15759,14638,1121,7.1
22071,1/1/19,177160,167866,9294,5.2
22073,1/1/19,69997,65999,3998,5.7
22075,1/1/19,9927,9467,460,4.6
22077,1/1/19,9824,9236,588,6
22079,1/1/19,54646,51563,3083,5.6
22081,1/1/19,3694,3506,188,5.1
22083,1/1/19,8190,7632,558,6.8
22085,1/1/19,8942,8440,502,5.6
22087,1/1/19,19618,18585,1033,5.3
22089,1/1/19,24892,23759,1133,4.6
22091,1/1/19,4279,3983,296,6.9
22093,1/1/19,9184,8583,601,6.5
22095,1/1/19,19506,18347,1159,5.9
22097,1/1/19,31360,29256,2104,6.7
22099,1/1/19,21965,20756,1209,5.5
22101,1/1/19,19714,18477,1237,6.3
22103,1/1/19,118036,112711,5325,4.5
22105,1/1/19,53702,50410,3292,6.1
22107,1/1/19,1355,1249,106,7.8
22109,1/1/19,45391,43014,2377,5.2
22111,1/1/19,9080,8489,591,6.5
22113,1/1/19,23727,22385,1342,5.7
22115,1/1/19,15993,14875,1118,7
22117,1/1/19,16836,15775,1061,6.3
22119,1/1/19,14403,13493,910,6.3
22121,1/1/19,13637,12978,659,4.8
22123,1/1/19,3626,3164,462,12.7
22125,1/1/19,5337,5119,218,4.1
22127,1/1/19,4845,4518,327,6.7
23001,1/1/19,55360,53323,2037,3.7
23003,1/1/19,30447,28676,1771,5.8
23005,1/1/19,162386,157603,4783,2.9
23007,1/1/19,14475,13791,684,4.7
23009,1/1/19,27300,25660,1640,6
23011,1/1/19,61955,59535,2420,3.9
23013,1/1/19,19906,19108,798,4
23015,1/1/19,16120,15433,687,4.3
23017,1/1/19,26963,25673,1290,4.8
23019,1/1/19,75551,72235,3316,4.4
23021,1/1/19,7229,6877,352,4.9
23023,1/1/19,19259,18683,576,3
23025,1/1/19,22359,21016,1343,6
23027,1/1/19,20431,19516,915,4.5
23029,1/1/19,13416,12580,836,6.2
23031,1/1/19,111901,107551,4350,3.9
24001,1/1/19,32316,30364,1952,6
24003,1/1/19,314464,303107,11357,3.6
24005,1/1/19,452711,433339,19372,4.3
24009,1/1/19,49767,47868,1899,3.8
24011,1/1/19,18429,17614,815,4.4
24013,1/1/19,96298,92891,3407,3.5
24015,1/1/19,53455,51024,2431,4.5
24017,1/1/19,87072,83108,3964,4.6
24019,1/1/19,15603,14699,904,5.8
24021,1/1/19,135366,130172,5194,3.8
24023,1/1/19,15812,14932,880,5.6
24025,1/1/19,140619,135318,5301,3.8
24027,1/1/19,186953,180832,6121,3.3
24029,1/1/19,10559,9963,596,5.6
24031,1/1/19,560471,540609,19862,3.5
24033,1/1/19,508247,484282,23965,4.7
24035,1/1/19,28369,27309,1060,3.7
24037,1/1/19,56991,54740,2251,3.9
24039,1/1/19,9206,8490,716,7.8
24041,1/1/19,19202,18325,877,4.6
24043,1/1/19,75204,71686,3518,4.7
24045,1/1/19,49279,46312,2967,6
24047,1/1/19,25629,22597,3032,11.8
24510,1/1/19,287780,271110,16670,5.8
25001,1/1/19,109744,102419,7325,6.7
25003,1/1/19,65300,62147,3153,4.8
25005,1/1/19,304451,289192,15259,5
25007,1/1/19,8520,7804,716,8.4
25009,1/1/19,428902,412601,16301,3.8
25011,1/1/19,41301,39793,1508,3.7
25013,1/1/19,230193,218366,11827,5.1
25015,1/1/19,90609,87511,3098,3.4
25017,1/1/19,923716,897367,26349,2.9
25019,1/1/19,6151,5471,680,11.1
25021,1/1/19,392657,380374,12283,3.1
25023,1/1/19,284254,272980,11274,4
25025,1/1/19,457580,443188,14392,3.1
25027,1/1/19,450234,432312,17922,4
26001,1/1/19,3798,3443,355,9.3
26003,1/1/19,3118,2773,345,11.1
26005,1/1/19,61473,59004,2469,4
26007,1/1/19,13265,12408,857,6.5
26009,1/1/19,9895,9151,744,7.5
26011,1/1/19,5944,5389,555,9.3
26013,1/1/19,3185,2932,253,7.9
26015,1/1/19,31632,30333,1299,4.1
26017,1/1/19,50320,47190,3130,6.2
26019,1/1/19,8676,7981,695,8
26021,1/1/19,72322,68530,3792,5.2
26023,1/1/19,18943,18070,873,4.6
26025,1/1/19,62538,59541,2997,4.8
26027,1/1/19,24671,23369,1302,5.3
26029,1/1/19,12814,11946,868,6.8
26031,1/1/19,10531,8617,1914,18.2
26033,1/1/19,16251,14729,1522,9.4
26035,1/1/19,11821,10820,1001,8.5
26037,1/1/19,41077,39438,1639,4
26039,1/1/19,5542,5136,406,7.3
26041,1/1/19,17003,15826,1177,6.9
26043,1/1/19,12369,11767,602,4.9
26045,1/1/19,57455,54872,2583,4.5
26047,1/1/19,17406,15955,1451,8.3
26049,1/1/19,182173,171309,10864,6
26051,1/1/19,9845,9122,723,7.3
26053,1/1/19,6238,5851,387,6.2
26055,1/1/19,47934,45603,2331,4.9
26057,1/1/19,17977,16908,1069,5.9
26059,1/1/19,20251,19261,990,4.9
26061,1/1/19,15521,14566,955,6.2
26063,1/1/19,15109,14165,944,6.2
26065,1/1/19,151397,144847,6550,4.3
26067,1/1/19,29954,28629,1325,4.4
26069,1/1/19,9948,9086,862,8.7
26071,1/1/19,5155,4775,380,7.4
26073,1/1/19,34598,33058,1540,4.5
26075,1/1/19,74158,70762,3396,4.6
26077,1/1/19,133284,128338,4946,3.7
26079,1/1/19,7744,7095,649,8.4
26081,1/1/19,359239,347313,11926,3.3
26083,1/1/19,850,777,73,8.6
26085,1/1/19,3614,3308,306,8.5
26087,1/1/19,41531,38565,2966,7.1
26089,1/1/19,10133,9569,564,5.6
26091,1/1/19,45949,43777,2172,4.7
26093,1/1/19,103035,99156,3879,3.8
26095,1/1/19,2322,2134,188,8.1
26097,1/1/19,4537,3527,1010,22.3
26099,1/1/19,450781,425791,24990,5.5
26101,1/1/19,10088,9287,801,7.9
26103,1/1/19,31776,29754,2022,6.4
26105,1/1/19,13264,12333,931,7
26107,1/1/19,18333,17223,1110,6.1
26109,1/1/19,10948,10417,531,4.9
26111,1/1/19,40445,38580,1865,4.6
26113,1/1/19,6876,6399,477,6.9
26115,1/1/19,75207,71537,3670,4.9
26117,1/1/19,28423,26898,1525,5.4
26119,1/1/19,2982,2623,359,12
26121,1/1/19,76636,72736,3900,5.1
26123,1/1/19,23049,21747,1302,5.6
26125,1/1/19,672815,647330,25485,3.8
26127,1/1/19,11656,10575,1081,9.3
26129,1/1/19,7875,7099,776,9.9
26131,1/1/19,2067,1898,169,8.2
26133,1/1/19,11120,10503,617,5.5
26135,1/1/19,2862,2597,265,9.3
26137,1/1/19,11487,10791,696,6.1
26139,1/1/19,160339,155260,5079,3.2
26141,1/1/19,4893,4302,591,12.1
26143,1/1/19,7589,6708,881,11.6
26145,1/1/19,86829,81537,5292,6.1
26147,1/1/19,76192,71371,4821,6.3
26149,1/1/19,28059,26662,1397,5
26151,1/1/19,19281,17928,1353,7
26153,1/1/19,3337,2978,359,10.8
26155,1/1/19,33515,31669,1846,5.5
26157,1/1/19,23868,22166,1702,7.1
26159,1/1/19,35154,32943,2211,6.3
26161,1/1/19,194764,188640,6124,3.1
26163,1/1/19,807318,759420,47898,5.9
26165,1/1/19,14837,13934,903,6.1
27001,1/1/19,7311,6545,766,10.5
27003,1/1/19,198395,190526,7869,4
27005,1/1/19,18521,17377,1144,6.2
27007,1/1/19,24279,22804,1475,6.1
27009,1/1/19,22193,20843,1350,6.1
27011,1/1/19,2439,2251,188,7.7
27013,1/1/19,40408,39004,1404,3.5
27015,1/1/19,14265,13404,861,6
27017,1/1/19,17919,16821,1098,6.1
27019,1/1/19,58483,56507,1976,3.4
27021,1/1/19,14066,12698,1368,9.7
27023,1/1/19,6934,6570,364,5.2
27025,1/1/19,30323,28623,1700,5.6
27027,1/1/19,35772,34210,1562,4.4
27029,1/1/19,4679,4016,663,14.2
27031,1/1/19,2933,2705,228,7.8
27033,1/1/19,5752,5478,274,4.8
27035,1/1/19,31989,29763,2226,7
27037,1/1/19,241947,233419,8528,3.5
27039,1/1/19,11896,11313,583,4.9
27041,1/1/19,20716,19740,976,4.7
27043,1/1/19,6928,6506,422,6.1
27045,1/1/19,11546,10926,620,5.4
27047,1/1/19,16072,15281,791,4.9
27049,1/1/19,26901,25748,1153,4.3
27051,1/1/19,3268,3025,243,7.4
27053,1/1/19,704682,682949,21733,3.1
27055,1/1/19,10332,9807,525,5.1
27057,1/1/19,9820,8890,930,9.5
27059,1/1/19,21708,20303,1405,6.5
27061,1/1/19,21979,20060,1919,8.7
27063,1/1/19,5643,5378,265,4.7
27065,1/1/19,9240,8252,988,10.7
27067,1/1/19,24244,22934,1310,5.4
27069,1/1/19,2332,2202,130,5.6
27071,1/1/19,5960,5543,417,7
27073,1/1/19,3463,3262,201,5.8
27075,1/1/19,5379,5109,270,5
27077,1/1/19,2502,2396,106,4.2
27079,1/1/19,16517,15244,1273,7.7
27081,1/1/19,3152,2976,176,5.6
27083,1/1/19,14522,13872,650,4.5
27085,1/1/19,19449,18413,1036,5.3
27087,1/1/19,2329,2171,158,6.8
27089,1/1/19,5461,4850,611,11.2
27091,1/1/19,9938,9463,475,4.8
27093,1/1/19,13370,12524,846,6.3
27095,1/1/19,13380,12128,1252,9.4
27097,1/1/19,17778,16102,1676,9.4
27099,1/1/19,20297,19491,806,4
27101,1/1/19,4821,4425,396,8.2
27103,1/1/19,20795,20127,668,3.2
27105,1/1/19,11089,10666,423,3.8
27107,1/1/19,3238,2991,247,7.6
27109,1/1/19,88508,85765,2743,3.1
27111,1/1/19,30889,28730,2159,7
27113,1/1/19,9056,8323,733,8.1
27115,1/1/19,15261,13816,1445,9.5
27117,1/1/19,4815,4513,302,6.3
27119,1/1/19,16636,15721,915,5.5
27121,1/1/19,6430,6129,301,4.7
27123,1/1/19,289144,279343,9801,3.4
27125,1/1/19,2250,2053,197,8.8
27127,1/1/19,7535,7104,431,5.7
27129,1/1/19,8498,7917,581,6.8
27131,1/1/19,37024,35486,1538,4.2
27133,1/1/19,5569,5399,170,3.1
27135,1/1/19,7932,7442,490,6.2
27137,1/1/19,102044,96696,5348,5.2
27139,1/1/19,83666,80777,2889,3.5
27141,1/1/19,53145,50287,2858,5.4
27143,1/1/19,8576,8031,545,6.4
27145,1/1/19,90401,86336,4065,4.5
27147,1/1/19,20985,20094,891,4.2
27149,1/1/19,5225,5015,210,4
27151,1/1/19,4788,4478,310,6.5
27153,1/1/19,13532,12553,979,7.2
27155,1/1/19,1747,1641,106,6.1
27157,1/1/19,12260,11668,592,4.8
27159,1/1/19,6042,5471,571,9.5
27161,1/1/19,8770,8277,493,5.6
27163,1/1/19,143462,138498,4964,3.5
27165,1/1/19,6458,6066,392,6.1
27167,1/1/19,3429,3249,180,5.2
27169,1/1/19,28453,27477,976,3.4
27171,1/1/19,76337,72665,3672,4.8
27173,1/1/19,5314,5044,270,5.1
28001,1/1/19,11026,10245,781,7.1
28003,1/1/19,16139,15392,747,4.6
28005,1/1/19,4352,4019,333,7.7
28007,1/1/19,6965,6500,465,6.7
28009,1/1/19,3008,2829,179,6
28011,1/1/19,12190,11317,873,7.2
28013,1/1/19,5481,5165,316,5.8
28015,1/1/19,3398,3183,215,6.3
28017,1/1/19,6857,6474,383,5.6
28019,1/1/19,3690,3487,203,5.5
28021,1/1/19,2969,2667,302,10.2
28023,1/1/19,5930,5571,359,6.1
28025,1/1/19,7591,7102,489,6.4
28027,1/1/19,8309,7591,718,8.6
28029,1/1/19,11133,10344,789,7.1
28031,1/1/19,7985,7585,400,5
28033,1/1/19,90298,86242,4056,4.5
28035,1/1/19,33081,31379,1702,5.1
28037,1/1/19,2793,2598,195,7
28039,1/1/19,8710,7965,745,8.6
28041,1/1/19,4250,3893,357,8.4
28043,1/1/19,9507,9032,475,5
28045,1/1/19,18546,17374,1172,6.3
28047,1/1/19,84950,80482,4468,5.3
28049,1/1/19,106227,100587,5640,5.3
28051,1/1/19,5577,4982,595,10.7
28053,1/1/19,2170,1926,244,11.2
28055,1/1/19,363,313,50,13.8
28057,1/1/19,10375,9885,490,4.7
28059,1/1/19,57794,54042,3752,6.5
28061,1/1/19,6050,5626,424,7
28063,1/1/19,1981,1685,296,14.9
28065,1/1/19,4088,3799,289,7.1
28067,1/1/19,25725,24319,1406,5.5
28069,1/1/19,3528,3261,267,7.6
28071,1/1/19,27207,25944,1263,4.6
28073,1/1/19,30605,29281,1324,4.3
28075,1/1/19,30773,29100,1673,5.4
28077,1/1/19,4602,4281,321,7
28079,1/1/19,7796,7350,446,5.7
28081,1/1/19,40707,38956,1751,4.3
28083,1/1/19,9959,9088,871,8.7
28085,1/1/19,14473,13620,853,5.9
28087,1/1/19,24951,23635,1316,5.3
28089,1/1/19,52758,50513,2245,4.3
28091,1/1/19,9802,9235,567,5.8
28093,1/1/19,14294,13472,822,5.8
28095,1/1/19,15233,14409,824,5.4
28097,1/1/19,3931,3676,255,6.5
28099,1/1/19,9953,9367,586,5.9
28101,1/1/19,8679,8218,461,5.3
28103,1/1/19,3675,3412,263,7.2
28105,1/1/19,22041,20843,1198,5.4
28107,1/1/19,12203,11364,839,6.9
28109,1/1/19,23634,22262,1372,5.8
28111,1/1/19,4272,3968,304,7.1
28113,1/1/19,14327,13368,959,6.7
28115,1/1/19,14562,13938,624,4.3
28117,1/1/19,11187,10628,559,5
28119,1/1/19,2310,2117,193,8.4
28121,1/1/19,75562,72543,3019,4
28123,1/1/19,12533,11959,574,4.6
28125,1/1/19,1585,1423,162,10.2
28127,1/1/19,10652,10074,578,5.4
28129,1/1/19,6743,6371,372,5.5
28131,1/1/19,6686,6250,436,6.5
28133,1/1/19,7621,6856,765,10
28135,1/1/19,5257,4896,361,6.9
28137,1/1/19,12168,11495,673,5.5
28139,1/1/19,9381,8892,489,5.2
28141,1/1/19,8673,8212,461,5.3
28143,1/1/19,4398,4092,306,7
28145,1/1/19,13918,13332,586,4.2
28147,1/1/19,4912,4551,361,7.3
28149,1/1/19,20227,18898,1329,6.6
28151,1/1/19,16877,15467,1410,8.4
28153,1/1/19,7247,6811,436,6
28155,1/1/19,3859,3637,222,5.8
28157,1/1/19,2812,2516,296,10.5
28159,1/1/19,7230,6760,470,6.5
28161,1/1/19,4984,4699,285,5.7
28163,1/1/19,9222,8656,566,6.1
29001,1/1/19,10399,9939,460,4.4
29003,1/1/19,9691,9366,325,3.4
29005,1/1/19,2739,2646,93,3.4
29007,1/1/19,10773,10327,446,4.1
29009,1/1/19,15783,15161,622,3.9
29011,1/1/19,5273,5099,174,3.3
29013,1/1/19,7903,7517,386,4.9
29015,1/1/19,7199,6775,424,5.9
29017,1/1/19,5496,5259,237,4.3
29019,1/1/19,95710,93026,2684,2.8
29021,1/1/19,44190,42589,1601,3.6
29023,1/1/19,17731,16855,876,4.9
29025,1/1/19,4354,4194,160,3.7
29027,1/1/19,21193,20463,730,3.4
29029,1/1/19,17697,16522,1175,6.6
29031,1/1/19,40638,39386,1252,3.1
29033,1/1/19,5067,4900,167,3.3
29035,1/1/19,2429,2286,143,5.9
29037,1/1/19,54413,52394,2019,3.7
29039,1/1/19,5729,5501,228,4
29041,1/1/19,3764,3636,128,3.4
29043,1/1/19,44526,43017,1509,3.4
29045,1/1/19,3243,3092,151,4.7
29047,1/1/19,134785,130436,4349,3.2
29049,1/1/19,10651,10273,378,3.5
29051,1/1/19,38602,37449,1153,3
29053,1/1/19,7381,7087,294,4
29055,1/1/19,10837,10361,476,4.4
29057,1/1/19,3572,3441,131,3.7
29059,1/1/19,7000,6681,319,4.6
29061,1/1/19,4099,3939,160,3.9
29063,1/1/19,4820,4642,178,3.7
29065,1/1/19,6280,6025,255,4.1
29067,1/1/19,5111,4886,225,4.4
29069,1/1/19,11946,11161,785,6.6
29071,1/1/19,52460,50483,1977,3.8
29073,1/1/19,7661,7376,285,3.7
29075,1/1/19,3546,3454,92,2.6
29077,1/1/19,149418,144841,4577,3.1
29079,1/1/19,4472,4296,176,3.9
29081,1/1/19,3956,3794,162,4.1
29083,1/1/19,9736,9307,429,4.4
29085,1/1/19,3726,3519,207,5.6
29087,1/1/19,2628,2557,71,2.7
29089,1/1/19,4964,4793,171,3.4
29091,1/1/19,16386,15711,675,4.1
29093,1/1/19,3585,3366,219,6.1
29095,1/1/19,359426,343971,15455,4.3
29097,1/1/19,57061,55198,1863,3.3
29099,1/1/19,116460,112093,4367,3.7
29101,1/1/19,22876,21944,932,4.1
29103,1/1/19,1814,1746,68,3.7
29105,1/1/19,16929,16247,682,4
29107,1/1/19,16719,16115,604,3.6
29109,1/1/19,18089,17356,733,4.1
29111,1/1/19,4998,4824,174,3.5
29113,1/1/19,28122,26968,1154,4.1
29115,1/1/19,5175,4892,283,5.5
29117,1/1/19,7448,7222,226,3
29119,1/1/19,10490,10132,358,3.4
29121,1/1/19,7634,7281,353,4.6
29123,1/1/19,5483,5265,218,4
29125,1/1/19,3871,3728,143,3.7
29127,1/1/19,14480,13920,560,3.9
29129,1/1/19,1905,1830,75,3.9
29131,1/1/19,12031,11399,632,5.3
29133,1/1/19,5844,5579,265,4.5
29135,1/1/19,7285,7036,249,3.4
29137,1/1/19,3851,3672,179,4.6
29139,1/1/19,5665,5461,204,3.6
29141,1/1/19,7908,7457,451,5.7
29143,1/1/19,8261,7864,397,4.8
29145,1/1/19,27295,26355,940,3.4
29147,1/1/19,10595,10265,330,3.1
29149,1/1/19,4013,3851,162,4
29151,1/1/19,7047,6865,182,2.6
29153,1/1/19,3415,3166,249,7.3
29155,1/1/19,6350,5986,364,5.7
29157,1/1/19,10266,9955,311,3
29159,1/1/19,20827,20015,812,3.9
29161,1/1/19,19664,18882,782,4
29163,1/1/19,7437,7120,317,4.3
29165,1/1/19,57963,56270,1693,2.9
29167,1/1/19,14503,13906,597,4.1
29169,1/1/19,14634,14011,623,4.3
29171,1/1/19,2359,2237,122,5.2
29173,1/1/19,5650,5426,224,4
29175,1/1/19,10187,9711,476,4.7
29177,1/1/19,10923,10469,454,4.2
29179,1/1/19,3012,2886,126,4.2
29181,1/1/19,5039,4754,285,5.7
29183,1/1/19,223345,216678,6667,3
29185,1/1/19,3846,3643,203,5.3
29186,1/1/19,9115,8810,305,3.3
29187,1/1/19,26468,25307,1161,4.4
29189,1/1/19,524275,505878,18397,3.5
29195,1/1/19,10695,10323,372,3.5
29197,1/1/19,1986,1876,110,5.5
29199,1/1/19,2392,2298,94,3.9
29201,1/1/19,20150,19367,783,3.9
29203,1/1/19,3236,3008,228,7
29205,1/1/19,3095,2959,136,4.4
29207,1/1/19,13119,12376,743,5.7
29209,1/1/19,13062,11743,1319,10.1
29211,1/1/19,2756,2648,108,3.9
29213,1/1/19,25949,22790,3159,12.2
29215,1/1/19,9145,8709,436,4.8
29217,1/1/19,9627,9245,382,4
29219,1/1/19,17713,17109,604,3.4
29221,1/1/19,10260,9682,578,5.6
29223,1/1/19,5395,5095,300,5.6
29225,1/1/19,17105,16468,637,3.7
29227,1/1/19,1170,1137,33,2.8
29229,1/1/19,7485,7145,340,4.5
29510,1/1/19,150522,143993,6529,4.3
30001,1/1/19,5071,4858,213,4.2
30003,1/1/19,4904,4453,451,9.2
30005,1/1/19,2473,2346,127,5.1
30007,1/1/19,2528,2406,122,4.8
30009,1/1/19,5489,5230,259,4.7
30011,1/1/19,658,629,29,4.4
30013,1/1/19,37737,36212,1525,4
30015,1/1/19,2416,2327,89,3.7
30017,1/1/19,5963,5715,248,4.2
30019,1/1/19,904,883,21,2.3
30021,1/1/19,4589,4458,131,2.9
30023,1/1/19,5015,4811,204,4.1
30025,1/1/19,1688,1651,37,2.2
30027,1/1/19,5945,5663,282,4.7
30029,1/1/19,46640,43759,2881,6.2
30031,1/1/19,66559,64733,1826,2.7
30033,1/1/19,744,721,23,3.1
30035,1/1/19,5500,4976,524,9.5
30037,1/1/19,372,349,23,6.2
30039,1/1/19,1784,1648,136,7.6
30041,1/1/19,7474,7165,309,4.1
30043,1/1/19,5663,5407,256,4.5
30045,1/1/19,924,880,44,4.8
30047,1/1/19,12829,12137,692,5.4
30049,1/1/19,35459,34067,1392,3.9
30051,1/1/19,958,925,33,3.4
30053,1/1/19,7963,7164,799,10
30055,1/1/19,942,924,18,1.9
30057,1/1/19,5340,5125,215,4
30059,1/1/19,998,947,51,5.1
30061,1/1/19,1709,1563,146,8.5
30063,1/1/19,63097,60366,2731,4.3
30065,1/1/19,2252,2144,108,4.8
30067,1/1/19,8471,8021,450,5.3
30069,1/1/19,283,268,15,5.3
30071,1/1/19,1901,1801,100,5.3
30073,1/1/19,2677,2542,135,5
30075,1/1/19,955,920,35,3.7
30077,1/1/19,2788,2664,124,4.4
30079,1/1/19,478,456,22,4.6
30081,1/1/19,19823,18676,1147,5.8
30083,1/1/19,5825,5662,163,2.8
30085,1/1/19,4503,4278,225,5
30087,1/1/19,3769,3545,224,5.9
30089,1/1/19,4743,4327,416,8.8
30091,1/1/19,1748,1693,55,3.1
30093,1/1/19,16956,16163,793,4.7
30095,1/1/19,5001,4806,195,3.9
30097,1/1/19,1767,1706,61,3.5
30099,1/1/19,2706,2587,119,4.4
30101,1/1/19,2116,2064,52,2.5
30103,1/1/19,334,322,12,3.6
30105,1/1/19,4019,3864,155,3.9
30107,1/1/19,775,732,43,5.5
30109,1/1/19,464,447,17,3.7
30111,1/1/19,81315,78249,3066,3.8
31001,1/1/19,16402,15776,626,3.8
31003,1/1/19,3576,3471,105,2.9
31005,1/1/19,231,219,12,5.2
31007,1/1/19,380,366,14,3.7
31009,1/1/19,270,256,14,5.2
31011,1/1/19,3012,2911,101,3.4
31013,1/1/19,5344,5175,169,3.2
31015,1/1/19,1101,1058,43,3.9
31017,1/1/19,1413,1351,62,4.4
31019,1/1/19,27590,26807,783,2.8
31021,1/1/19,3514,3355,159,4.5
31023,1/1/19,4589,4472,117,2.5
31025,1/1/19,13332,12825,507,3.8
31027,1/1/19,4483,4364,119,2.7
31029,1/1/19,2282,2235,47,2.1
31031,1/1/19,3408,3317,91,2.7
31033,1/1/19,4482,4313,169,3.8
31035,1/1/19,3285,3143,142,4.3
31037,1/1/19,5562,5399,163,2.9
31039,1/1/19,4721,4589,132,2.8
31041,1/1/19,6473,6312,161,2.5
31043,1/1/19,10707,10161,546,5.1
31045,1/1/19,4958,4818,140,2.8
31047,1/1/19,13031,12561,470,3.6
31049,1/1/19,937,912,25,2.7
31051,1/1/19,3045,2934,111,3.6
31053,1/1/19,19239,18602,637,3.3
31055,1/1/19,292914,282099,10815,3.7
31057,1/1/19,1180,1149,31,2.6
31059,1/1/19,3165,3070,95,3
31061,1/1/19,1513,1453,60,4
31063,1/1/19,1646,1586,60,3.6
31065,1/1/19,2579,2503,76,2.9
31067,1/1/19,10909,10470,439,4
31069,1/1/19,1122,1087,35,3.1
31071,1/1/19,1138,1109,29,2.5
31073,1/1/19,1077,1050,27,2.5
31075,1/1/19,440,428,12,2.7
31077,1/1/19,1246,1199,47,3.8
31079,1/1/19,31979,30318,1661,5.2
31081,1/1/19,4772,4605,167,3.5
31083,1/1/19,1747,1693,54,3.1
31085,1/1/19,600,588,12,2
31087,1/1/19,1267,1218,49,3.9
31089,1/1/19,5818,5641,177,3
31091,1/1/19,373,363,10,2.7
31093,1/1/19,3457,3230,227,6.6
31095,1/1/19,4157,4033,124,3
31097,1/1/19,2059,1987,72,3.5
31099,1/1/19,3764,3684,80,2.1
31101,1/1/19,4487,4320,167,3.7
31103,1/1/19,616,602,14,2.3
31105,1/1/19,2047,1983,64,3.1
31107,1/1/19,4652,4471,181,3.9
31109,1/1/19,174147,169015,5132,2.9
31111,1/1/19,18090,17392,698,3.9
31113,1/1/19,469,455,14,3
31115,1/1/19,408,392,16,3.9
31117,1/1/19,441,429,12,2.7
31119,1/1/19,19701,19075,626,3.2
31121,1/1/19,4059,3869,190,4.7
31123,1/1/19,2607,2516,91,3.5
31125,1/1/19,1978,1916,62,3.1
31127,1/1/19,3629,3487,142,3.9
31129,1/1/19,2448,2368,80,3.3
31131,1/1/19,8268,7984,284,3.4
31133,1/1/19,1488,1445,43,2.9
31135,1/1/19,1850,1811,39,2.1
31137,1/1/19,4953,4819,134,2.7
31139,1/1/19,4057,3925,132,3.3
31141,1/1/19,17419,16857,562,3.2
31143,1/1/19,2950,2861,89,3
31145,1/1/19,5818,5653,165,2.8
31147,1/1/19,4204,4043,161,3.8
31149,1/1/19,891,858,33,3.7
31151,1/1/19,7384,7093,291,3.9
31153,1/1/19,94206,91276,2930,3.1
31155,1/1/19,10998,10658,340,3.1
31157,1/1/19,18062,17291,771,4.3
31159,1/1/19,8859,8599,260,2.9
31161,1/1/19,2709,2641,68,2.5
31163,1/1/19,1710,1646,64,3.7
31165,1/1/19,763,740,23,3
31167,1/1/19,3514,3415,99,2.8
31169,1/1/19,2870,2796,74,2.6
31171,1/1/19,435,416,19,4.4
31173,1/1/19,2990,2871,119,4
31175,1/1/19,2134,2052,82,3.8
31177,1/1/19,11085,10712,373,3.4
31179,1/1/19,5802,5652,150,2.6
31181,1/1/19,1672,1610,62,3.7
31183,1/1/19,609,593,16,2.6
31185,1/1/19,7223,7029,194,2.7
32001,1/1/19,10797,10325,472,4.4
32003,1/1/19,1118227,1066729,51498,4.6
32005,1/1/19,22837,21711,1126,4.9
32007,1/1/19,27349,26329,1020,3.7
32009,1/1/19,413,397,16,3.9
32011,1/1/19,1064,1036,28,2.6
32013,1/1/19,8064,7775,289,3.6
32015,1/1/19,3179,3052,127,4
32017,1/1/19,2051,1944,107,5.2
32019,1/1/19,23223,21832,1391,6
32021,1/1/19,1990,1889,101,5.1
32023,1/1/19,16974,15961,1013,6
32027,1/1/19,2529,2404,125,4.9
32029,1/1/19,2000,1904,96,4.8
32031,1/1/19,250704,240654,10050,4
32033,1/1/19,4481,4310,171,3.8
32510,1/1/19,25800,24517,1283,5
33001,1/1/19,30573,29608,965,3.2
33003,1/1/19,23449,22710,739,3.2
33005,1/1/19,40508,39265,1243,3.1
33007,1/1/19,14734,14119,615,4.2
33009,1/1/19,49286,48060,1226,2.5
33011,1/1/19,241710,234323,7387,3.1
33013,1/1/19,83490,81214,2276,2.7
33015,1/1/19,186931,180776,6155,3.3
33017,1/1/19,73113,71127,1986,2.7
33019,1/1/19,23118,22550,568,2.5
34001,1/1/19,118479,110505,7974,6.7
34003,1/1/19,476021,459631,16390,3.4
34005,1/1/19,228009,219027,8982,3.9
34007,1/1/19,250837,238728,12109,4.8
34009,1/1/19,39741,34278,5463,13.7
34011,1/1/19,65116,60544,4572,7
34013,1/1/19,365737,346812,18925,5.2
34015,1/1/19,148373,141784,6589,4.4
34017,1/1/19,357233,343546,13687,3.8
34019,1/1/19,63737,61508,2229,3.5
34021,1/1/19,200316,192662,7654,3.8
34023,1/1/19,431976,416157,15819,3.7
34025,1/1/19,323066,310314,12752,3.9
34027,1/1/19,254053,245453,8600,3.4
34029,1/1/19,271402,258346,13056,4.8
34031,1/1/19,240617,227889,12728,5.3
34033,1/1/19,28876,27203,1673,5.8
34035,1/1/19,169691,163638,6053,3.6
34037,1/1/19,73326,70105,3221,4.4
34039,1/1/19,274403,262258,12145,4.4
34041,1/1/19,55334,53007,2327,4.2
35001,1/1/19,329809,314120,15689,4.8
35003,1/1/19,1128,1044,84,7.4
35005,1/1/19,27198,25889,1309,4.8
35006,1/1/19,8960,8356,604,6.7
35007,1/1/19,5372,5108,264,4.9
35009,1/1/19,21689,20786,903,4.2
35011,1/1/19,792,756,36,4.5
35013,1/1/19,96169,90116,6053,6.3
35015,1/1/19,33280,32203,1077,3.2
35017,1/1/19,12155,11493,662,5.4
35019,1/1/19,1503,1409,94,6.3
35021,1/1/19,277,263,14,5.1
35023,1/1/19,2088,1995,93,4.5
35025,1/1/19,30952,29735,1217,3.9
35027,1/1/19,8702,8216,486,5.6
35028,1/1/19,9207,8894,313,3.4
35029,1/1/19,9999,8349,1650,16.5
35031,1/1/19,24367,22488,1879,7.7
35033,1/1/19,2158,2004,154,7.1
35035,1/1/19,24899,23584,1315,5.3
35037,1/1/19,3186,3019,167,5.2
35039,1/1/19,16409,15416,993,6.1
35041,1/1/19,7805,7458,347,4.4
35043,1/1/19,65594,62182,3412,5.2
35045,1/1/19,51583,48302,3281,6.4
35047,1/1/19,10791,10107,684,6.3
35049,1/1/19,73856,70631,3225,4.4
35051,1/1/19,3824,3512,312,8.2
35053,1/1/19,6441,6041,400,6.2
35055,1/1/19,15672,14665,1007,6.4
35057,1/1/19,5554,5082,472,8.5
35059,1/1/19,1795,1729,66,3.7
35061,1/1/19,30304,28608,1696,5.6
36001,1/1/19,156431,150019,6412,4.1
36003,1/1/19,19500,18132,1368,7
36005,1/1/19,604149,563497,40652,6.7
36007,1/1/19,83238,78422,4816,5.8
36009,1/1/19,34838,32631,2207,6.3
36011,1/1/19,36524,34584,1940,5.3
36013,1/1/19,54614,51475,3139,5.7
36015,1/1/19,35409,33735,1674,4.7
36017,1/1/19,22618,21303,1315,5.8
36019,1/1/19,36528,34610,1918,5.3
36021,1/1/19,31280,30065,1215,3.9
36023,1/1/19,23181,21657,1524,6.6
36025,1/1/19,19196,18057,1139,5.9
36027,1/1/19,143168,137460,5708,4
36029,1/1/19,440626,418598,22028,5
36031,1/1/19,17606,16526,1080,6.1
36033,1/1/19,19842,18634,1208,6.1
36035,1/1/19,22743,21351,1392,6.1
36037,1/1/19,30060,28509,1551,5.2
36039,1/1/19,20750,19672,1078,5.2
36041,1/1/19,2166,1974,192,8.9
36043,1/1/19,28302,26559,1743,6.2
36045,1/1/19,43786,40665,3121,7.1
36047,1/1/19,1205148,1144355,60793,5
36049,1/1/19,12065,11164,901,7.5
36051,1/1/19,31160,29540,1620,5.2
36053,1/1/19,33191,31265,1926,5.8
36055,1/1/19,358923,342404,16519,4.6
36057,1/1/19,22701,21283,1418,6.2
36059,1/1/19,698377,672270,26107,3.7
36061,1/1/19,916143,875681,40462,4.4
36063,1/1/19,99459,93272,6187,6.2
36065,1/1/19,101544,96337,5207,5.1
36067,1/1/19,218895,209104,9791,4.5
36069,1/1/19,55618,52994,2624,4.7
36071,1/1/19,183752,176283,7469,4.1
36073,1/1/19,17922,16922,1000,5.6
36075,1/1/19,53259,49586,3673,6.9
36077,1/1/19,27771,26201,1570,5.7
36079,1/1/19,50748,48699,2049,4
36081,1/1/19,1145223,1095400,49823,4.4
36083,1/1/19,80849,77252,3597,4.4
36085,1/1/19,223566,212716,10850,4.9
36087,1/1/19,153617,147709,5908,3.8
36089,1/1/19,43431,40528,2903,6.7
36091,1/1/19,118623,113861,4762,4
36093,1/1/19,75643,72312,3331,4.4
36095,1/1/19,15004,14018,986,6.6
36097,1/1/19,8096,7569,527,6.5
36099,1/1/19,16093,15318,775,4.8
36101,1/1/19,43392,40874,2518,5.8
36103,1/1/19,771384,737628,33756,4.4
36105,1/1/19,35968,34292,1676,4.7
36107,1/1/19,22672,21536,1136,5
36109,1/1/19,48664,46733,1931,4
36111,1/1/19,86965,83145,3820,4.4
36113,1/1/19,30718,28821,1897,6.2
36115,1/1/19,27651,26189,1462,5.3
36117,1/1/19,44372,42233,2139,4.8
36119,1/1/19,479292,459842,19450,4.1
36121,1/1/19,18774,17613,1161,6.2
36123,1/1/19,12270,11711,559,4.6
37001,1/1/19,81572,78024,3548,4.3
37003,1/1/19,18011,17339,672,3.7
37005,1/1/19,4277,4038,239,5.6
37007,1/1/19,10832,10293,539,5
37009,1/1/19,12625,12019,606,4.8
37011,1/1/19,7306,6981,325,4.4
37013,1/1/19,19671,18632,1039,5.3
37015,1/1/19,7886,7458,428,5.4
37017,1/1/19,14542,13682,860,5.9
37019,1/1/19,51388,47963,3425,6.7
37021,1/1/19,139423,134639,4784,3.4
37023,1/1/19,40938,39245,1693,4.1
37025,1/1/19,108122,103646,4476,4.1
37027,1/1/19,36634,34882,1752,4.8
37029,1/1/19,4650,4436,214,4.6
37031,1/1/19,30883,29125,1758,5.7
37033,1/1/19,9886,9382,504,5.1
37035,1/1/19,78863,75673,3190,4
37037,1/1/19,35506,34142,1364,3.8
37039,1/1/19,11087,10474,613,5.5
37041,1/1/19,5585,5274,311,5.6
37043,1/1/19,4059,3837,222,5.5
37045,1/1/19,48330,46200,2130,4.4
37047,1/1/19,22270,20935,1335,6
37049,1/1/19,41712,39666,2046,4.9
37051,1/1/19,128617,121050,7567,5.9
37053,1/1/19,13926,13297,629,4.5
37055,1/1/19,17637,16164,1473,8.4
37057,1/1/19,81142,77763,3379,4.2
37059,1/1/19,20723,19923,800,3.9
37061,1/1/19,25129,23918,1211,4.8
37063,1/1/19,170785,164091,6694,3.9
37065,1/1/19,21784,20282,1502,6.9
37067,1/1/19,188529,180461,8068,4.3
37069,1/1/19,31117,29684,1433,4.6
37071,1/1/19,110043,105212,4831,4.4
37073,1/1/19,5288,5038,250,4.7
37075,1/1/19,3206,2990,216,6.7
37077,1/1/19,30335,29162,1173,3.9
37079,1/1/19,9578,9183,395,4.1
37081,1/1/19,263324,251000,12324,4.7
37083,1/1/19,20432,19104,1328,6.5
37085,1/1/19,53146,50322,2824,5.3
37087,1/1/19,29779,28614,1165,3.9
37089,1/1/19,54740,52694,2046,3.7
37091,1/1/19,9213,8659,554,6
37093,1/1/19,20257,19105,1152,5.7
37095,1/1/19,1846,1611,235,12.7
37097,1/1/19,88637,85019,3618,4.1
37099,1/1/19,18980,17989,991,5.2
37101,1/1/19,98498,94394,4104,4.2
37103,1/1/19,4410,4202,208,4.7
37105,1/1/19,26149,24768,1381,5.3
37107,1/1/19,27984,26788,1196,4.3
37109,1/1/19,43021,41315,1706,4
37111,1/1/19,20599,19718,881,4.3
37113,1/1/19,15167,14439,728,4.8
37115,1/1/19,10114,9694,420,4.2
37117,1/1/19,9197,8674,523,5.7
37119,1/1/19,615859,590195,25664,4.2
37121,1/1/19,6016,5666,350,5.8
37123,1/1/19,11486,10980,506,4.4
37125,1/1/19,42272,40474,1798,4.3
37127,1/1/19,44043,41691,2352,5.3
37129,1/1/19,121716,116382,5334,4.4
37131,1/1/19,7775,7305,470,6
37133,1/1/19,64895,61370,3525,5.4
37135,1/1/19,78521,75606,2915,3.7
37137,1/1/19,5339,5096,243,4.6
37139,1/1/19,16817,15841,976,5.8
37141,1/1/19,28408,27050,1358,4.8
37143,1/1/19,4998,4689,309,6.2
37145,1/1/19,18424,17551,873,4.7
37147,1/1/19,90811,86602,4209,4.6
37149,1/1/19,8903,8511,392,4.4
37151,1/1/19,66493,63593,2900,4.4
37153,1/1/19,16761,15750,1011,6
37155,1/1/19,50677,47483,3194,6.3
37157,1/1/19,40280,38259,2021,5
37159,1/1/19,65620,62628,2992,4.6
37161,1/1/19,25102,23665,1437,5.7
37163,1/1/19,29479,28188,1291,4.4
37165,1/1/19,11739,10833,906,7.7
37167,1/1/19,29912,28655,1257,4.2
37169,1/1/19,21768,20872,896,4.1
37171,1/1/19,33820,32412,1408,4.2
37173,1/1/19,6605,6236,369,5.6
37175,1/1/19,14152,13514,638,4.5
37177,1/1/19,1325,1210,115,8.7
37179,1/1/19,122721,117802,4919,4
37181,1/1/19,17361,16209,1152,6.6
37183,1/1/19,591147,568549,22598,3.8
37185,1/1/19,6479,6063,416,6.4
37187,1/1/19,4475,4145,330,7.4
37189,1/1/19,28674,27499,1175,4.1
37191,1/1/19,52727,50209,2518,4.8
37193,1/1/19,29607,28266,1341,4.5
37195,1/1/19,34993,32777,2216,6.3
37197,1/1/19,17812,17113,699,3.9
37199,1/1/19,8312,7945,367,4.4
38001,1/1/19,1029,1003,26,2.5
38003,1/1/19,5147,4988,159,3.1
38005,1/1/19,2304,2186,118,5.1
38007,1/1/19,358,343,15,4.2
38009,1/1/19,2887,2755,132,4.6
38011,1/1/19,1667,1635,32,1.9
38013,1/1/19,1057,1034,23,2.2
38015,1/1/19,48443,46836,1607,3.3
38017,1/1/19,100174,97415,2759,2.8
38019,1/1/19,1839,1769,70,3.8
38021,1/1/19,2266,2214,52,2.3
38023,1/1/19,1453,1430,23,1.6
38025,1/1/19,3034,2970,64,2.1
38027,1/1/19,1194,1119,75,6.3
38029,1/1/19,1426,1344,82,5.8
38031,1/1/19,1520,1458,62,4.1
38033,1/1/19,843,823,20,2.4
38035,1/1/19,37015,36071,944,2.6
38037,1/1/19,1176,1135,41,3.5
38039,1/1/19,1001,971,30,3
38041,1/1/19,1362,1327,35,2.6
38043,1/1/19,1279,1195,84,6.6
38045,1/1/19,2034,1978,56,2.8
38047,1/1/19,864,842,22,2.5
38049,1/1/19,3026,2867,159,5.3
38051,1/1/19,1104,1056,48,4.3
38053,1/1/19,9603,9461,142,1.5
38055,1/1/19,4564,4373,191,4.2
38057,1/1/19,3543,3336,207,5.8
38059,1/1/19,16064,15380,684,4.3
38061,1/1/19,7088,6975,113,1.6
38063,1/1/19,1349,1297,52,3.9
38065,1/1/19,858,815,43,5
38067,1/1/19,3268,3129,139,4.3
38069,1/1/19,1707,1632,75,4.4
38071,1/1/19,5516,5306,210,3.8
38073,1/1/19,2778,2713,65,2.3
38075,1/1/19,1198,1162,36,3
38077,1/1/19,8452,8177,275,3.3
38079,1/1/19,4545,4136,409,9
38081,1/1/19,2591,2527,64,2.5
38083,1/1/19,660,619,41,6.2
38085,1/1/19,1204,1156,48,4
38087,1/1/19,395,386,9,2.3
38089,1/1/19,18018,17562,456,2.5
38091,1/1/19,968,946,22,2.3
38093,1/1/19,10287,9952,335,3.3
38095,1/1/19,1136,1099,37,3.3
38097,1/1/19,4337,4198,139,3.2
38099,1/1/19,5079,4890,189,3.7
38101,1/1/19,30949,29953,996,3.2
38103,1/1/19,1862,1785,77,4.1
38105,1/1/19,23748,23255,493,2.1
39001,1/1/19,10901,9797,1104,10.1
39003,1/1/19,47756,45400,2356,4.9
39005,1/1/19,26416,24883,1533,5.8
39007,1/1/19,44053,41167,2886,6.6
39009,1/1/19,27130,25254,1876,6.9
39011,1/1/19,24773,23885,888,3.6
39013,1/1/19,30025,27868,2157,7.2
39015,1/1/19,19552,18173,1379,7.1
39017,1/1/19,192416,183749,8667,4.5
39019,1/1/19,12919,12061,858,6.6
39021,1/1/19,19757,18902,855,4.3
39023,1/1/19,62982,59693,3289,5.2
39025,1/1/19,105595,100580,5015,4.7
39027,1/1/19,17606,16514,1092,6.2
39029,1/1/19,47059,44146,2913,6.2
39031,1/1/19,14396,13375,1021,7.1
39033,1/1/19,17896,16832,1064,5.9
39035,1/1/19,609997,580679,29318,4.8
39037,1/1/19,25689,24489,1200,4.7
39039,1/1/19,17874,16983,891,5
39041,1/1/19,108708,104730,3978,3.7
39043,1/1/19,36217,33481,2736,7.6
39045,1/1/19,77278,73624,3654,4.7
39047,1/1/19,13783,13089,694,5
39049,1/1/19,688842,659998,28844,4.2
39051,1/1/19,22300,20993,1307,5.9
39053,1/1/19,12491,11528,963,7.7
39055,1/1/19,48866,46772,2094,4.3
39057,1/1/19,82368,78632,3736,4.5
39059,1/1/19,18758,17328,1430,7.6
39061,1/1/19,410765,391684,19081,4.6
39063,1/1/19,41355,39763,1592,3.8
39065,1/1/19,13855,13174,681,4.9
39067,1/1/19,6843,6397,446,6.5
39069,1/1/19,13207,12330,877,6.6
39071,1/1/19,17091,15920,1171,6.9
39073,1/1/19,13114,12229,885,6.7
39075,1/1/19,20293,19549,744,3.7
39077,1/1/19,27984,25499,2485,8.9
39079,1/1/19,12834,11742,1092,8.5
39081,1/1/19,27394,25305,2089,7.6
39083,1/1/19,31235,29575,1660,5.3
39085,1/1/19,126089,120336,5753,4.6
39087,1/1/19,23731,22173,1558,6.6
39089,1/1/19,89518,85364,4154,4.6
39091,1/1/19,22950,21918,1032,4.5
39093,1/1/19,153541,145525,8016,5.2
39095,1/1/19,208237,195697,12540,6
39097,1/1/19,20601,19681,920,4.5
39099,1/1/19,103121,95966,7155,6.9
39101,1/1/19,28567,27089,1478,5.2
39103,1/1/19,97058,93156,3902,4
39105,1/1/19,9232,8326,906,9.8
39107,1/1/19,23055,22334,721,3.1
39109,1/1/19,53655,51181,2474,4.6
39111,1/1/19,5467,4849,618,11.3
39113,1/1/19,250161,237529,12632,5
39115,1/1/19,6834,6183,651,9.5
39117,1/1/19,16771,15783,988,5.9
39119,1/1/19,39340,36613,2727,6.9
39121,1/1/19,4828,4349,479,9.9
39123,1/1/19,20251,18283,1968,9.7
39125,1/1/19,8560,8162,398,4.6
39127,1/1/19,15951,14788,1163,7.3
39129,1/1/19,26268,24883,1385,5.3
39131,1/1/19,10862,9934,928,8.5
39133,1/1/19,86633,81869,4764,5.5
39135,1/1/19,21028,20006,1022,4.9
39137,1/1/19,18542,17760,782,4.2
39139,1/1/19,52414,49397,3017,5.8
39141,1/1/19,34892,32972,1920,5.5
39143,1/1/19,30466,28660,1806,5.9
39145,1/1/19,28827,26370,2457,8.5
39147,1/1/19,27202,25760,1442,5.3
39149,1/1/19,24161,23104,1057,4.4
39151,1/1/19,184757,173929,10828,5.9
39153,1/1/19,270295,255351,14944,5.5
39155,1/1/19,86853,80389,6464,7.4
39157,1/1/19,44048,41549,2499,5.7
39159,1/1/19,28560,27432,1128,3.9
39161,1/1/19,14920,14328,592,4
39163,1/1/19,5565,5124,441,7.9
39165,1/1/19,117473,112506,4967,4.2
39167,1/1/19,27176,25189,1987,7.3
39169,1/1/19,61460,58938,2522,4.1
39171,1/1/19,18908,18128,780,4.1
39173,1/1/19,70111,66930,3181,4.5
39175,1/1/19,12862,12338,524,4.1
40001,1/1/19,8154,7754,400,4.9
40003,1/1/19,2864,2800,64,2.2
40005,1/1/19,4925,4708,217,4.4
40007,1/1/19,2927,2855,72,2.5
40009,1/1/19,11067,10770,297,2.7
40011,1/1/19,4648,4555,93,2
40013,1/1/19,20715,19986,729,3.5
40015,1/1/19,12040,11604,436,3.6
40017,1/1/19,73188,70915,2273,3.1
40019,1/1/19,21371,20540,831,3.9
40021,1/1/19,18686,17816,870,4.7
40023,1/1/19,5556,5255,301,5.4
40025,1/1/19,1343,1318,25,1.9
40027,1/1/19,140964,136348,4616,3.3
40029,1/1/19,2563,2463,100,3.9
40031,1/1/19,47690,45692,1998,4.2
40033,1/1/19,2694,2613,81,3
40035,1/1/19,6018,5763,255,4.2
40037,1/1/19,31216,29932,1284,4.1
40039,1/1/19,15547,15139,408,2.6
40041,1/1/19,17635,16821,814,4.6
40043,1/1/19,2868,2808,60,2.1
40045,1/1/19,2238,2186,52,2.3
40047,1/1/19,27262,26382,880,3.2
40049,1/1/19,12725,12259,466,3.7
40051,1/1/19,26176,25299,877,3.4
40053,1/1/19,2718,2654,64,2.4
40055,1/1/19,1877,1781,96,5.1
40057,1/1/19,1175,1141,34,2.9
40059,1/1/19,1759,1713,46,2.6
40061,1/1/19,4288,4053,235,5.5
40063,1/1/19,5402,5120,282,5.2
40065,1/1/19,10719,10367,352,3.3
40067,1/1/19,2553,2471,82,3.2
40069,1/1/19,3866,3698,168,4.3
40071,1/1/19,18384,17472,912,5
40073,1/1/19,9332,9116,216,2.3
40075,1/1/19,3494,3355,139,4
40077,1/1/19,3143,2936,207,6.6
40079,1/1/19,19032,18015,1017,5.3
40081,1/1/19,15647,15022,625,4
40083,1/1/19,21836,21119,717,3.3
40085,1/1/19,6194,6067,127,2.1
40087,1/1/19,19438,18853,585,3
40089,1/1/19,14385,13421,964,6.7
40091,1/1/19,6895,6427,468,6.8
40093,1/1/19,4041,3953,88,2.2
40095,1/1/19,6756,6474,282,4.2
40097,1/1/19,19272,18585,687,3.6
40099,1/1/19,6150,5949,201,3.3
40101,1/1/19,28790,27553,1237,4.3
40103,1/1/19,5718,5568,150,2.6
40105,1/1/19,4563,4370,193,4.2
40107,1/1/19,4623,4397,226,4.9
40109,1/1/19,380189,366319,13870,3.6
40111,1/1/19,15549,14693,856,5.5
40113,1/1/19,20482,19569,913,4.5
40115,1/1/19,14171,13627,544,3.8
40117,1/1/19,7314,6969,345,4.7
40119,1/1/19,37637,36383,1254,3.3
40121,1/1/19,17653,16911,742,4.2
40123,1/1/19,18771,17976,795,4.2
40125,1/1/19,32250,30933,1317,4.1
40127,1/1/19,4497,4251,246,5.5
40129,1/1/19,1931,1879,52,2.7
40131,1/1/19,44479,42901,1578,3.5
40133,1/1/19,9542,9002,540,5.7
40135,1/1/19,16170,15405,765,4.7
40137,1/1/19,18689,17893,796,4.3
40139,1/1/19,11333,11089,244,2.2
40141,1/1/19,3074,2959,115,3.7
40143,1/1/19,319116,307654,11462,3.6
40145,1/1/19,37485,36128,1357,3.6
40147,1/1/19,22332,21434,898,4
40149,1/1/19,5265,5097,168,3.2
40151,1/1/19,4636,4530,106,2.3
40153,1/1/19,8980,8724,256,2.9
41001,1/1/19,7102,6595,507,7.1
41003,1/1/19,48107,46499,1608,3.3
41005,1/1/19,218408,209499,8909,4.1
41007,1/1/19,18822,17847,975,5.2
41009,1/1/19,24452,23114,1338,5.5
41011,1/1/19,26135,24479,1656,6.3
41013,1/1/19,9492,8764,728,7.7
41015,1/1/19,8623,7937,686,8
41017,1/1/19,95294,90007,5287,5.5
41019,1/1/19,46670,43705,2965,6.4
41021,1/1/19,940,896,44,4.7
41023,1/1/19,3205,2750,455,14.2
41025,1/1/19,3569,3180,389,10.9
41027,1/1/19,13857,13316,541,3.9
41029,1/1/19,102959,97011,5948,5.8
41031,1/1/19,10122,9323,799,7.9
41033,1/1/19,35758,33306,2452,6.9
41035,1/1/19,29491,26717,2774,9.4
41037,1/1/19,3579,3224,355,9.9
41039,1/1/19,180816,171779,9037,5
41041,1/1/19,20586,19392,1194,5.8
41043,1/1/19,58979,55835,3144,5.3
41045,1/1/19,12062,11282,780,6.5
41047,1/1/19,159582,151743,7839,4.9
41049,1/1/19,5558,5219,339,6.1
41051,1/1/19,453953,435902,18051,4
41053,1/1/19,39505,37518,1987,5
41055,1/1/19,882,846,36,4.1
41057,1/1/19,11743,11141,602,5.1
41059,1/1/19,36290,33336,2954,8.1
41061,1/1/19,11997,11100,897,7.5
41063,1/1/19,3324,3024,300,9
41065,1/1/19,12575,11816,759,6
41067,1/1/19,323187,311492,11695,3.6
41069,1/1/19,697,661,36,5.2
41071,1/1/19,54410,52212,2198,4
42001,1/1/19,54508,52564,1944,3.6
42003,1/1/19,643867,616301,27566,4.3
42005,1/1/19,32166,30228,1938,6
42007,1/1/19,83507,79441,4066,4.9
42009,1/1/19,23387,22046,1341,5.7
42011,1/1/19,212994,203450,9544,4.5
42013,1/1/19,58993,56245,2748,4.7
42015,1/1/19,28726,27327,1399,4.9
42017,1/1/19,341993,328387,13606,4
42019,1/1/19,99261,94862,4399,4.4
42021,1/1/19,57609,54315,3294,5.7
42023,1/1/19,2057,1937,120,5.8
42025,1/1/19,31967,30174,1793,5.6
42027,1/1/19,78682,75951,2731,3.5
42029,1/1/19,281376,272344,9032,3.2
42031,1/1/19,17022,16048,974,5.7
42033,1/1/19,36028,33794,2234,6.2
42035,1/1/19,18320,17075,1245,6.8
42037,1/1/19,33111,31284,1827,5.5
42039,1/1/19,38368,36358,2010,5.2
42041,1/1/19,130210,125847,4363,3.4
42043,1/1/19,142452,136755,5697,4
42045,1/1/19,296585,284529,12056,4.1
42047,1/1/19,15844,15197,647,4.1
42049,1/1/19,127963,121443,6520,5.1
42051,1/1/19,57130,53178,3952,6.9
42053,1/1/19,1814,1666,148,8.2
42055,1/1/19,77057,73971,3086,4
42057,1/1/19,7790,7419,371,4.8
42059,1/1/19,16580,15725,855,5.2
42061,1/1/19,19596,18123,1473,7.5
42063,1/1/19,38292,36103,2189,5.7
42065,1/1/19,20530,19425,1105,5.4
42067,1/1/19,12358,11694,664,5.4
42069,1/1/19,104461,99010,5451,5.2
42071,1/1/19,280179,270277,9902,3.5
42073,1/1/19,40614,38129,2485,6.1
42075,1/1/19,71166,68273,2893,4.1
42077,1/1/19,191800,182772,9028,4.7
42079,1/1/19,156832,147145,9687,6.2
42081,1/1/19,56891,53792,3099,5.4
42083,1/1/19,17184,16238,946,5.5
42085,1/1/19,49243,46714,2529,5.1
42087,1/1/19,20827,19711,1116,5.4
42089,1/1/19,83041,78386,4655,5.6
42091,1/1/19,451929,435809,16120,3.6
42093,1/1/19,8975,8611,364,4.1
42095,1/1/19,160576,153057,7519,4.7
42097,1/1/19,42649,39913,2736,6.4
42099,1/1/19,24081,23100,981,4.1
42101,1/1/19,716709,676029,40680,5.7
42103,1/1/19,25071,23583,1488,5.9
42105,1/1/19,7092,6556,536,7.6
42107,1/1/19,66087,62277,3810,5.8
42109,1/1/19,19704,18737,967,4.9
42111,1/1/19,33990,31871,2119,6.2
42113,1/1/19,2607,2449,158,6.1
42115,1/1/19,20289,19270,1019,5
42117,1/1/19,18708,17516,1192,6.4
42119,1/1/19,19923,19111,812,4.1
42121,1/1/19,22420,21253,1167,5.2
42123,1/1/19,18966,18010,956,5
42125,1/1/19,106355,101229,5126,4.8
42127,1/1/19,22035,20700,1335,6.1
42129,1/1/19,180112,171209,8903,4.9
42131,1/1/19,13518,12732,786,5.8
42133,1/1/19,234766,225580,9186,3.9
44001,1/1/19,25833,24829,1004,3.9
44003,1/1/19,90241,86436,3805,4.2
44005,1/1/19,44324,42231,2093,4.7
44007,1/1/19,323575,308016,15559,4.8
44009,1/1/19,68541,65646,2895,4.2
45001,1/1/19,10153,9667,486,4.8
45003,1/1/19,75094,72324,2770,3.7
45005,1/1/19,2793,2604,189,6.8
45007,1/1/19,91171,87809,3362,3.7
45009,1/1/19,5134,4765,369,7.2
45011,1/1/19,8383,7937,446,5.3
45013,1/1/19,75757,73003,2754,3.6
45015,1/1/19,102818,99209,3609,3.5
45017,1/1/19,6609,6283,326,4.9
45019,1/1/19,209274,202633,6641,3.2
45021,1/1/19,24946,23937,1009,4
45023,1/1/19,13378,12650,728,5.4
45025,1/1/19,22310,21435,875,3.9
45027,1/1/19,12906,12221,685,5.3
45029,1/1/19,16719,15985,734,4.4
45031,1/1/19,30648,29258,1390,4.5
45033,1/1/19,13269,12541,728,5.5
45035,1/1/19,77318,74600,2718,3.5
45037,1/1/19,10836,10434,402,3.7
45039,1/1/19,9680,9045,635,6.6
45041,1/1/19,67295,64486,2809,4.2
45043,1/1/19,25166,23659,1507,6
45045,1/1/19,254363,245900,8463,3.3
45047,1/1/19,31616,30288,1328,4.2
45049,1/1/19,8435,8112,323,3.8
45051,1/1/19,142487,133794,8693,6.1
45053,1/1/19,12435,12001,434,3.5
45055,1/1/19,29123,27960,1163,4
45057,1/1/19,41033,39206,1827,4.5
45059,1/1/19,30211,29041,1170,3.9
45061,1/1/19,6665,6310,355,5.3
45063,1/1/19,148750,144009,4741,3.2
45065,1/1/19,3409,3249,160,4.7
45067,1/1/19,13073,12239,834,6.4
45069,1/1/19,9330,8810,520,5.6
45071,1/1/19,19296,18623,673,3.5
45073,1/1/19,34889,33573,1316,3.8
45075,1/1/19,35446,33207,2239,6.3
45077,1/1/19,57401,55241,2160,3.8
45079,1/1/19,197280,189282,7998,4.1
45081,1/1/19,9019,8707,312,3.5
45083,1/1/19,152583,147315,5268,3.5
45085,1/1/19,43923,41974,1949,4.4
45087,1/1/19,11642,11110,532,4.6
45089,1/1/19,12350,11552,798,6.5
45091,1/1/19,139021,133827,5194,3.7
46003,1/1/19,1513,1472,41,2.7
46005,1/1/19,9532,9193,339,3.6
46007,1/1/19,1075,1019,56,5.2
46009,1/1/19,2833,2744,89,3.1
46011,1/1/19,18657,18053,604,3.2
46013,1/1/19,20706,20032,674,3.3
46015,1/1/19,2384,2320,64,2.7
46017,1/1/19,695,660,35,5
46019,1/1/19,5005,4837,168,3.4
46021,1/1/19,750,717,33,4.4
46023,1/1/19,3714,3587,127,3.4
46025,1/1/19,1925,1826,99,5.1
46027,1/1/19,7492,7258,234,3.1
46029,1/1/19,15405,14832,573,3.7
46031,1/1/19,1357,1304,53,3.9
46033,1/1/19,3919,3713,206,5.3
46035,1/1/19,11009,10661,348,3.2
46037,1/1/19,2708,2542,166,6.1
46039,1/1/19,2096,1940,156,7.4
46041,1/1/19,2184,2052,132,6
46043,1/1/19,1539,1490,49,3.2
46045,1/1/19,2045,1981,64,3.1
46047,1/1/19,2961,2811,150,5.1
46049,1/1/19,1049,1014,35,3.3
46051,1/1/19,4445,4242,203,4.6
46053,1/1/19,1979,1902,77,3.9
46055,1/1/19,1061,1023,38,3.6
46057,1/1/19,3220,3080,140,4.3
46059,1/1/19,1793,1742,51,2.8
46061,1/1/19,1761,1657,104,5.9
46063,1/1/19,720,704,16,2.2
46065,1/1/19,9960,9687,273,2.7
46067,1/1/19,3556,3432,124,3.5
46069,1/1/19,691,663,28,4.1
46071,1/1/19,1195,1108,87,7.3
46073,1/1/19,1101,1070,31,2.8
46075,1/1/19,510,492,18,3.5
46077,1/1/19,2641,2544,97,3.7
46079,1/1/19,6534,6277,257,3.9
46081,1/1/19,12747,12340,407,3.2
46083,1/1/19,33965,33062,903,2.7
46085,1/1/19,1610,1536,74,4.6
46087,1/1/19,3050,2951,99,3.2
46089,1/1/19,1026,983,43,4.2
46091,1/1/19,2320,2221,99,4.3
46093,1/1/19,13646,13083,563,4.1
46095,1/1/19,746,708,38,5.1
46097,1/1/19,1164,1129,35,3
46099,1/1/19,111276,107707,3569,3.2
46101,1/1/19,3976,3851,125,3.1
46102,1/1/19,3500,3176,324,9.3
46103,1/1/19,54528,52553,1975,3.6
46105,1/1/19,1418,1375,43,3
46107,1/1/19,1018,987,31,3
46109,1/1/19,4756,4507,249,5.2
46111,1/1/19,1123,1092,31,2.8
46115,1/1/19,3186,3059,127,4
46117,1/1/19,1863,1791,72,3.9
46119,1/1/19,807,782,25,3.1
46121,1/1/19,3205,3009,196,6.1
46123,1/1/19,3048,2957,91,3
46125,1/1/19,4649,4493,156,3.4
46127,1/1/19,8400,8107,293,3.5
46129,1/1/19,2090,1960,130,6.2
46135,1/1/19,11749,11413,336,2.9
46137,1/1/19,924,884,40,4.3
47001,1/1/19,34412,33013,1399,4.1
47003,1/1/19,20935,20118,817,3.9
47005,1/1/19,6939,6594,345,5
47007,1/1/19,4368,4061,307,7
47009,1/1/19,63308,60854,2454,3.9
47011,1/1/19,51149,49137,2012,3.9
47013,1/1/19,14819,14010,809,5.5
47015,1/1/19,6532,6322,210,3.2
47017,1/1/19,12224,11510,714,5.8
47019,1/1/19,23944,22777,1167,4.9
47021,1/1/19,21704,21054,650,3
47023,1/1/19,8532,8214,318,3.7
47025,1/1/19,13017,12395,622,4.8
47027,1/1/19,2885,2700,185,6.4
47029,1/1/19,15082,14102,980,6.5
47031,1/1/19,25295,24386,909,3.6
47033,1/1/19,7063,6756,307,4.3
47035,1/1/19,23423,22067,1356,5.8
47037,1/1/19,400028,388665,11363,2.8
47039,1/1/19,4591,4312,279,6.1
47041,1/1/19,7785,7384,401,5.2
47043,1/1/19,26806,25897,909,3.4
47045,1/1/19,16562,15633,929,5.6
47047,1/1/19,19236,18460,776,4
47049,1/1/19,7555,7203,352,4.7
47051,1/1/19,19876,19196,680,3.4
47053,1/1/19,22105,21011,1094,4.9
47055,1/1/19,15288,14659,629,4.1
47057,1/1/19,9551,9064,487,5.1
47059,1/1/19,30023,28345,1678,5.6
47061,1/1/19,4984,4757,227,4.6
47063,1/1/19,27898,26722,1176,4.2
47065,1/1/19,182831,176310,6521,3.6
47067,1/1/19,2155,1992,163,7.6
47069,1/1/19,9551,9010,541,5.7
47071,1/1/19,10361,9851,510,4.9
47073,1/1/19,23828,22768,1060,4.4
47075,1/1/19,7776,7308,468,6
47077,1/1/19,12255,11583,672,5.5
47079,1/1/19,14293,13594,699,4.9
47081,1/1/19,11359,10968,391,3.4
47083,1/1/19,3309,3122,187,5.7
47085,1/1/19,9045,8605,440,4.9
47087,1/1/19,4657,4384,273,5.9
47089,1/1/19,24517,23384,1133,4.6
47091,1/1/19,7720,7392,328,4.2
47093,1/1/19,241895,234198,7697,3.2
47095,1/1/19,1877,1693,184,9.8
47097,1/1/19,9737,9091,646,6.6
47099,1/1/19,19099,18265,834,4.4
47101,1/1/19,5159,4912,247,4.8
47103,1/1/19,16972,16403,569,3.4
47105,1/1/19,23381,22508,873,3.7
47107,1/1/19,23325,22302,1023,4.4
47109,1/1/19,8620,8090,530,6.1
47111,1/1/19,11249,10880,369,3.3
47113,1/1/19,48790,46851,1939,4
47115,1/1/19,12468,11852,616,4.9
47117,1/1/19,15706,15144,562,3.6
47119,1/1/19,48904,47304,1600,3.3
47121,1/1/19,5105,4843,262,5.1
47123,1/1/19,20142,19327,815,4
47125,1/1/19,84660,81112,3548,4.2
47127,1/1/19,3505,3391,114,3.3
47129,1/1/19,7893,7492,401,5.1
47131,1/1/19,13069,11846,1223,9.4
47133,1/1/19,9920,9420,500,5
47135,1/1/19,3209,3009,200,6.2
47137,1/1/19,2287,2145,142,6.2
47139,1/1/19,7419,7067,352,4.7
47141,1/1/19,34866,33508,1358,3.9
47143,1/1/19,13301,12329,972,7.3
47145,1/1/19,23339,22219,1120,4.8
47147,1/1/19,37797,36546,1251,3.3
47149,1/1/19,182143,176984,5159,2.8
47151,1/1/19,8533,8087,446,5.2
47153,1/1/19,6187,5891,296,4.8
47155,1/1/19,53622,50368,3254,6.1
47157,1/1/19,445432,425149,20283,4.6
47159,1/1/19,9422,9079,343,3.6
47161,1/1/19,5428,5102,326,6
47163,1/1/19,70601,67624,2977,4.2
47165,1/1/19,101378,98343,3035,3
47167,1/1/19,28227,26978,1249,4.4
47169,1/1/19,5381,5203,178,3.3
47171,1/1/19,7154,6710,444,6.2
47173,1/1/19,7607,7245,362,4.8
47175,1/1/19,2062,1946,116,5.6
47177,1/1/19,16851,16115,736,4.4
47179,1/1/19,59960,57626,2334,3.9
47181,1/1/19,6393,6009,384,6
47183,1/1/19,16579,15687,892,5.4
47185,1/1/19,12340,11847,493,4
47187,1/1/19,127039,123729,3310,2.6
47189,1/1/19,75999,73672,2327,3.1
48001,1/1/19,23584,22761,823,3.5
48003,1/1/19,9905,9672,233,2.4
48005,1/1/19,36060,34354,1706,4.7
48007,1/1/19,9454,8951,503,5.3
48009,1/1/19,4123,3987,136,3.3
48011,1/1/19,902,875,27,3
48013,1/1/19,21440,20552,888,4.1
48015,1/1/19,13946,13392,554,4
48017,1/1/19,2396,2292,104,4.3
48019,1/1/19,9969,9586,383,3.8
48021,1/1/19,42322,40753,1569,3.7
48023,1/1/19,1711,1662,49,2.9
48025,1/1/19,9810,9317,493,5
48027,1/1/19,143304,136806,6498,4.5
48029,1/1/19,940121,906427,33694,3.6
48031,1/1/19,6383,6200,183,2.9
48033,1/1/19,348,337,11,3.2
48035,1/1/19,8250,7913,337,4.1
48037,1/1/19,39880,37727,2153,5.4
48039,1/1/19,178064,169803,8261,4.6
48041,1/1/19,116677,113110,3567,3.1
48043,1/1/19,4181,4029,152,3.6
48045,1/1/19,550,526,24,4.4
48047,1/1/19,2651,2503,148,5.6
48049,1/1/19,16050,15429,621,3.9
48051,1/1/19,8196,7897,299,3.6
48053,1/1/19,23279,22556,723,3.1
48055,1/1/19,19416,18626,790,4.1
48057,1/1/19,11904,11454,450,3.8
48059,1/1/19,6023,5803,220,3.7
48061,1/1/19,166934,156108,10826,6.5
48063,1/1/19,4913,4675,238,4.8
48065,1/1/19,2935,2845,90,3.1
48067,1/1/19,12330,11709,621,5
48069,1/1/19,3276,3165,111,3.4
48071,1/1/19,19431,18380,1051,5.4
48073,1/1/19,20892,19971,921,4.4
48075,1/1/19,2903,2821,82,2.8
48077,1/1/19,4903,4722,181,3.7
48079,1/1/19,1039,995,44,4.2
48081,1/1/19,1422,1370,52,3.7
48083,1/1/19,2907,2774,133,4.6
48085,1/1/19,556550,536995,19555,3.5
48087,1/1/19,1120,1082,38,3.4
48089,1/1/19,9739,9399,340,3.5
48091,1/1/19,72700,70220,2480,3.4
48093,1/1/19,5409,5205,204,3.8
48095,1/1/19,1034,997,37,3.6
48097,1/1/19,19544,18899,645,3.3
48099,1/1/19,24005,22902,1103,4.6
48101,1/1/19,542,516,26,4.8
48103,1/1/19,1535,1469,66,4.3
48105,1/1/19,1604,1558,46,2.9
48107,1/1/19,2402,2298,104,4.3
48109,1/1/19,1005,968,37,3.7
48111,1/1/19,3846,3756,90,2.3
48113,1/1/19,1350914,1295893,55021,4.1
48115,1/1/19,4674,4477,197,4.2
48117,1/1/19,8139,7883,256,3.1
48119,1/1/19,2429,2339,90,3.7
48121,1/1/19,488088,471592,16496,3.4
48123,1/1/19,9756,9459,297,3
48125,1/1/19,664,630,34,5.1
48127,1/1/19,7538,7331,207,2.7
48129,1/1/19,1459,1393,66,4.5
48131,1/1/19,5053,4803,250,4.9
48133,1/1/19,8672,8369,303,3.5
48135,1/1/19,88135,85741,2394,2.7
48137,1/1/19,917,885,32,3.5
48139,1/1/19,91653,88280,3373,3.7
48141,1/1/19,361870,345882,15988,4.4
48143,1/1/19,20395,19674,721,3.5
48145,1/1/19,6471,6222,249,3.8
48147,1/1/19,17059,16496,563,3.3
48149,1/1/19,12477,12117,360,2.9
48151,1/1/19,1597,1545,52,3.3
48153,1/1/19,2499,2366,133,5.3
48155,1/1/19,565,542,23,4.1
48157,1/1/19,389888,374239,15649,4
48159,1/1/19,4580,4374,206,4.5
48161,1/1/19,6352,5997,355,5.6
48163,1/1/19,10364,10062,302,2.9
48165,1/1/19,9599,9344,255,2.7
48167,1/1/19,164806,156853,7953,4.8
48169,1/1/19,2161,2095,66,3.1
48171,1/1/19,13330,12940,390,2.9
48173,1/1/19,737,719,18,2.4
48175,1/1/19,3286,3155,131,4
48177,1/1/19,9413,9117,296,3.1
48179,1/1/19,8001,7675,326,4.1
48181,1/1/19,63450,61262,2188,3.4
48183,1/1/19,58047,55604,2443,4.2
48185,1/1/19,11110,10646,464,4.2
48187,1/1/19,80617,77829,2788,3.5
48189,1/1/19,12259,11666,593,4.8
48191,1/1/19,1042,995,47,4.5
48193,1/1/19,3657,3533,124,3.4
48195,1/1/19,2742,2666,76,2.8
48197,1/1/19,1683,1620,63,3.7
48199,1/1/19,25395,24030,1365,5.4
48201,1/1/19,2306972,2204087,102885,4.5
48203,1/1/19,29406,28055,1351,4.6
48205,1/1/19,2748,2693,55,2
48207,1/1/19,2210,2126,84,3.8
48209,1/1/19,118372,114345,4027,3.4
48211,1/1/19,1930,1878,52,2.7
48213,1/1/19,36065,34606,1459,4
48215,1/1/19,354185,328045,26140,7.4
48217,1/1/19,16109,15478,631,3.9
48219,1/1/19,11284,10918,366,3.2
48221,1/1/19,27268,26226,1042,3.8
48223,1/1/19,17351,16727,624,3.6
48225,1/1/19,10127,9753,374,3.7
48227,1/1/19,14016,13562,454,3.2
48229,1/1/19,1779,1688,91,5.1
48231,1/1/19,42886,41135,1751,4.1
48233,1/1/19,8637,8181,456,5.3
48235,1/1/19,752,731,21,2.8
48237,1/1/19,3441,3321,120,3.5
48239,1/1/19,7401,7146,255,3.4
48241,1/1/19,13006,12074,932,7.2
48243,1/1/19,1023,982,41,4
48245,1/1/19,107454,100216,7238,6.7
48247,1/1/19,1926,1813,113,5.9
48249,1/1/19,17063,16195,868,5.1
48251,1/1/19,81439,78302,3137,3.9
48253,1/1/19,5595,5316,279,5
48255,1/1/19,7055,6861,194,2.7
48257,1/1/19,63768,61363,2405,3.8
48259,1/1/19,21844,21170,674,3.1
48261,1/1/19,237,228,9,3.8
48263,1/1/19,441,429,12,2.7
48265,1/1/19,21902,21133,769,3.5
48267,1/1/19,1785,1718,67,3.8
48269,1/1/19,202,196,6,3
48271,1/1/19,1292,1231,61,4.7
48273,1/1/19,13221,12558,663,5
48275,1/1/19,1398,1340,58,4.1
48277,1/1/19,23675,22726,949,4
48279,1/1/19,5169,4928,241,4.7
48281,1/1/19,9150,8792,358,3.9
48283,1/1/19,4611,4500,111,2.4
48285,1/1/19,8628,8338,290,3.4
48287,1/1/19,9723,9409,314,3.2
48289,1/1/19,6256,5942,314,5
48291,1/1/19,32940,31006,1934,5.9
48293,1/1/19,8555,8157,398,4.7
48295,1/1/19,1683,1636,47,2.8
48297,1/1/19,5397,5202,195,3.6
48299,1/1/19,8426,8075,351,4.2
48301,1/1/19,316,311,5,1.6
48303,1/1/19,156900,152017,4883,3.1
48305,1/1/19,2674,2590,84,3.1
48307,1/1/19,3706,3563,143,3.9
48309,1/1/19,118958,114482,4476,3.8
48311,1/1/19,724,709,15,2.1
48313,1/1/19,4518,4314,204,4.5
48315,1/1/19,4254,4039,215,5.1
48317,1/1/19,2822,2737,85,3
48319,1/1/19,1723,1656,67,3.9
48321,1/1/19,16524,15484,1040,6.3
48323,1/1/19,24286,22124,2162,8.9
48325,1/1/19,21535,20731,804,3.7
48327,1/1/19,830,796,34,4.1
48329,1/1/19,106368,103992,2376,2.2
48331,1/1/19,9845,9172,673,6.8
48333,1/1/19,1867,1788,79,4.2
48335,1/1/19,2298,2203,95,4.1
48337,1/1/19,9141,8844,297,3.2
48339,1/1/19,282366,271365,11001,3.9
48341,1/1/19,10661,10367,294,2.8
48343,1/1/19,4726,4426,300,6.3
48345,1/1/19,452,435,17,3.8
48347,1/1/19,28508,27273,1235,4.3
48349,1/1/19,23790,22867,923,3.9
48351,1/1/19,5222,4815,407,7.8
48353,1/1/19,6887,6655,232,3.4
48355,1/1/19,167423,159437,7986,4.8
48357,1/1/19,4356,4229,127,2.9
48359,1/1/19,884,857,27,3.1
48361,1/1/19,36595,34376,2219,6.1
48363,1/1/19,13461,12971,490,3.6
48365,1/1/19,10586,10141,445,4.2
48367,1/1/19,66580,64346,2234,3.4
48369,1/1/19,4773,4651,122,2.6
48371,1/1/19,6472,6240,232,3.6
48373,1/1/19,18043,17030,1013,5.6
48375,1/1/19,54590,52882,1708,3.1
48377,1/1/19,3049,2836,213,7
48379,1/1/19,6045,5824,221,3.7
48381,1/1/19,71080,69046,2034,2.9
48383,1/1/19,1817,1771,46,2.5
48385,1/1/19,1031,978,53,5.1
48387,1/1/19,5051,4770,281,5.6
48389,1/1/19,10867,10678,189,1.7
48391,1/1/19,3138,2993,145,4.6
48393,1/1/19,397,382,15,3.8
48395,1/1/19,7488,7165,323,4.3
48397,1/1/19,51456,49650,1806,3.5
48399,1/1/19,4477,4326,151,3.4
48401,1/1/19,22943,21987,956,4.2
48403,1/1/19,3747,3425,322,8.6
48405,1/1/19,3374,3173,201,6
48407,1/1/19,11660,11033,627,5.4
48409,1/1/19,29847,27987,1860,6.2
48411,1/1/19,2658,2582,76,2.9
48413,1/1/19,1370,1330,40,2.9
48415,1/1/19,6686,6451,235,3.5
48417,1/1/19,1888,1838,50,2.6
48419,1/1/19,10951,10420,531,4.8
48421,1/1/19,1308,1271,37,2.8
48423,1/1/19,106112,101972,4140,3.9
48425,1/1/19,4327,4149,178,4.1
48427,1/1/19,25810,23086,2724,10.6
48429,1/1/19,4166,4024,142,3.4
48431,1/1/19,533,513,20,3.8
48433,1/1/19,561,540,21,3.7
48435,1/1/19,1509,1451,58,3.8
48437,1/1/19,2608,2491,117,4.5
48439,1/1/19,1075567,1031880,43687,4.1
48441,1/1/19,65721,63543,2178,3.3
48443,1/1/19,364,349,15,4.1
48445,1/1/19,4950,4738,212,4.3
48447,1/1/19,628,605,23,3.7
48449,1/1/19,12717,12067,650,5.1
48451,1/1/19,54662,52802,1860,3.4
48453,1/1/19,731787,709071,22716,3.1
48455,1/1/19,5238,4938,300,5.7
48457,1/1/19,7099,6599,500,7
48459,1/1/19,17842,17047,795,4.5
48461,1/1/19,1627,1560,67,4.1
48463,1/1/19,11263,10729,534,4.7
48465,1/1/19,22599,21701,898,4
48467,1/1/19,25729,24762,967,3.8
48469,1/1/19,43090,41435,1655,3.8
48471,1/1/19,24087,23029,1058,4.4
48473,1/1/19,23215,22239,976,4.2
48475,1/1/19,7434,7249,185,2.5
48477,1/1/19,14841,14277,564,3.8
48479,1/1/19,118173,113191,4982,4.2
48481,1/1/19,21006,20205,801,3.8
48483,1/1/19,2213,2138,75,3.4
48485,1/1/19,56592,54509,2083,3.7
48487,1/1/19,5013,4796,217,4.3
48489,1/1/19,6488,5889,599,9.2
48491,1/1/19,309270,299146,10124,3.3
48493,1/1/19,24570,23782,788,3.2
48495,1/1/19,4084,3967,117,2.9
48497,1/1/19,31476,30340,1136,3.6
48499,1/1/19,17479,16684,795,4.5
48501,1/1/19,3733,3620,113,3
48503,1/1/19,7971,7695,276,3.5
48505,1/1/19,5368,5069,299,5.6
48507,1/1/19,3403,3058,345,10.1
49001,1/1/19,2923,2827,96,3.3
49003,1/1/19,25585,24672,913,3.6
49005,1/1/19,63861,62314,1547,2.4
49007,1/1/19,8383,8009,374,4.5
49009,1/1/19,331,310,21,6.3
49011,1/1/19,170712,165714,4998,2.9
49013,1/1/19,7663,7314,349,4.6
49015,1/1/19,4237,3993,244,5.8
49017,1/1/19,2297,1911,386,16.8
49019,1/1/19,5219,4549,670,12.8
49021,1/1/19,23591,22791,800,3.4
49023,1/1/19,5670,5480,190,3.4
49025,1/1/19,3463,3299,164,4.7
49027,1/1/19,5876,5664,212,3.6
49029,1/1/19,5452,5303,149,2.7
49031,1/1/19,471,442,29,6.2
49033,1/1/19,943,893,50,5.3
49035,1/1/19,621470,604355,17115,2.8
49037,1/1/19,5430,4987,443,8.2
49039,1/1/19,12392,11945,447,3.6
49041,1/1/19,9711,9280,431,4.4
49043,1/1/19,26783,26203,580,2.2
49045,1/1/19,33378,32281,1097,3.3
49047,1/1/19,13464,12780,684,5.1
49049,1/1/19,302590,294882,7708,2.5
49051,1/1/19,15951,15503,448,2.8
49053,1/1/19,74105,71419,2686,3.6
49055,1/1/19,1274,1113,161,12.6
49057,1/1/19,127291,121059,6232,4.9
50001,1/1/19,20386,19790,596,2.9
50003,1/1/19,18403,17769,634,3.4
50005,1/1/19,14341,13732,609,4.2
50007,1/1/19,95310,93490,1820,1.9
50009,1/1/19,2680,2558,122,4.6
50011,1/1/19,27162,26371,791,2.9
50013,1/1/19,4016,3874,142,3.5
50015,1/1/19,13985,13409,576,4.1
50017,1/1/19,15870,15324,546,3.4
50019,1/1/19,13625,12842,783,5.7
50021,1/1/19,30661,29715,946,3.1
50023,1/1/19,34567,33454,1113,3.2
50025,1/1/19,22478,21841,637,2.8
50027,1/1/19,29488,28856,632,2.1
51001,1/1/19,16493,15596,897,5.4
51003,1/1/19,56174,54492,1682,3
51005,1/1/19,7041,6731,310,4.4
51007,1/1/19,6257,6000,257,4.1
51009,1/1/19,15007,14465,542,3.6
51011,1/1/19,7164,6864,300,4.2
51013,1/1/19,153119,149328,3791,2.5
51015,1/1/19,37114,36014,1100,3
51017,1/1/19,2419,2331,88,3.6
51019,1/1/19,38436,37149,1287,3.3
51021,1/1/19,2839,2741,98,3.5
51023,1/1/19,17328,16791,537,3.1
51025,1/1/19,6098,5733,365,6
51027,1/1/19,6789,6359,430,6.3
51029,1/1/19,6363,6006,357,5.6
51031,1/1/19,25987,25042,945,3.6
51033,1/1/19,15208,14610,598,3.9
51035,1/1/19,13194,12571,623,4.7
51036,1/1/19,3661,3493,168,4.6
51037,1/1/19,5277,5069,208,3.9
51041,1/1/19,186604,180576,6028,3.2
51043,1/1/19,7526,7288,238,3.2
51045,1/1/19,2292,2205,87,3.8
51047,1/1/19,24414,23611,803,3.3
51049,1/1/19,4632,4447,185,4
51051,1/1/19,4615,4330,285,6.2
51053,1/1/19,13614,13072,542,4
51057,1/1/19,5550,5280,270,4.9
51059,1/1/19,630417,612286,18131,2.9
51061,1/1/19,36887,35749,1138,3.1
51063,1/1/19,7977,7702,275,3.4
51065,1/1/19,13656,13276,380,2.8
51067,1/1/19,26233,25338,895,3.4
51069,1/1/19,47624,46216,1408,3
51071,1/1/19,7696,7383,313,4.1
51073,1/1/19,19422,18804,618,3.2
51075,1/1/19,11177,10792,385,3.4
51077,1/1/19,7913,7620,293,3.7
51079,1/1/19,10289,10011,278,2.7
51081,1/1/19,4339,4157,182,4.2
51083,1/1/19,15682,14985,697,4.4
51085,1/1/19,58912,57209,1703,2.9
51087,1/1/19,181268,175238,6030,3.3
51089,1/1/19,23944,22992,952,4
51091,1/1/19,1237,1200,37,3
51093,1/1/19,19263,18625,638,3.3
51095,1/1/19,36348,35156,1192,3.3
51097,1/1/19,3851,3723,128,3.3
51099,1/1/19,13310,12853,457,3.4
51101,1/1/19,9141,8814,327,3.6
51103,1/1/19,5369,4966,403,7.5
51105,1/1/19,8246,7874,372,4.5
51107,1/1/19,220495,214339,6156,2.8
51109,1/1/19,19571,18899,672,3.4
51111,1/1/19,5378,5190,188,3.5
51113,1/1/19,7282,7087,195,2.7
51115,1/1/19,4121,3966,155,3.8
51117,1/1/19,12785,12190,595,4.7
51119,1/1/19,5216,5041,175,3.4
51121,1/1/19,48766,47119,1647,3.4
51125,1/1/19,7329,7072,257,3.5
51127,1/1/19,12427,12055,372,3
51131,1/1/19,5307,4955,352,6.6
51133,1/1/19,5599,5181,418,7.5
51135,1/1/19,7251,7006,245,3.4
51137,1/1/19,17100,16495,605,3.5
51139,1/1/19,11893,11150,743,6.2
51141,1/1/19,7467,7135,332,4.4
51143,1/1/19,30383,29233,1150,3.8
51145,1/1/19,14083,13648,435,3.1
51147,1/1/19,10435,9980,455,4.4
51149,1/1/19,15015,14430,585,3.9
51153,1/1/19,243944,236033,7911,3.2
51155,1/1/19,15642,15022,620,4
51157,1/1/19,3664,3546,118,3.2
51159,1/1/19,4047,3880,167,4.1
51161,1/1/19,49133,47665,1468,3
51163,1/1/19,10562,10194,368,3.5
51165,1/1/19,42013,40801,1212,2.9
51167,1/1/19,11252,10642,610,5.4
51169,1/1/19,9105,8752,353,3.9
51171,1/1/19,22177,21480,697,3.1
51173,1/1/19,13681,13053,628,4.6
51175,1/1/19,8998,8720,278,3.1
51177,1/1/19,66606,64181,2425,3.6
51179,1/1/19,71605,69075,2530,3.5
51181,1/1/19,3669,3512,157,4.3
51183,1/1/19,3768,3566,202,5.4
51185,1/1/19,15784,14952,832,5.3
51187,1/1/19,20277,19572,705,3.5
51191,1/1/19,26742,25609,1133,4.2
51193,1/1/19,9270,8827,443,4.8
51195,1/1/19,13355,12618,737,5.5
51197,1/1/19,13671,13094,577,4.2
51199,1/1/19,32575,31478,1097,3.4
51510,1/1/19,100621,97819,2802,2.8
51520,1/1/19,7200,6872,328,4.6
51530,1/1/19,3332,3220,112,3.4
51540,1/1/19,25987,25197,790,3
51550,1/1/19,121803,117577,4226,3.5
51570,1/1/19,8779,8442,337,3.8
51580,1/1/19,2421,2303,118,4.9
51590,1/1/19,19349,18359,990,5.1
51595,1/1/19,2329,2187,142,6.1
51600,1/1/19,13346,12986,360,2.7
51610,1/1/19,8517,8310,207,2.4
51620,1/1/19,3559,3397,162,4.6
51630,1/1/19,14080,13488,592,4.2
51640,1/1/19,2910,2795,115,4
51650,1/1/19,64174,61121,3053,4.8
51660,1/1/19,25140,24212,928,3.7
51670,1/1/19,9679,9174,505,5.2
51678,1/1/19,2077,1964,113,5.4
51680,1/1/19,36455,34820,1635,4.5
51683,1/1/19,21933,21205,728,3.3
51685,1/1/19,9347,9022,325,3.5
51690,1/1/19,5474,5242,232,4.2
51700,1/1/19,88403,84612,3791,4.3
51710,1/1/19,110928,106353,4575,4.1
51720,1/1/19,1685,1607,78,4.6
51730,1/1/19,13043,12178,865,6.6
51735,1/1/19,6332,6139,193,3
51740,1/1/19,44022,41992,2030,4.6
51750,1/1/19,8439,8062,377,4.5
51760,1/1/19,117909,113341,4568,3.9
51770,1/1/19,48915,47227,1688,3.5
51775,1/1/19,12905,12498,407,3.2
51790,1/1/19,12147,11749,398,3.3
51800,1/1/19,44272,42692,1580,3.6
51810,1/1/19,231377,223802,7575,3.3
51820,1/1/19,10628,10246,382,3.6
51830,1/1/19,6663,6350,313,4.7
51840,1/1/19,14644,14139,505,3.4
53001,1/1/19,8454,7636,818,9.7
53003,1/1/19,10299,9733,566,5.5
53005,1/1/19,99909,93061,6848,6.9
53007,1/1/19,42559,39558,3001,7.1
53009,1/1/19,28610,26220,2390,8.4
53011,1/1/19,240815,227477,13338,5.5
53013,1/1/19,1797,1661,136,7.6
53015,1/1/19,48008,44614,3394,7.1
53017,1/1/19,20745,19044,1701,8.2
53019,1/1/19,2578,2181,397,15.4
53021,1/1/19,40780,37071,3709,9.1
53023,1/1/19,888,816,72,8.1
53025,1/1/19,44597,40086,4511,10.1
53027,1/1/19,28833,26382,2451,8.5
53029,1/1/19,35430,33255,2175,6.1
53031,1/1/19,12618,11757,861,6.8
53033,1/1/19,1277413,1234136,43277,3.4
53035,1/1/19,127679,120656,7023,5.5
53037,1/1/19,22512,20870,1642,7.3
53039,1/1/19,9757,8978,779,8
53041,1/1/19,34739,32073,2666,7.7
53043,1/1/19,4865,4530,335,6.9
53045,1/1/19,24951,23042,1909,7.7
53047,1/1/19,19025,17034,1991,10.5
53049,1/1/19,8526,7789,737,8.6
53051,1/1/19,5064,4559,505,10
53053,1/1/19,438772,412163,26609,6.1
53055,1/1/19,7903,7477,426,5.4
53057,1/1/19,61932,57902,4030,6.5
53059,1/1/19,5567,5177,390,7
53061,1/1/19,434773,418843,15930,3.7
53063,1/1/19,253648,236406,17242,6.8
53065,1/1/19,19100,17224,1876,9.8
53067,1/1/19,141588,133440,8148,5.8
53069,1/1/19,1370,1255,115,8.4
53071,1/1/19,29091,27192,1899,6.5
53073,1/1/19,114759,108154,6605,5.8
53075,1/1/19,24405,23198,1207,4.9
53077,1/1/19,125892,113066,12826,10.2
54001,1/1/19,7077,6566,511,7.2
54003,1/1/19,57220,54825,2395,4.2
54005,1/1/19,7303,6874,429,5.9
54007,1/1/19,5170,4692,478,9.2
54009,1/1/19,9687,9115,572,5.9
54011,1/1/19,40778,38854,1924,4.7
54013,1/1/19,2594,2173,421,16.2
54015,1/1/19,3168,2807,361,11.4
54017,1/1/19,3848,3656,192,5
54019,1/1/19,16032,14930,1102,6.9
54021,1/1/19,2329,2137,192,8.2
54023,1/1/19,5809,5415,394,6.8
54025,1/1/19,15420,14465,955,6.2
54027,1/1/19,10492,10014,478,4.6
54029,1/1/19,12654,11938,716,5.7
54031,1/1/19,5795,5405,390,6.7
54033,1/1/19,34231,32516,1715,5
54035,1/1/19,13462,12701,761,5.7
54037,1/1/19,29503,28414,1089,3.7
54039,1/1/19,81212,76800,4412,5.4
54041,1/1/19,6960,6545,415,6
54043,1/1/19,7113,6576,537,7.5
54045,1/1/19,10922,10207,715,6.5
54047,1/1/19,4467,3992,475,10.6
54049,1/1/19,25297,23864,1433,5.7
54051,1/1/19,13933,12950,983,7.1
54053,1/1/19,10045,9322,723,7.2
54055,1/1/19,20625,19285,1340,6.5
54057,1/1/19,12347,11647,700,5.7
54059,1/1/19,6711,6241,470,7
54061,1/1/19,53464,51209,2255,4.2
54063,1/1/19,5794,5479,315,5.4
54065,1/1/19,8019,7634,385,4.8
54067,1/1/19,9350,8650,700,7.5
54069,1/1/19,20750,19777,973,4.7
54071,1/1/19,3575,3409,166,4.6
54073,1/1/19,2993,2762,231,7.7
54075,1/1/19,4230,3964,266,6.3
54077,1/1/19,15278,14413,865,5.7
54079,1/1/19,26408,24995,1413,5.4
54081,1/1/19,29979,28314,1665,5.6
54083,1/1/19,11991,11146,845,7
54085,1/1/19,4406,4111,295,6.7
54087,1/1/19,5113,4511,602,11.8
54089,1/1/19,4175,3885,290,6.9
54091,1/1/19,7738,7306,432,5.6
54093,1/1/19,3320,3116,204,6.1
54095,1/1/19,3178,2902,276,8.7
54097,1/1/19,9482,8847,635,6.7
54099,1/1/19,15612,14606,1006,6.4
54101,1/1/19,3256,3023,233,7.2
54103,1/1/19,6622,6084,538,8.1
54105,1/1/19,2294,2065,229,10
54107,1/1/19,36261,33985,2276,6.3
54109,1/1/19,6771,6194,577,8.5
55001,1/1/19,8072,7496,576,7.1
55003,1/1/19,7706,7260,446,5.8
55005,1/1/19,24822,23523,1299,5.2
55007,1/1/19,7454,6933,521,7
55009,1/1/19,140807,136300,4507,3.2
55011,1/1/19,6620,6293,327,4.9
55013,1/1/19,7186,6683,503,7
55015,1/1/19,27608,26779,829,3
55017,1/1/19,33225,31541,1684,5.1
55019,1/1/19,18227,17470,757,4.2
55021,1/1/19,31218,30140,1078,3.5
55023,1/1/19,7850,7452,398,5.1
55025,1/1/19,314773,306739,8034,2.6
55027,1/1/19,47505,45946,1559,3.3
55029,1/1/19,14155,13364,791,5.6
55031,1/1/19,22878,21772,1106,4.8
55033,1/1/19,24126,23097,1029,4.3
55035,1/1/19,57995,55996,1999,3.4
55037,1/1/19,2264,2142,122,5.4
55039,1/1/19,57096,55269,1827,3.2
55041,1/1/19,4064,3800,264,6.5
55043,1/1/19,27768,26742,1026,3.7
55045,1/1/19,21042,20296,746,3.5
55047,1/1/19,9477,9010,467,4.9
55049,1/1/19,13847,13342,505,3.6
55051,1/1/19,2591,2421,170,6.6
55053,1/1/19,10426,9902,524,5
55055,1/1/19,45702,44032,1670,3.7
55057,1/1/19,13339,12793,546,4.1
55059,1/1/19,88029,84379,3650,4.1
55061,1/1/19,11288,10820,468,4.1
55063,1/1/19,65574,63398,2176,3.3
55065,1/1/19,10311,9974,337,3.3
55067,1/1/19,9515,9040,475,5
55069,1/1/19,15217,14580,637,4.2
55071,1/1/19,41130,39536,1594,3.9
55073,1/1/19,73659,71378,2281,3.1
55075,1/1/19,19474,18471,1003,5.2
55077,1/1/19,7680,7278,402,5.2
55078,1/1/19,1618,1524,94,5.8
55079,1/1/19,461607,443152,18455,4
55081,1/1/19,23555,22660,895,3.8
55083,1/1/19,20762,19840,922,4.4
55085,1/1/19,17614,16685,929,5.3
55087,1/1/19,102654,99254,3400,3.3
55089,1/1/19,48601,47218,1383,2.8
55091,1/1/19,4188,3974,214,5.1
55093,1/1/19,25549,24446,1103,4.3
55095,1/1/19,24880,23392,1488,6
55097,1/1/19,38179,36733,1446,3.8
55099,1/1/19,6520,6226,294,4.5
55101,1/1/19,98045,93829,4216,4.3
55103,1/1/19,9415,9069,346,3.7
55105,1/1/19,84426,81176,3250,3.8
55107,1/1/19,7060,6641,419,5.9
55109,1/1/19,50508,48392,2116,4.2
55111,1/1/19,35273,34084,1189,3.4
55113,1/1/19,7734,7296,438,5.7
55115,1/1/19,21466,20625,841,3.9
55117,1/1/19,61728,59996,1732,2.8
55119,1/1/19,11324,10737,587,5.2
55121,1/1/19,16307,15545,762,4.7
55123,1/1/19,15609,14961,648,4.2
55125,1/1/19,9708,9178,530,5.5
55127,1/1/19,56839,54737,2102,3.7
55129,1/1/19,7756,7343,413,5.3
55131,1/1/19,76672,74321,2351,3.1
55133,1/1/19,222406,215678,6728,3
55135,1/1/19,26162,25184,978,3.7
55137,1/1/19,11816,11230,586,5
55139,1/1/19,90800,88052,2748,3
55141,1/1/19,35216,33586,1630,4.6
56001,1/1/19,19716,19042,674,3.4
56003,1/1/19,5063,4787,276,5.5
56005,1/1/19,22885,22020,865,3.8
56007,1/1/19,7623,7290,333,4.4
56009,1/1/19,8158,7908,250,3.1
56011,1/1/19,3620,3488,132,3.6
56013,1/1/19,18545,17502,1043,5.6
56015,1/1/19,6665,6447,218,3.3
56017,1/1/19,2189,2096,93,4.2
56019,1/1/19,4138,3929,209,5.1
56021,1/1/19,48645,46672,1973,4.1
56023,1/1/19,8757,8373,384,4.4
56025,1/1/19,38959,37206,1753,4.5
56027,1/1/19,1268,1232,36,2.8
56029,1/1/19,14535,13732,803,5.5
56031,1/1/19,4795,4611,184,3.8
56033,1/1/19,15441,14726,715,4.6
56035,1/1/19,4046,3838,208,5.1
56037,1/1/19,21213,20263,950,4.5
56039,1/1/19,15217,14790,427,2.8
56041,1/1/19,8941,8562,379,4.2
56043,1/1/19,3988,3798,190,4.8
56045,1/1/19,3839,3709,130,3.4
72001,1/1/19,4156,3490,666,16
72003,1/1/19,11699,10484,1215,10.4
72005,1/1/19,14241,12800,1441,10.1
72007,1/1/19,6339,5782,557,8.8
72009,1/1/19,6290,5663,627,10
72011,1/1/19,8651,7923,728,8.4
72013,1/1/19,23160,21046,2114,9.1
72015,1/1/19,4588,4009,579,12.6
72017,1/1/19,5711,5111,600,10.5
72019,1/1/19,7178,6580,598,8.3
72021,1/1/19,63238,59598,3640,5.8
72023,1/1/19,13139,12034,1105,8.4
72025,1/1/19,46396,43359,3037,6.5
72027,1/1/19,9227,8476,751,8.1
72029,1/1/19,15569,14575,994,6.4
72031,1/1/19,59601,56328,3273,5.5
72033,1/1/19,7596,7087,509,6.7
72035,1/1/19,15683,14615,1068,6.8
72037,1/1/19,3647,3255,392,10.7
72039,1/1/19,3571,3223,348,9.7
72041,1/1/19,15129,14063,1066,7
72043,1/1/19,9780,8675,1105,11.3
72045,1/1/19,4742,4354,388,8.2
72047,1/1/19,8684,7952,732,8.4
72049,1/1/19,897,874,23,2.6
72051,1/1/19,12741,12104,637,5
72053,1/1/19,10742,9569,1173,10.9
72054,1/1/19,3217,2877,340,10.6
72055,1/1/19,3852,3328,524,13.6
72057,1/1/19,10924,9637,1287,11.8
72059,1/1/19,4787,4092,695,14.5
72061,1/1/19,36565,35200,1365,3.7
72063,1/1/19,17508,16566,942,5.4
72065,1/1/19,13376,11578,1798,13.4
72067,1/1/19,5237,4806,431,8.2
72069,1/1/19,16742,15063,1679,10
72071,1/1/19,12308,11205,1103,9
72073,1/1/19,4082,3678,404,9.9
72075,1/1/19,14666,13313,1353,9.2
72077,1/1/19,11847,10931,916,7.7
72079,1/1/19,5081,4442,639,12.6
72081,1/1/19,6846,5753,1093,16
72083,1/1/19,2652,2341,311,11.7
72085,1/1/19,10912,10023,889,8.1
72087,1/1/19,8112,7561,551,6.8
72089,1/1/19,6072,5464,608,10
72091,1/1/19,11245,10451,794,7.1
72093,1/1/19,1913,1651,262,13.7
72095,1/1/19,2888,2447,441,15.3
72097,1/1/19,21358,19116,2242,10.5
72099,1/1/19,10259,9199,1060,10.3
72101,1/1/19,7698,7046,652,8.5
72103,1/1/19,7950,7245,705,8.9
72105,1/1/19,6828,6302,526,7.7
72107,1/1/19,4888,4364,524,10.7
72109,1/1/19,4377,3633,744,17
72111,1/1/19,5706,4986,720,12.6
72113,1/1/19,44557,40524,4033,9.1
72115,1/1/19,5945,5225,720,12.1
72117,1/1/19,4770,4024,746,15.6
72119,1/1/19,16419,15252,1167,7.1
72121,1/1/19,5927,5197,730,12.3
72123,1/1/19,7196,6258,938,13
72125,1/1/19,9380,8392,988,10.5
72127,1/1/19,130522,123758,6764,5.2
72129,1/1/19,11359,10379,980,8.6
72131,1/1/19,10185,8754,1431,14.1
72133,1/1/19,10066,9262,804,8
72135,1/1/19,26271,24861,1410,5.4
72137,1/1/19,28252,26751,1501,5.3
72139,1/1/19,26262,25060,1202,4.6
72141,1/1/19,6493,5808,685,10.5
72143,1/1/19,9381,8670,711,7.6
72145,1/1/19,12761,11647,1114,8.7
72147,1/1/19,2633,2419,214,8.1
72149,1/1/19,7469,6211,1258,16.8
72151,1/1/19,8579,7490,1089,12.7
72153,1/1/19,9697,8282,1415,14.6
1001,2/1/19,26256,25353,903,3.4
1003,2/1/19,95901,92454,3447,3.6
1005,2/1/19,8420,8026,394,4.7
1007,2/1/19,8702,8358,344,4
1009,2/1/19,25302,24432,870,3.4
1011,2/1/19,4830,4631,199,4.1
1013,2/1/19,9160,8763,397,4.3
1015,2/1/19,46263,44179,2084,4.5
1017,2/1/19,15694,15120,574,3.7
1019,2/1/19,11728,11243,485,4.1
1021,2/1/19,19832,19137,695,3.5
1023,2/1/19,4911,4635,276,5.6
1025,2/1/19,7720,7152,568,7.4
1027,2/1/19,6128,5889,239,3.9
1029,2/1/19,5850,5607,243,4.2
1031,2/1/19,21597,20768,829,3.8
1033,2/1/19,23715,22538,1177,5
1035,2/1/19,4553,4322,231,5.1
1037,2/1/19,4527,4356,171,3.8
1039,2/1/19,15706,15016,690,4.4
1041,2/1/19,6525,6270,255,3.9
1043,2/1/19,38678,37452,1226,3.2
1045,2/1/19,20833,19981,852,4.1
1047,2/1/19,14996,13937,1059,7.1
1049,2/1/19,30855,29706,1149,3.7
1051,2/1/19,37654,36437,1217,3.2
1053,2/1/19,14671,14025,646,4.4
1055,2/1/19,42937,41153,1784,4.2
1057,2/1/19,6606,6354,252,3.8
1059,2/1/19,14651,14124,527,3.6
1061,2/1/19,11038,10623,415,3.8
1063,2/1/19,2880,2697,183,6.4
1065,2/1/19,6140,5853,287,4.7
1067,2/1/19,6964,6632,332,4.8
1069,2/1/19,46352,44559,1793,3.9
1071,2/1/19,23668,22719,949,4
1073,2/1/19,319084,307501,11583,3.6
1075,2/1/19,5839,5620,219,3.8
1077,2/1/19,42419,40693,1726,4.1
1079,2/1/19,14295,13715,580,4.1
1081,2/1/19,76301,73667,2634,3.5
1083,2/1/19,43835,42332,1503,3.4
1085,2/1/19,3629,3374,255,7
1087,2/1/19,7821,7400,421,5.4
1089,2/1/19,184948,178985,5963,3.2
1091,2/1/19,7736,7386,350,4.5
1093,2/1/19,12928,12362,566,4.4
1095,2/1/19,43767,42370,1397,3.2
1097,2/1/19,190591,181422,9169,4.8
1099,2/1/19,7324,6875,449,6.1
1101,2/1/19,106433,102257,4176,3.9
1103,2/1/19,58161,56258,1903,3.3
1105,2/1/19,3454,3249,205,5.9
1107,2/1/19,7961,7615,346,4.3
1109,2/1/19,15558,14922,636,4.1
1111,2/1/19,9573,9198,375,3.9
1113,2/1/19,24141,23254,887,3.7
1115,2/1/19,40507,39131,1376,3.4
1117,2/1/19,115798,112584,3214,2.8
1119,2/1/19,4765,4516,249,5.2
1121,2/1/19,36047,34538,1509,4.2
1123,2/1/19,18212,17489,723,4
1125,2/1/19,105327,101817,3510,3.3
1127,2/1/19,25366,24291,1075,4.2
1129,2/1/19,6905,6502,403,5.8
1131,2/1/19,2800,2536,264,9.4
1133,2/1/19,9911,9497,414,4.2
2013,2/1/19,3175,3110,65,2
2016,2/1/19,4759,4632,127,2.7
2020,2/1/19,146967,138920,8047,5.5
2050,2/1/19,7070,6088,982,13.9
2060,2/1/19,244,204,40,16.4
2068,2/1/19,579,462,117,20.2
2070,2/1/19,1890,1712,178,9.4
2090,2/1/19,44307,41548,2759,6.2
2100,2/1/19,890,755,135,15.2
2105,2/1/19,996,794,202,20.3
2110,2/1/19,16431,15531,900,5.5
2122,2/1/19,25190,23037,2153,8.5
2130,2/1/19,6231,5726,505,8.1
2150,2/1/19,6067,5753,314,5.2
2158,2/1/19,2807,2205,602,21.4
2164,2/1/19,623,529,94,15.1
2170,2/1/19,47201,43473,3728,7.9
2180,2/1/19,4047,3557,490,12.1
2185,2/1/19,3659,3440,219,6
2188,2/1/19,2849,2439,410,14.4
2195,2/1/19,1275,1129,146,11.5
2198,2/1/19,2837,2420,417,14.7
2220,2/1/19,3979,3788,191,4.8
2230,2/1/19,603,467,136,22.6
2240,2/1/19,2768,2442,326,11.8
2261,2/1/19,4094,3658,436,10.6
2275,2/1/19,966,867,99,10.2
2282,2/1/19,217,191,26,12
2290,2/1/19,2509,2066,443,17.7
4001,2/1/19,20569,18467,2102,10.2
4003,2/1/19,50253,47307,2946,5.9
4005,2/1/19,76069,71347,4722,6.2
4007,2/1/19,21416,20206,1210,5.6
4009,2/1/19,15524,14752,772,5
4011,2/1/19,4433,4253,180,4.1
4012,2/1/19,9398,8818,580,6.2
4013,2/1/19,2282471,2187676,94795,4.2
4015,2/1/19,86395,81434,4961,5.7
4017,2/1/19,40383,37106,3277,8.1
4019,2/1/19,496016,473738,22278,4.5
4021,2/1/19,185761,176445,9316,5
4023,2/1/19,19861,18388,1473,7.4
4025,2/1/19,104703,99948,4755,4.5
4027,2/1/19,97638,85596,12042,12.3
5001,2/1/19,9312,8957,355,3.8
5003,2/1/19,7859,7384,475,6
5005,2/1/19,16293,15513,780,4.8
5007,2/1/19,135850,131637,4213,3.1
5009,2/1/19,16000,15393,607,3.8
5011,2/1/19,4512,4276,236,5.2
5013,2/1/19,2448,2307,141,5.8
5015,2/1/19,12232,11665,567,4.6
5017,2/1/19,3271,3009,262,8
5019,2/1/19,9728,9375,353,3.6
5021,2/1/19,5632,5289,343,6.1
5023,2/1/19,9220,8720,500,5.4
5025,2/1/19,3214,3067,147,4.6
5027,2/1/19,9180,8750,430,4.7
5029,2/1/19,8149,7769,380,4.7
5031,2/1/19,54935,53166,1769,3.2
5033,2/1/19,26826,25765,1061,4
5035,2/1/19,21205,20205,1000,4.7
5037,2/1/19,7299,6930,369,5.1
5039,2/1/19,2814,2659,155,5.5
5041,2/1/19,5396,5131,265,4.9
5043,2/1/19,7827,7355,472,6
5045,2/1/19,62438,60306,2132,3.4
5047,2/1/19,7394,7117,277,3.7
5049,2/1/19,4890,4648,242,4.9
5051,2/1/19,41300,39553,1747,4.2
5053,2/1/19,8368,8084,284,3.4
5055,2/1/19,19983,19174,809,4
5057,2/1/19,10028,9604,424,4.2
5059,2/1/19,13893,13334,559,4
5061,2/1/19,5735,5528,207,3.6
5063,2/1/19,16485,15751,734,4.5
5065,2/1/19,4890,4606,284,5.8
5067,2/1/19,5819,5409,410,7
5069,2/1/19,27839,26207,1632,5.9
5071,2/1/19,10416,9887,529,5.1
5073,2/1/19,2481,2355,126,5.1
5075,2/1/19,6821,6481,340,5
5077,2/1/19,2815,2658,157,5.6
5079,2/1/19,3934,3739,195,5
5081,2/1/19,5479,5193,286,5.2
5083,2/1/19,8545,8162,383,4.5
5085,2/1/19,34317,33134,1183,3.4
5087,2/1/19,7297,7064,233,3.2
5089,2/1/19,6631,6314,317,4.8
5091,2/1/19,19593,18628,965,4.9
5093,2/1/19,17181,16274,907,5.3
5095,2/1/19,2761,2631,130,4.7
5097,2/1/19,2904,2737,167,5.8
5099,2/1/19,3690,3543,147,4
5101,2/1/19,3321,3173,148,4.5
5103,2/1/19,9843,9245,598,6.1
5105,2/1/19,4282,4069,213,5
5107,2/1/19,6464,6021,443,6.9
5109,2/1/19,4186,4001,185,4.4
5111,2/1/19,10096,9702,394,3.9
5113,2/1/19,8035,7667,368,4.6
5115,2/1/19,29063,27700,1363,4.7
5117,2/1/19,3508,3335,173,4.9
5119,2/1/19,190358,183185,7173,3.8
5121,2/1/19,7233,6902,331,4.6
5123,2/1/19,8165,7658,507,6.2
5125,2/1/19,59173,57260,1913,3.2
5127,2/1/19,4296,4129,167,3.9
5129,2/1/19,2805,2663,142,5.1
5131,2/1/19,56586,54361,2225,3.9
5133,2/1/19,5518,5235,283,5.1
5135,2/1/19,5791,5455,336,5.8
5137,2/1/19,4681,4379,302,6.5
5139,2/1/19,15876,14979,897,5.7
5141,2/1/19,5715,5373,342,6
5143,2/1/19,123613,120115,3498,2.8
5145,2/1/19,33890,32099,1791,5.3
5147,2/1/19,2735,2574,161,5.9
5149,2/1/19,8450,8037,413,4.9
6001,2/1/19,846722,820476,26246,3.1
6003,2/1/19,690,662,28,4.1
6005,2/1/19,14676,13989,687,4.7
6007,2/1/19,100619,94371,6248,6.2
6009,2/1/19,21021,20042,979,4.7
6011,2/1/19,11065,8814,2251,20.3
6013,2/1/19,563835,545005,18830,3.3
6015,2/1/19,9644,9019,625,6.5
6017,2/1/19,92479,88662,3817,4.1
6019,2/1/19,451352,411227,40125,8.9
6021,2/1/19,13143,12122,1021,7.8
6023,2/1/19,62860,60193,2667,4.2
6025,2/1/19,71306,59103,12203,17.1
6027,2/1/19,8712,8319,393,4.5
6029,2/1/19,391062,355228,35834,9.2
6031,2/1/19,58793,52999,5794,9.9
6033,2/1/19,29447,27670,1777,6
6035,2/1/19,9976,9378,598,6
6037,2/1/19,5129311,4895412,233899,4.6
6039,2/1/19,63514,58314,5200,8.2
6041,2/1/19,139413,135969,3444,2.5
6043,2/1/19,7364,6863,501,6.8
6045,2/1/19,38982,36992,1990,5.1
6047,2/1/19,117498,105278,12220,10.4
6049,2/1/19,3090,2756,334,10.8
6051,2/1/19,8998,8654,344,3.8
6053,2/1/19,214512,192280,22232,10.4
6055,2/1/19,73037,70568,2469,3.4
6057,2/1/19,49216,47315,1901,3.9
6059,2/1/19,1630270,1582044,48226,3
6061,2/1/19,188350,181850,6500,3.5
6063,2/1/19,7571,6636,935,12.3
6065,2/1/19,1105938,1057633,48305,4.4
6067,2/1/19,713693,685107,28586,4
6069,2/1/19,31644,29592,2052,6.5
6071,2/1/19,969670,930427,39243,4
6073,2/1/19,1594441,1539902,54539,3.4
6075,2/1/19,580501,566680,13821,2.4
6077,2/1/19,328182,305700,22482,6.9
6079,2/1/19,140695,136242,4453,3.2
6081,2/1/19,457924,447803,10121,2.2
6083,2/1/19,215022,204668,10354,4.8
6085,2/1/19,1054336,1026393,27943,2.7
6087,2/1/19,140963,131615,9348,6.6
6089,2/1/19,73756,69287,4469,6.1
6091,2/1/19,1273,1175,98,7.7
6093,2/1/19,16994,15376,1618,9.5
6095,2/1/19,209971,200987,8984,4.3
6097,2/1/19,258236,250394,7842,3
6099,2/1/19,242617,225516,17101,7
6101,2/1/19,44961,40579,4382,9.7
6103,2/1/19,25600,23878,1722,6.7
6105,2/1/19,4544,4192,352,7.7
6107,2/1/19,204501,181055,23446,11.5
6109,2/1/19,21264,20083,1181,5.6
6111,2/1/19,425987,409341,16646,3.9
6113,2/1/19,109037,103437,5600,5.1
6115,2/1/19,29638,27405,2233,7.5
8001,2/1/19,272595,262889,9706,3.6
8003,2/1/19,8473,8104,369,4.4
8005,2/1/19,364736,353408,11328,3.1
8007,2/1/19,6559,6284,275,4.2
8009,2/1/19,2002,1959,43,2.1
8011,2/1/19,1753,1684,69,3.9
8013,2/1/19,196069,190732,5337,2.7
8014,2/1/19,40072,38955,1117,2.8
8015,2/1/19,9457,9164,293,3.1
8017,2/1/19,1055,1035,20,1.9
8019,2/1/19,6030,5865,165,2.7
8021,2/1/19,3975,3773,202,5.1
8023,2/1/19,1805,1701,104,5.8
8025,2/1/19,1496,1419,77,5.1
8027,2/1/19,1960,1894,66,3.4
8029,2/1/19,13858,13239,619,4.5
8031,2/1/19,417219,404020,13199,3.2
8033,2/1/19,1079,1038,41,3.8
8035,2/1/19,194044,188762,5282,2.7
8037,2/1/19,38844,37921,923,2.4
8039,2/1/19,14925,14522,403,2.7
8041,2/1/19,339926,326718,13208,3.9
8043,2/1/19,14937,14065,872,5.8
8045,2/1/19,33693,32548,1145,3.4
8047,2/1/19,3774,3674,100,2.6
8049,2/1/19,10580,10315,265,2.5
8051,2/1/19,11771,11470,301,2.6
8053,2/1/19,384,371,13,3.4
8055,2/1/19,2441,2234,207,8.5
8057,2/1/19,905,875,30,3.3
8059,2/1/19,335204,325192,10012,3
8061,2/1/19,843,827,16,1.9
8063,2/1/19,4027,3946,81,2
8065,2/1/19,5299,5169,130,2.5
8067,2/1/19,31793,30712,1081,3.4
8069,2/1/19,202261,196388,5873,2.9
8071,2/1/19,6542,6224,318,4.9
8073,2/1/19,2344,2283,61,2.6
8075,2/1/19,10979,10668,311,2.8
8077,2/1/19,76358,73018,3340,4.4
8079,2/1/19,562,549,13,2.3
8081,2/1/19,7517,7148,369,4.9
8083,2/1/19,12704,11903,801,6.3
8085,2/1/19,21434,20508,926,4.3
8087,2/1/19,15868,15373,495,3.1
8089,2/1/19,8238,7786,452,5.5
8091,2/1/19,2284,2197,87,3.8
8093,2/1/19,11139,10789,350,3.1
8095,2/1/19,2321,2275,46,2
8097,2/1/19,11544,11261,283,2.5
8099,2/1/19,6035,5836,199,3.3
8101,2/1/19,75819,72139,3680,4.9
8103,2/1/19,2920,2769,151,5.2
8105,2/1/19,5059,4776,283,5.6
8107,2/1/19,17120,16705,415,2.4
8109,2/1/19,3296,3136,160,4.9
8111,2/1/19,497,476,21,4.2
8113,2/1/19,6335,6198,137,2.2
8115,2/1/19,1107,1079,28,2.5
8117,2/1/19,25914,25470,444,1.7
8119,2/1/19,12752,12268,484,3.8
8121,2/1/19,2863,2800,63,2.2
8123,2/1/19,166737,161692,5045,3
8125,2/1/19,5712,5594,118,2.1
9001,2/1/19,473710,453635,20075,4.2
9003,2/1/19,480749,459712,21037,4.4
9005,2/1/19,103804,99152,4652,4.5
9007,2/1/19,92987,89499,3488,3.8
9009,2/1/19,457269,437047,20222,4.4
9011,2/1/19,135363,129575,5788,4.3
9013,2/1/19,86683,83335,3348,3.9
9015,2/1/19,63863,60764,3099,4.9
10001,2/1/19,79061,75826,3235,4.1
10003,2/1/19,301679,291042,10637,3.5
10005,2/1/19,102602,97960,4642,4.5
11001,2/1/19,409166,384629,24537,6
12001,2/1/19,139044,134793,4251,3.1
12003,2/1/19,11648,11267,381,3.3
12005,2/1/19,83403,79219,4184,5
12007,2/1/19,10875,10520,355,3.3
12009,2/1/19,279454,269866,9588,3.4
12011,2/1/19,1030950,997386,33564,3.3
12013,2/1/19,4808,4580,228,4.7
12015,2/1/19,72267,69485,2782,3.8
12017,2/1/19,47685,45227,2458,5.2
12019,2/1/19,105855,102469,3386,3.2
12021,2/1/19,184896,179297,5599,3
12023,2/1/19,29441,28412,1029,3.5
12027,2/1/19,14248,13713,535,3.8
12029,2/1/19,5850,5626,224,3.8
12031,2/1/19,483354,466738,16616,3.4
12033,2/1/19,143561,138648,4913,3.4
12035,2/1/19,46969,45057,1912,4.1
12037,2/1/19,4504,4300,204,4.5
12039,2/1/19,18656,17865,791,4.2
12041,2/1/19,7143,6890,253,3.5
12043,2/1/19,5718,5511,207,3.6
12045,2/1/19,5743,5380,363,6.3
12047,2/1/19,4253,4059,194,4.6
12049,2/1/19,8625,8187,438,5.1
12051,2/1/19,16056,15271,785,4.9
12053,2/1/19,71114,67907,3207,4.5
12055,2/1/19,36287,34556,1731,4.8
12057,2/1/19,743677,719441,24236,3.3
12059,2/1/19,6869,6608,261,3.8
12061,2/1/19,65459,62896,2563,3.9
12063,2/1/19,17097,16398,699,4.1
12065,2/1/19,5620,5414,206,3.7
12067,2/1/19,2913,2826,87,3
12069,2/1/19,156938,151565,5373,3.4
12071,2/1/19,349163,337799,11364,3.3
12073,2/1/19,155193,150338,4855,3.1
12075,2/1/19,16821,16148,673,4
12077,2/1/19,2644,2539,105,4
12079,2/1/19,7305,7011,294,4
12081,2/1/19,180420,174650,5770,3.2
12083,2/1/19,136477,130859,5618,4.1
12085,2/1/19,73677,71198,2479,3.4
12086,2/1/19,1393318,1356876,36442,2.6
12087,2/1/19,46642,45610,1032,2.2
12089,2/1/19,40509,39248,1261,3.1
12091,2/1/19,93995,91189,2806,3
12093,2/1/19,17890,17246,644,3.6
12095,2/1/19,752981,730017,22964,3
12097,2/1/19,182058,175783,6275,3.4
12099,2/1/19,732448,707745,24703,3.4
12101,2/1/19,235186,226460,8726,3.7
12103,2/1/19,488441,472809,15632,3.2
12105,2/1/19,301377,289809,11568,3.8
12107,2/1/19,26572,25351,1221,4.6
12109,2/1/19,130208,126529,3679,2.8
12111,2/1/19,144277,138310,5967,4.1
12113,2/1/19,81476,78923,2553,3.1
12115,2/1/19,189336,183159,6177,3.3
12117,2/1/19,252360,244566,7794,3.1
12119,2/1/19,32434,30826,1608,5
12121,2/1/19,17899,17253,646,3.6
12123,2/1/19,7950,7646,304,3.8
12125,2/1/19,4621,4480,141,3.1
12127,2/1/19,253686,244466,9220,3.6
12129,2/1/19,14905,14457,448,3
12131,2/1/19,30605,29648,957,3.1
12133,2/1/19,9580,9209,371,3.9
13001,2/1/19,9255,8889,366,4
13003,2/1/19,4790,4628,162,3.4
13005,2/1/19,4972,4790,182,3.7
13007,2/1/19,1168,1110,58,5
13009,2/1/19,17589,16757,832,4.7
13011,2/1/19,9528,9251,277,2.9
13013,2/1/19,40266,38980,1286,3.2
13015,2/1/19,50354,48556,1798,3.6
13017,2/1/19,5383,5086,297,5.5
13019,2/1/19,7528,7213,315,4.2
13021,2/1/19,68546,65637,2909,4.2
13023,2/1/19,4624,4371,253,5.5
13025,2/1/19,7201,6867,334,4.6
13027,2/1/19,6911,6660,251,3.6
13029,2/1/19,18404,17800,604,3.3
13031,2/1/19,37185,35667,1518,4.1
13033,2/1/19,9135,8672,463,5.1
13035,2/1/19,10734,10309,425,4
13037,2/1/19,2236,2149,87,3.9
13039,2/1/19,20986,20130,856,4.1
13043,2/1/19,5505,5332,173,3.1
13045,2/1/19,55021,52934,2087,3.8
13047,2/1/19,33491,32362,1129,3.4
13049,2/1/19,4796,4595,201,4.2
13051,2/1/19,140654,135562,5092,3.6
13053,2/1/19,2025,1918,107,5.3
13055,2/1/19,10752,9862,890,8.3
13057,2/1/19,135233,131114,4119,3
13059,2/1/19,59693,57316,2377,4
13061,2/1/19,866,801,65,7.5
13063,2/1/19,137447,131092,6355,4.6
13065,2/1/19,2744,2627,117,4.3
13067,2/1/19,423533,409520,14013,3.3
13069,2/1/19,18946,18141,805,4.2
13071,2/1/19,21510,20776,734,3.4
13073,2/1/19,75075,72556,2519,3.4
13075,2/1/19,7984,7702,282,3.5
13077,2/1/19,74339,71908,2431,3.3
13079,2/1/19,5652,5439,213,3.8
13081,2/1/19,9438,9028,410,4.3
13083,2/1/19,8187,7877,310,3.8
13085,2/1/19,12264,11873,391,3.2
13087,2/1/19,11697,11227,470,4
13089,2/1/19,397903,382914,14989,3.8
13091,2/1/19,7045,6741,304,4.3
13093,2/1/19,5084,4874,210,4.1
13095,2/1/19,38281,36291,1990,5.2
13097,2/1/19,72942,70124,2818,3.9
13099,2/1/19,4332,4139,193,4.5
13101,2/1/19,1920,1861,59,3.1
13103,2/1/19,31103,30131,972,3.1
13105,2/1/19,7657,7347,310,4
13107,2/1/19,8289,7855,434,5.2
13109,2/1/19,4849,4674,175,3.6
13111,2/1/19,11488,11077,411,3.6
13113,2/1/19,57818,55865,1953,3.4
13115,2/1/19,44229,42381,1848,4.2
13117,2/1/19,121642,117884,3758,3.1
13119,2/1/19,10161,9775,386,3.8
13121,2/1/19,555038,533747,21291,3.8
13123,2/1/19,11791,11314,477,4
13125,2/1/19,1270,1224,46,3.6
13127,2/1/19,38959,37525,1434,3.7
13129,2/1/19,27821,26690,1131,4.1
13131,2/1/19,10658,10276,382,3.6
13133,2/1/19,7041,6738,303,4.3
13135,2/1/19,487637,471257,16380,3.4
13137,2/1/19,19103,18400,703,3.7
13139,2/1/19,101933,98732,3201,3.1
13141,2/1/19,2479,2331,148,6
13143,2/1/19,12496,12045,451,3.6
13145,2/1/19,16767,16197,570,3.4
13147,2/1/19,11600,11169,431,3.7
13149,2/1/19,5231,5038,193,3.7
13151,2/1/19,115237,110701,4536,3.9
13153,2/1/19,70630,67994,2636,3.7
13155,2/1/19,3386,3211,175,5.2
13157,2/1/19,36440,35336,1104,3
13159,2/1/19,6914,6679,235,3.4
13161,2/1/19,6115,5836,279,4.6
13163,2/1/19,6567,6252,315,4.8
13165,2/1/19,3140,2977,163,5.2
13167,2/1/19,4095,3950,145,3.5
13169,2/1/19,13830,13339,491,3.6
13171,2/1/19,8211,7850,361,4.4
13173,2/1/19,3761,3589,172,4.6
13175,2/1/19,19413,18551,862,4.4
13177,2/1/19,14676,14182,494,3.4
13179,2/1/19,26097,25082,1015,3.9
13181,2/1/19,3563,3410,153,4.3
13183,2/1/19,8132,7831,301,3.7
13185,2/1/19,51280,49262,2018,3.9
13187,2/1/19,16736,16132,604,3.6
13189,2/1/19,8828,8375,453,5.1
13191,2/1/19,6121,5883,238,3.9
13193,2/1/19,4723,4489,234,5
13195,2/1/19,13385,12932,453,3.4
13197,2/1/19,3326,3174,152,4.6
13199,2/1/19,8913,8448,465,5.2
13201,2/1/19,2747,2648,99,3.6
13205,2/1/19,8442,8048,394,4.7
13207,2/1/19,13099,12637,462,3.5
13209,2/1/19,3853,3639,214,5.6
13211,2/1/19,9215,8887,328,3.6
13213,2/1/19,15628,14772,856,5.5
13215,2/1/19,78011,74248,3763,4.8
13217,2/1/19,52092,49843,2249,4.3
13219,2/1/19,19664,19096,568,2.9
13221,2/1/19,6992,6746,246,3.5
13223,2/1/19,85640,82833,2807,3.3
13225,2/1/19,11857,11339,518,4.4
13227,2/1/19,15221,14711,510,3.4
13229,2/1/19,8723,8385,338,3.9
13231,2/1/19,8866,8566,300,3.4
13233,2/1/19,18439,17649,790,4.3
13235,2/1/19,4077,3895,182,4.5
13237,2/1/19,8196,7766,430,5.2
13239,2/1/19,808,766,42,5.2
13241,2/1/19,6980,6691,289,4.1
13243,2/1/19,2587,2455,132,5.1
13245,2/1/19,85126,80979,4147,4.9
13247,2/1/19,44629,42749,1880,4.2
13249,2/1/19,2150,2057,93,4.3
13251,2/1/19,5122,4857,265,5.2
13253,2/1/19,3076,2927,149,4.8
13255,2/1/19,28638,27337,1301,4.5
13257,2/1/19,10775,10327,448,4.2
13259,2/1/19,2377,2271,106,4.5
13261,2/1/19,12445,11763,682,5.5
13263,2/1/19,2869,2723,146,5.1
13265,2/1/19,566,539,27,4.8
13267,2/1/19,9569,9159,410,4.3
13269,2/1/19,2862,2723,139,4.9
13271,2/1/19,4163,3931,232,5.6
13273,2/1/19,3525,3314,211,6
13275,2/1/19,16929,16209,720,4.3
13277,2/1/19,19724,18969,755,3.8
13279,2/1/19,11761,11164,597,5.1
13281,2/1/19,3840,3620,220,5.7
13283,2/1/19,2728,2589,139,5.1
13285,2/1/19,37066,35823,1243,3.4
13287,2/1/19,3154,3017,137,4.3
13289,2/1/19,2920,2744,176,6
13291,2/1/19,10226,9853,373,3.6
13293,2/1/19,11340,10892,448,4
13295,2/1/19,31750,30107,1643,5.2
13297,2/1/19,45869,44297,1572,3.4
13299,2/1/19,15685,14960,725,4.6
13301,2/1/19,2773,2650,123,4.4
13303,2/1/19,7033,6698,335,4.8
13305,2/1/19,11509,10996,513,4.5
13307,2/1/19,999,944,55,5.5
13309,2/1/19,1600,1500,100,6.3
13311,2/1/19,16002,15503,499,3.1
13313,2/1/19,44071,41764,2307,5.2
13315,2/1/19,2732,2611,121,4.4
13317,2/1/19,3835,3653,182,4.7
13319,2/1/19,3955,3797,158,4
13321,2/1/19,8883,8513,370,4.2
15001,2/1/19,90807,87755,3052,3.4
15003,2/1/19,451403,439985,11418,2.5
15007,2/1/19,36075,35091,984,2.7
15009,2/1/19,86562,84186,2376,2.7
16001,2/1/19,251837,244441,7396,2.9
16003,2/1/19,1702,1556,146,8.6
16005,2/1/19,42790,41323,1467,3.4
16007,2/1/19,2922,2802,120,4.1
16009,2/1/19,4069,3777,292,7.2
16011,2/1/19,22906,22086,820,3.6
16013,2/1/19,12429,12028,401,3.2
16015,2/1/19,3506,3321,185,5.3
16017,2/1/19,19882,18759,1123,5.6
16019,2/1/19,55992,54277,1715,3.1
16021,2/1/19,5181,4845,336,6.5
16023,2/1/19,1346,1299,47,3.5
16025,2/1/19,674,652,22,3.3
16027,2/1/19,103047,98963,4084,4
16029,2/1/19,3986,3844,142,3.6
16031,2/1/19,11655,11307,348,3
16033,2/1/19,343,330,13,3.8
16035,2/1/19,2873,2625,248,8.6
16037,2/1/19,2000,1865,135,6.8
16039,2/1/19,11187,10707,480,4.3
16041,2/1/19,6989,6726,263,3.8
16043,2/1/19,7660,7391,269,3.5
16045,2/1/19,8188,7859,329,4
16047,2/1/19,8071,7795,276,3.4
16049,2/1/19,6367,5974,393,6.2
16051,2/1/19,13637,13210,427,3.1
16053,2/1/19,12018,11603,415,3.5
16055,2/1/19,78428,74515,3913,5
16057,2/1/19,20931,20253,678,3.2
16059,2/1/19,3418,3185,233,6.8
16061,2/1/19,1554,1450,104,6.7
16063,2/1/19,2683,2545,138,5.1
16065,2/1/19,21642,21157,485,2.2
16067,2/1/19,10905,10530,375,3.4
16069,2/1/19,20961,20174,787,3.8
16071,2/1/19,2269,2176,93,4.1
16073,2/1/19,5218,4971,247,4.7
16075,2/1/19,11510,10974,536,4.7
16077,2/1/19,3778,3618,160,4.2
16079,2/1/19,5276,4880,396,7.5
16081,2/1/19,6079,5903,176,2.9
16083,2/1/19,40898,39528,1370,3.3
16085,2/1/19,5473,5177,296,5.4
16087,2/1/19,4498,4248,250,5.6
17001,2/1/19,32499,31146,1353,4.2
17003,2/1/19,2065,1928,137,6.6
17005,2/1/19,7774,7395,379,4.9
17007,2/1/19,26670,24865,1805,6.8
17009,2/1/19,2927,2848,79,2.7
17011,2/1/19,17229,16152,1077,6.3
17013,2/1/19,2324,2191,133,5.7
17015,2/1/19,7094,6684,410,5.8
17017,2/1/19,6112,5791,321,5.3
17019,2/1/19,111021,106239,4782,4.3
17021,2/1/19,14731,13857,874,5.9
17023,2/1/19,7713,7245,468,6.1
17025,2/1/19,6518,6147,371,5.7
17027,2/1/19,20497,19632,865,4.2
17029,2/1/19,24541,23406,1135,4.6
17031,2/1/19,2600508,2489412,111096,4.3
17033,2/1/19,8707,8243,464,5.3
17035,2/1/19,6156,5862,294,4.8
17037,2/1/19,55110,52403,2707,4.9
17039,2/1/19,7554,7127,427,5.7
17041,2/1/19,10286,9842,444,4.3
17043,2/1/19,508622,491455,17167,3.4
17045,2/1/19,9157,8697,460,5
17047,2/1/19,2719,2585,134,4.9
17049,2/1/19,19356,18571,785,4.1
17051,2/1/19,9866,9291,575,5.8
17053,2/1/19,6534,6176,358,5.5
17055,2/1/19,16595,15550,1045,6.3
17057,2/1/19,15230,14124,1106,7.3
17059,2/1/19,2366,2233,133,5.6
17061,2/1/19,5967,5654,313,5.2
17063,2/1/19,25745,24174,1571,6.1
17065,2/1/19,4469,4247,222,5
17067,2/1/19,8263,7783,480,5.8
17069,2/1/19,1313,1216,97,7.4
17071,2/1/19,3557,3292,265,7.5
17073,2/1/19,24970,23494,1476,5.9
17075,2/1/19,14126,13332,794,5.6
17077,2/1/19,28457,27215,1242,4.4
17079,2/1/19,4585,4325,260,5.7
17081,2/1/19,17753,16833,920,5.2
17083,2/1/19,11057,10454,603,5.5
17085,2/1/19,10691,10071,620,5.8
17087,2/1/19,4267,3934,333,7.8
17089,2/1/19,274785,258984,15801,5.8
17091,2/1/19,55699,52171,3528,6.3
17093,2/1/19,68745,65966,2779,4
17095,2/1/19,21737,20390,1347,6.2
17097,2/1/19,378415,358023,20392,5.4
17099,2/1/19,55091,51284,3807,6.9
17101,2/1/19,6026,5656,370,6.1
17103,2/1/19,17561,16716,845,4.8
17105,2/1/19,16408,15562,846,5.2
17107,2/1/19,12875,12218,657,5.1
17109,2/1/19,13706,13034,672,4.9
17111,2/1/19,166449,159439,7010,4.2
17113,2/1/19,89210,85267,3943,4.4
17115,2/1/19,48845,45941,2904,5.9
17117,2/1/19,23109,21849,1260,5.5
17119,2/1/19,134762,128639,6123,4.5
17121,2/1/19,17771,16887,884,5
17123,2/1/19,5346,5020,326,6.1
17125,2/1/19,6262,5836,426,6.8
17127,2/1/19,5626,5273,353,6.3
17129,2/1/19,6573,6220,353,5.4
17131,2/1/19,8156,7565,591,7.2
17133,2/1/19,18841,18134,707,3.8
17135,2/1/19,11843,11049,794,6.7
17137,2/1/19,16464,15652,812,4.9
17139,2/1/19,7583,7297,286,3.8
17141,2/1/19,25336,23806,1530,6
17143,2/1/19,85551,80344,5207,6.1
17145,2/1/19,8434,7942,492,5.8
17147,2/1/19,8750,8344,406,4.6
17149,2/1/19,6967,6550,417,6
17151,2/1/19,1704,1599,105,6.2
17153,2/1/19,1976,1806,170,8.6
17155,2/1/19,3050,2845,205,6.7
17157,2/1/19,14338,13720,618,4.3
17159,2/1/19,7227,6878,349,4.8
17161,2/1/19,71531,67322,4209,5.9
17163,2/1/19,127240,120771,6469,5.1
17165,2/1/19,9840,9226,614,6.2
17167,2/1/19,101803,96816,4987,4.9
17169,2/1/19,3209,3037,172,5.4
17171,2/1/19,2493,2323,170,6.8
17173,2/1/19,10589,10099,490,4.6
17175,2/1/19,2534,2348,186,7.3
17177,2/1/19,21406,20283,1123,5.2
17179,2/1/19,64198,60659,3539,5.5
17181,2/1/19,7561,6990,571,7.6
17183,2/1/19,33311,31352,1959,5.9
17185,2/1/19,5796,5519,277,4.8
17187,2/1/19,8611,8197,414,4.8
17189,2/1/19,10062,9767,295,2.9
17191,2/1/19,6870,6471,399,5.8
17193,2/1/19,6684,6389,295,4.4
17195,2/1/19,28606,27125,1481,5.2
17197,2/1/19,358689,341845,16844,4.7
17199,2/1/19,32674,31037,1637,5
17201,2/1/19,140896,132487,8409,6
17203,2/1/19,18821,17932,889,4.7
18001,2/1/19,17386,16853,533,3.1
18003,2/1/19,185825,179224,6601,3.6
18005,2/1/19,44987,43576,1411,3.1
18007,2/1/19,4629,4441,188,4.1
18009,2/1/19,5103,4859,244,4.8
18011,2/1/19,36231,35175,1056,2.9
18013,2/1/19,7732,7412,320,4.1
18015,2/1/19,10363,9959,404,3.9
18017,2/1/19,18092,17293,799,4.4
18019,2/1/19,61669,59319,2350,3.8
18021,2/1/19,12218,11684,534,4.4
18023,2/1/19,17330,16766,564,3.3
18025,2/1/19,4928,4625,303,6.1
18027,2/1/19,16670,16144,526,3.2
18029,2/1/19,25826,24704,1122,4.3
18031,2/1/19,15287,14729,558,3.7
18033,2/1/19,22664,21922,742,3.3
18035,2/1/19,54642,52177,2465,4.5
18037,2/1/19,23165,22475,690,3
18039,2/1/19,114570,110792,3778,3.3
18041,2/1/19,9003,8551,452,5
18043,2/1/19,41682,40134,1548,3.7
18045,2/1/19,8049,7696,353,4.4
18047,2/1/19,11385,10874,511,4.5
18049,2/1/19,9868,9464,404,4.1
18051,2/1/19,19624,19042,582,3
18053,2/1/19,32597,31215,1382,4.2
18055,2/1/19,14007,13246,761,5.4
18057,2/1/19,183634,178292,5342,2.9
18059,2/1/19,40312,38931,1381,3.4
18061,2/1/19,20397,19549,848,4.2
18063,2/1/19,90005,87176,2829,3.1
18065,2/1/19,22219,21302,917,4.1
18067,2/1/19,37163,35519,1644,4.4
18069,2/1/19,18354,17630,724,3.9
18071,2/1/19,22964,22253,711,3.1
18073,2/1/19,16531,15721,810,4.9
18075,2/1/19,9607,9238,369,3.8
18077,2/1/19,15295,14709,586,3.8
18079,2/1/19,13575,12944,631,4.6
18081,2/1/19,83050,80380,2670,3.2
18083,2/1/19,18852,18146,706,3.7
18085,2/1/19,42438,41149,1289,3
18087,2/1/19,20176,19534,642,3.2
18089,2/1/19,232242,219337,12905,5.6
18091,2/1/19,48165,45503,2662,5.5
18093,2/1/19,21548,20593,955,4.4
18095,2/1/19,59447,56717,2730,4.6
18097,2/1/19,490676,472259,18417,3.8
18099,2/1/19,23197,22330,867,3.7
18101,2/1/19,5338,5169,169,3.2
18103,2/1/19,15773,15089,684,4.3
18105,2/1/19,72120,69270,2850,4
18107,2/1/19,18816,18160,656,3.5
18109,2/1/19,36443,35024,1419,3.9
18111,2/1/19,7081,6684,397,5.6
18113,2/1/19,23726,22916,810,3.4
18115,2/1/19,3191,3051,140,4.4
18117,2/1/19,8973,8603,370,4.1
18119,2/1/19,9684,9189,495,5.1
18121,2/1/19,6983,6665,318,4.6
18123,2/1/19,9394,9000,394,4.2
18125,2/1/19,6168,5906,262,4.2
18127,2/1/19,87460,83611,3849,4.4
18129,2/1/19,13752,13314,438,3.2
18131,2/1/19,6610,6366,244,3.7
18133,2/1/19,16810,16123,687,4.1
18135,2/1/19,11472,10936,536,4.7
18137,2/1/19,14329,13710,619,4.3
18139,2/1/19,9080,8779,301,3.3
18141,2/1/19,137394,131833,5561,4
18143,2/1/19,10587,10138,449,4.2
18145,2/1/19,23183,22378,805,3.5
18147,2/1/19,10479,10050,429,4.1
18149,2/1/19,9917,9342,575,5.8
18151,2/1/19,20567,19913,654,3.2
18153,2/1/19,8541,8092,449,5.3
18155,2/1/19,5023,4820,203,4
18157,2/1/19,99719,96351,3368,3.4
18159,2/1/19,9378,9080,298,3.2
18161,2/1/19,3570,3419,151,4.2
18163,2/1/19,95579,92195,3384,3.5
18165,2/1/19,7149,6670,479,6.7
18167,2/1/19,48990,46386,2604,5.3
18169,2/1/19,15175,14604,571,3.8
18171,2/1/19,4215,4070,145,3.4
18173,2/1/19,33383,32250,1133,3.4
18175,2/1/19,13787,13190,597,4.3
18177,2/1/19,31330,30045,1285,4.1
18179,2/1/19,14486,13994,492,3.4
18181,2/1/19,13526,13056,470,3.5
18183,2/1/19,17814,17206,608,3.4
19001,2/1/19,4245,4101,144,3.4
19003,2/1/19,2175,2130,45,2.1
19005,2/1/19,7573,7154,419,5.5
19007,2/1/19,5987,5786,201,3.4
19009,2/1/19,3253,3153,100,3.1
19011,2/1/19,13652,13148,504,3.7
19013,2/1/19,69745,67521,2224,3.2
19015,2/1/19,15092,14667,425,2.8
19017,2/1/19,14113,13758,355,2.5
19019,2/1/19,11407,11008,399,3.5
19021,2/1/19,12000,11754,246,2.1
19023,2/1/19,7954,7622,332,4.2
19025,2/1/19,4315,4187,128,3
19027,2/1/19,10918,10700,218,2
19029,2/1/19,6998,6722,276,3.9
19031,2/1/19,10913,10573,340,3.1
19033,2/1/19,23359,22648,711,3
19035,2/1/19,6259,6088,171,2.7
19037,2/1/19,6589,6362,227,3.4
19039,2/1/19,4937,4754,183,3.7
19041,2/1/19,8571,8300,271,3.2
19043,2/1/19,10230,9612,618,6
19045,2/1/19,22706,21824,882,3.9
19047,2/1/19,8286,7883,403,4.9
19049,2/1/19,49281,48237,1044,2.1
19051,2/1/19,4256,4140,116,2.7
19053,2/1/19,4569,4462,107,2.3
19055,2/1/19,10579,10274,305,2.9
19057,2/1/19,19298,18496,802,4.2
19059,2/1/19,9350,8950,400,4.3
19061,2/1/19,56095,54299,1796,3.2
19063,2/1/19,5301,5147,154,2.9
19065,2/1/19,10994,10509,485,4.4
19067,2/1/19,9103,8783,320,3.5
19069,2/1/19,5825,5645,180,3.1
19071,2/1/19,3724,3629,95,2.6
19073,2/1/19,5465,5325,140,2.6
19075,2/1/19,6700,6487,213,3.2
19077,2/1/19,5729,5494,235,4.1
19079,2/1/19,7044,6796,248,3.5
19081,2/1/19,5963,5821,142,2.4
19083,2/1/19,8296,7949,347,4.2
19085,2/1/19,7437,7200,237,3.2
19087,2/1/19,9958,9683,275,2.8
19089,2/1/19,5305,5083,222,4.2
19091,2/1/19,5166,4995,171,3.3
19093,2/1/19,4250,4130,120,2.8
19095,2/1/19,10668,10342,326,3.1
19097,2/1/19,11104,10640,464,4.2
19099,2/1/19,19604,18903,701,3.6
19101,2/1/19,10278,10029,249,2.4
19103,2/1/19,86552,84885,1667,1.9
19105,2/1/19,10922,10426,496,4.5
19107,2/1/19,5332,5102,230,4.3
19109,2/1/19,8542,8315,227,2.7
19111,2/1/19,16061,15392,669,4.2
19113,2/1/19,121816,118013,3803,3.1
19115,2/1/19,6057,5835,222,3.7
19117,2/1/19,4682,4588,94,2
19119,2/1/19,7130,6987,143,2
19121,2/1/19,8694,8249,445,5.1
19123,2/1/19,11907,11585,322,2.7
19125,2/1/19,18093,17629,464,2.6
19127,2/1/19,18398,17194,1204,6.5
19129,2/1/19,7390,7204,186,2.5
19131,2/1/19,6330,6174,156,2.5
19133,2/1/19,4550,4389,161,3.5
19135,2/1/19,4075,3921,154,3.8
19137,2/1/19,5066,4914,152,3
19139,2/1/19,21792,21056,736,3.4
19141,2/1/19,8304,8089,215,2.6
19143,2/1/19,3596,3520,76,2.1
19145,2/1/19,6469,6305,164,2.5
19147,2/1/19,4844,4723,121,2.5
19149,2/1/19,14916,14598,318,2.1
19151,2/1/19,4319,4222,97,2.2
19153,2/1/19,267747,259129,8618,3.2
19155,2/1/19,48335,46955,1380,2.9
19157,2/1/19,10691,10341,350,3.3
19159,2/1/19,2563,2468,95,3.7
19161,2/1/19,5404,5225,179,3.3
19163,2/1/19,88158,85196,2962,3.4
19165,2/1/19,6760,6594,166,2.5
19167,2/1/19,21588,21061,527,2.4
19169,2/1/19,59627,58641,986,1.7
19171,2/1/19,9650,9215,435,4.5
19173,2/1/19,3275,3209,66,2
19175,2/1/19,6340,6078,262,4.1
19177,2/1/19,3721,3609,112,3
19179,2/1/19,17966,17340,626,3.5
19181,2/1/19,28263,27374,889,3.1
19183,2/1/19,12286,11883,403,3.3
19185,2/1/19,2840,2755,85,3
19187,2/1/19,19387,18704,683,3.5
19189,2/1/19,5149,5002,147,2.9
19191,2/1/19,12234,11729,505,4.1
19193,2/1/19,55738,54032,1706,3.1
19195,2/1/19,4221,4071,150,3.6
19197,2/1/19,6625,6438,187,2.8
20001,2/1/19,6494,6255,239,3.7
20003,2/1/19,4094,3930,164,4
20005,2/1/19,6986,6651,335,4.8
20007,2/1/19,2283,2232,51,2.2
20009,2/1/19,13785,13302,483,3.5
20011,2/1/19,6799,6445,354,5.2
20013,2/1/19,5386,5192,194,3.6
20015,2/1/19,32231,31141,1090,3.4
20017,2/1/19,1467,1409,58,4
20019,2/1/19,1405,1346,59,4.2
20021,2/1/19,10047,9697,350,3.5
20023,2/1/19,1292,1261,31,2.4
20025,2/1/19,1042,1018,24,2.3
20027,2/1/19,3792,3644,148,3.9
20029,2/1/19,3764,3637,127,3.4
20031,2/1/19,4003,3775,228,5.7
20033,2/1/19,850,831,19,2.2
20035,2/1/19,16367,15818,549,3.4
20037,2/1/19,18765,17989,776,4.1
20039,2/1/19,1214,1181,33,2.7
20041,2/1/19,8853,8485,368,4.2
20043,2/1/19,4115,3956,159,3.9
20045,2/1/19,66265,64133,2132,3.2
20047,2/1/19,1473,1436,37,2.5
20049,2/1/19,1158,1113,45,3.9
20051,2/1/19,16947,16560,387,2.3
20053,2/1/19,2677,2606,71,2.7
20055,2/1/19,20698,20212,486,2.3
20057,2/1/19,17138,16678,460,2.7
20059,2/1/19,14040,13477,563,4
20061,2/1/19,11517,10950,567,4.9
20063,2/1/19,1437,1406,31,2.2
20065,2/1/19,1102,1071,31,2.8
20067,2/1/19,3187,3095,92,2.9
20069,2/1/19,3228,3165,63,2
20071,2/1/19,812,796,16,2
20073,2/1/19,3191,3083,108,3.4
20075,2/1/19,1585,1555,30,1.9
20077,2/1/19,2850,2777,73,2.6
20079,2/1/19,16850,16337,513,3
20081,2/1/19,2220,2171,49,2.2
20083,2/1/19,967,943,24,2.5
20085,2/1/19,7152,6892,260,3.6
20087,2/1/19,10085,9693,392,3.9
20089,2/1/19,1280,1242,38,3
20091,2/1/19,333294,323354,9940,3
20093,2/1/19,2038,1991,47,2.3
20095,2/1/19,3407,3288,119,3.5
20097,2/1/19,1271,1241,30,2.4
20099,2/1/19,10146,9726,420,4.1
20101,2/1/19,755,736,19,2.5
20103,2/1/19,36034,34569,1465,4.1
20105,2/1/19,1668,1616,52,3.1
20107,2/1/19,4459,4098,361,8.1
20109,2/1/19,1612,1577,35,2.2
20111,2/1/19,16743,16103,640,3.8
20113,2/1/19,16917,16532,385,2.3
20115,2/1/19,6008,5828,180,3
20117,2/1/19,5427,5244,183,3.4
20119,2/1/19,2155,2103,52,2.4
20121,2/1/19,17338,16583,755,4.4
20123,2/1/19,3428,3341,87,2.5
20125,2/1/19,14887,14273,614,4.1
20127,2/1/19,2991,2899,92,3.1
20129,2/1/19,1157,1122,35,3
20131,2/1/19,5328,5176,152,2.9
20133,2/1/19,6019,5749,270,4.5
20135,2/1/19,1318,1285,33,2.5
20137,2/1/19,2692,2634,58,2.2
20139,2/1/19,7971,7614,357,4.5
20141,2/1/19,2046,2001,45,2.2
20143,2/1/19,2993,2908,85,2.8
20145,2/1/19,2845,2749,96,3.4
20147,2/1/19,2667,2590,77,2.9
20149,2/1/19,12779,12354,425,3.3
20151,2/1/19,4869,4735,134,2.8
20153,2/1/19,1448,1417,31,2.1
20155,2/1/19,29472,28501,971,3.3
20157,2/1/19,2236,2177,59,2.6
20159,2/1/19,5157,5004,153,3
20161,2/1/19,36006,34946,1060,2.9
20163,2/1/19,2537,2446,91,3.6
20165,2/1/19,1610,1563,47,2.9
20167,2/1/19,3362,3266,96,2.9
20169,2/1/19,30161,29160,1001,3.3
20171,2/1/19,2772,2720,52,1.9
20173,2/1/19,249470,240196,9274,3.7
20175,2/1/19,9615,9317,298,3.1
20177,2/1/19,89992,86571,3421,3.8
20179,2/1/19,1398,1363,35,2.5
20181,2/1/19,2874,2803,71,2.5
20183,2/1/19,2002,1951,51,2.5
20185,2/1/19,1994,1943,51,2.6
20187,2/1/19,971,947,24,2.5
20189,2/1/19,2531,2461,70,2.8
20191,2/1/19,10825,10431,394,3.6
20193,2/1/19,4322,4221,101,2.3
20195,2/1/19,1404,1359,45,3.2
20197,2/1/19,3631,3492,139,3.8
20199,2/1/19,794,771,23,2.9
20201,2/1/19,2854,2762,92,3.2
20203,2/1/19,1403,1373,30,2.1
20205,2/1/19,3926,3771,155,3.9
20207,2/1/19,1581,1506,75,4.7
20209,2/1/19,76374,72540,3834,5
21001,2/1/19,7169,6710,459,6.4
21003,2/1/19,8894,8464,430,4.8
21005,2/1/19,11958,11487,471,3.9
21007,2/1/19,3515,3253,262,7.5
21009,2/1/19,18832,17855,977,5.2
21011,2/1/19,4606,4230,376,8.2
21013,2/1/19,8515,7981,534,6.3
21015,2/1/19,70777,68040,2737,3.9
21017,2/1/19,9397,8983,414,4.4
21019,2/1/19,17949,16793,1156,6.4
21021,2/1/19,12684,12052,632,5
21023,2/1/19,3851,3595,256,6.6
21025,2/1/19,3557,3273,284,8
21027,2/1/19,7887,7365,522,6.6
21029,2/1/19,42821,40887,1934,4.5
21031,2/1/19,5135,4851,284,5.5
21033,2/1/19,5404,5113,291,5.4
21035,2/1/19,18971,18089,882,4.6
21037,2/1/19,50707,48731,1976,3.9
21039,2/1/19,2162,2049,113,5.2
21041,2/1/19,5311,5059,252,4.7
21043,2/1/19,9894,8896,998,10.1
21045,2/1/19,6652,6336,316,4.8
21047,2/1/19,24720,23333,1387,5.6
21049,2/1/19,17038,16296,742,4.4
21051,2/1/19,5189,4800,389,7.5
21053,2/1/19,3944,3673,271,6.9
21055,2/1/19,3782,3549,233,6.2
21057,2/1/19,3086,2905,181,5.9
21059,2/1/19,47175,45127,2048,4.3
21061,2/1/19,4853,4547,306,6.3
21063,2/1/19,2029,1846,183,9
21065,2/1/19,5395,5083,312,5.8
21067,2/1/19,173411,167066,6345,3.7
21069,2/1/19,6123,5722,401,6.5
21071,2/1/19,11101,10340,761,6.9
21073,2/1/19,25101,24086,1015,4
21075,2/1/19,2012,1894,118,5.9
21077,2/1/19,4053,3864,189,4.7
21079,2/1/19,7689,7300,389,5.1
21081,2/1/19,11766,11141,625,5.3
21083,2/1/19,15641,14813,828,5.3
21085,2/1/19,10935,10328,607,5.6
21087,2/1/19,5090,4846,244,4.8
21089,2/1/19,13451,12471,980,7.3
21091,2/1/19,3964,3786,178,4.5
21093,2/1/19,49203,46943,2260,4.6
21095,2/1/19,6747,6236,511,7.6
21097,2/1/19,8670,8265,405,4.7
21099,2/1/19,7981,7560,421,5.3
21101,2/1/19,22135,21209,926,4.2
21103,2/1/19,8162,7817,345,4.2
21105,2/1/19,1736,1634,102,5.9
21107,2/1/19,18431,17476,955,5.2
21109,2/1/19,4100,3797,303,7.4
21111,2/1/19,400283,383168,17115,4.3
21113,2/1/19,26389,25323,1066,4
21115,2/1/19,6785,6270,515,7.6
21117,2/1/19,87554,84113,3441,3.9
21119,2/1/19,4443,4111,332,7.5
21121,2/1/19,9991,9365,626,6.3
21123,2/1/19,6008,5693,315,5.2
21125,2/1/19,24850,23535,1315,5.3
21127,2/1/19,5120,4710,410,8
21129,2/1/19,2086,1951,135,6.5
21131,2/1/19,2611,2441,170,6.5
21133,2/1/19,6290,5863,427,6.8
21135,2/1/19,4683,4174,509,10.9
21137,2/1/19,9468,8896,572,6
21139,2/1/19,3689,3392,297,8.1
21141,2/1/19,12518,11977,541,4.3
21143,2/1/19,3001,2824,177,5.9
21145,2/1/19,29048,27420,1628,5.6
21147,2/1/19,4680,4364,316,6.8
21149,2/1/19,4162,3943,219,5.3
21151,2/1/19,47320,45298,2022,4.3
21153,2/1/19,3111,2694,417,13.4
21155,2/1/19,9699,9273,426,4.4
21157,2/1/19,14891,13981,910,6.1
21159,2/1/19,2800,2601,199,7.1
21161,2/1/19,7090,6628,462,6.5
21163,2/1/19,12272,11652,620,5.1
21165,2/1/19,2352,2127,225,9.6
21167,2/1/19,9914,9430,484,4.9
21169,2/1/19,4044,3842,202,5
21171,2/1/19,4620,4393,227,4.9
21173,2/1/19,11632,10905,727,6.3
21175,2/1/19,4559,4233,326,7.2
21177,2/1/19,10605,9888,717,6.8
21179,2/1/19,23118,21844,1274,5.5
21181,2/1/19,3223,3059,164,5.1
21183,2/1/19,9753,9165,588,6
21185,2/1/19,33304,32063,1241,3.7
21187,2/1/19,5054,4761,293,5.8
21189,2/1/19,1130,1039,91,8.1
21191,2/1/19,6995,6666,329,4.7
21193,2/1/19,8204,7688,516,6.3
21195,2/1/19,19964,18740,1224,6.1
21197,2/1/19,4968,4637,331,6.7
21199,2/1/19,26438,25099,1339,5.1
21201,2/1/19,791,738,53,6.7
21203,2/1/19,6690,6330,360,5.4
21205,2/1/19,10566,9918,648,6.1
21207,2/1/19,6132,5703,429,7
21209,2/1/19,28823,27732,1091,3.8
21211,2/1/19,25354,24377,977,3.9
21213,2/1/19,8915,8476,439,4.9
21215,2/1/19,10216,9811,405,4
21217,2/1/19,12663,12085,578,4.6
21219,2/1/19,5325,5089,236,4.4
21221,2/1/19,5936,5598,338,5.7
21223,2/1/19,3852,3669,183,4.8
21225,2/1/19,6016,5701,315,5.2
21227,2/1/19,65015,62200,2815,4.3
21229,2/1/19,6138,5859,279,4.5
21231,2/1/19,7315,6813,502,6.9
21233,2/1/19,5718,5472,246,4.3
21235,2/1/19,13796,13041,755,5.5
21237,2/1/19,1948,1780,168,8.6
21239,2/1/19,14355,13872,483,3.4
22001,2/1/19,23593,22480,1113,4.7
22003,2/1/19,8716,8300,416,4.8
22005,2/1/19,64212,61906,2306,3.6
22007,2/1/19,8752,8246,506,5.8
22009,2/1/19,14857,14128,729,4.9
22011,2/1/19,14391,13734,657,4.6
22013,2/1/19,5461,5153,308,5.6
22015,2/1/19,57194,55081,2113,3.7
22017,2/1/19,102595,97727,4868,4.7
22019,2/1/19,105751,102058,3693,3.5
22021,2/1/19,3780,3567,213,5.6
22023,2/1/19,3931,3802,129,3.3
22025,2/1/19,3277,3072,205,6.3
22027,2/1/19,5782,5499,283,4.9
22029,2/1/19,6792,6378,414,6.1
22031,2/1/19,10758,10202,556,5.2
22033,2/1/19,230948,222417,8531,3.7
22035,2/1/19,1888,1693,195,10.3
22037,2/1/19,7982,7663,319,4
22039,2/1/19,11797,11195,602,5.1
22041,2/1/19,7177,6699,478,6.7
22043,2/1/19,8048,7651,397,4.9
22045,2/1/19,27719,26379,1340,4.8
22047,2/1/19,14104,13360,744,5.3
22049,2/1/19,6717,6432,285,4.2
22051,2/1/19,212400,204526,7874,3.7
22053,2/1/19,12984,12438,546,4.2
22055,2/1/19,112225,107928,4297,3.8
22057,2/1/19,41119,39463,1656,4
22059,2/1/19,6570,6327,243,3.7
22061,2/1/19,21844,20874,970,4.4
22063,2/1/19,68928,66470,2458,3.6
22065,2/1/19,3462,3210,252,7.3
22067,2/1/19,10042,9234,808,8
22069,2/1/19,16120,15309,811,5
22071,2/1/19,177162,169744,7418,4.2
22073,2/1/19,69760,66433,3327,4.8
22075,2/1/19,10000,9625,375,3.8
22077,2/1/19,9876,9415,461,4.7
22079,2/1/19,54540,52066,2474,4.5
22081,2/1/19,3706,3553,153,4.1
22083,2/1/19,8179,7696,483,5.9
22085,2/1/19,8987,8578,409,4.6
22087,2/1/19,19662,18823,839,4.3
22089,2/1/19,24931,24028,903,3.6
22091,2/1/19,4277,4048,229,5.4
22093,2/1/19,9187,8692,495,5.4
22095,2/1/19,19512,18548,964,4.9
22097,2/1/19,31272,29493,1779,5.7
22099,2/1/19,22011,20999,1012,4.6
22101,2/1/19,19493,18420,1073,5.5
22103,2/1/19,118289,113997,4292,3.6
22105,2/1/19,53534,50942,2592,4.8
22107,2/1/19,1390,1293,97,7
22109,2/1/19,45418,43485,1933,4.3
22111,2/1/19,9087,8595,492,5.4
22113,2/1/19,23760,22661,1099,4.6
22115,2/1/19,15476,14638,838,5.4
22117,2/1/19,16682,15801,881,5.3
22119,2/1/19,14368,13601,767,5.3
22121,2/1/19,13705,13155,550,4
22123,2/1/19,3651,3217,434,11.9
22125,2/1/19,5397,5206,191,3.5
22127,2/1/19,4804,4532,272,5.7
23001,2/1/19,54865,52855,2010,3.7
23003,2/1/19,30733,28991,1742,5.7
23005,2/1/19,161282,156769,4513,2.8
23007,2/1/19,14752,14089,663,4.5
23009,2/1/19,27585,25909,1676,6.1
23011,2/1/19,61432,59097,2335,3.8
23013,2/1/19,19919,19061,858,4.3
23015,2/1/19,16146,15429,717,4.4
23017,2/1/19,26643,25411,1232,4.6
23019,2/1/19,76223,72933,3290,4.3
23021,2/1/19,7248,6901,347,4.8
23023,2/1/19,19173,18631,542,2.8
23025,2/1/19,22530,21196,1334,5.9
23027,2/1/19,20371,19493,878,4.3
23029,2/1/19,13804,12920,884,6.4
23031,2/1/19,111385,107272,4113,3.7
24001,2/1/19,32552,30672,1880,5.8
24003,2/1/19,314333,303736,10597,3.4
24005,2/1/19,452749,434180,18569,4.1
24009,2/1/19,50069,48303,1766,3.5
24011,2/1/19,18561,17722,839,4.5
24013,2/1/19,96480,93128,3352,3.5
24015,2/1/19,53502,50987,2515,4.7
24017,2/1/19,87042,83687,3355,3.9
24019,2/1/19,15685,14775,910,5.8
24021,2/1/19,135106,130189,4917,3.6
24023,2/1/19,15926,15016,910,5.7
24025,2/1/19,140657,135382,5275,3.8
24027,2/1/19,186931,181261,5670,3
24029,2/1/19,10662,10079,583,5.5
24031,2/1/19,561602,543221,18381,3.3
24033,2/1/19,508998,488305,20693,4.1
24035,2/1/19,28453,27427,1026,3.6
24037,2/1/19,57097,54955,2142,3.8
24039,2/1/19,9198,8537,661,7.2
24041,2/1/19,19308,18442,866,4.5
24043,2/1/19,74369,70825,3544,4.8
24045,2/1/19,49628,46743,2885,5.8
24047,2/1/19,25668,22860,2808,10.9
24510,2/1/19,286855,271286,15569,5.4
25001,2/1/19,108476,101481,6995,6.4
25003,2/1/19,64872,61886,2986,4.6
25005,2/1/19,305392,290930,14462,4.7
25007,2/1/19,8206,7510,696,8.5
25009,2/1/19,428814,413859,14955,3.5
25011,2/1/19,41330,39923,1407,3.4
25013,2/1/19,231740,220755,10985,4.7
25015,2/1/19,91284,88462,2822,3.1
25017,2/1/19,924845,900888,23957,2.6
25019,2/1/19,6093,5405,688,11.3
25021,2/1/19,393512,382401,11111,2.8
25023,2/1/19,285349,274771,10578,3.7
25025,2/1/19,458214,445543,12671,2.8
25027,2/1/19,451587,434836,16751,3.7
26001,2/1/19,3774,3457,317,8.4
26003,2/1/19,3122,2807,315,10.1
26005,2/1/19,61787,59424,2363,3.8
26007,2/1/19,13341,12513,828,6.2
26009,2/1/19,9986,9261,725,7.3
26011,2/1/19,5971,5416,555,9.3
26013,2/1/19,3208,2981,227,7.1
26015,2/1/19,31903,30678,1225,3.8
26017,2/1/19,50311,47463,2848,5.7
26019,2/1/19,8676,8025,651,7.5
26021,2/1/19,72944,69454,3490,4.8
26023,2/1/19,19165,18351,814,4.2
26025,2/1/19,63092,60242,2850,4.5
26027,2/1/19,24801,23621,1180,4.8
26029,2/1/19,12637,11823,814,6.4
26031,2/1/19,10430,8561,1869,17.9
26033,2/1/19,16269,14903,1366,8.4
26035,2/1/19,11840,10902,938,7.9
26037,2/1/19,41694,40298,1396,3.3
26039,2/1/19,5548,5167,381,6.9
26041,2/1/19,17019,15882,1137,6.7
26043,2/1/19,12304,11721,583,4.7
26045,2/1/19,58131,56033,2098,3.6
26047,2/1/19,17228,15831,1397,8.1
26049,2/1/19,182778,172912,9866,5.4
26051,2/1/19,9920,9222,698,7
26053,2/1/19,6228,5856,372,6
26055,2/1/19,48064,45822,2242,4.7
26057,2/1/19,18092,17159,933,5.2
26059,2/1/19,20348,19442,906,4.5
26061,2/1/19,16989,16058,931,5.5
26063,2/1/19,15221,14332,889,5.8
26065,2/1/19,153526,147892,5634,3.7
26067,2/1/19,30171,28992,1179,3.9
26069,2/1/19,9896,9103,793,8
26071,2/1/19,5181,4830,351,6.8
26073,2/1/19,34808,33289,1519,4.4
26075,2/1/19,74632,71418,3214,4.3
26077,2/1/19,134532,129875,4657,3.5
26079,2/1/19,7748,7128,620,8
26081,2/1/19,362068,350899,11169,3.1
26083,2/1/19,919,854,65,7.1
26085,2/1/19,3604,3319,285,7.9
26087,2/1/19,41638,38925,2713,6.5
26089,2/1/19,10211,9633,578,5.7
26091,2/1/19,46863,44809,2054,4.4
26093,2/1/19,103910,100057,3853,3.7
26095,2/1/19,2340,2167,173,7.4
26097,2/1/19,4564,3588,976,21.4
26099,2/1/19,449023,429387,19636,4.4
26101,2/1/19,10034,9271,763,7.6
26103,2/1/19,33041,31054,1987,6
26105,2/1/19,13245,12352,893,6.7
26107,2/1/19,18547,17466,1081,5.8
26109,2/1/19,10954,10460,494,4.5
26111,2/1/19,40587,38835,1752,4.3
26113,2/1/19,6884,6441,443,6.4
26115,2/1/19,76073,72537,3536,4.6
26117,2/1/19,28638,27194,1444,5
26119,2/1/19,2941,2620,321,10.9
26121,2/1/19,76792,73143,3649,4.8
26123,2/1/19,23071,21833,1238,5.4
26125,2/1/19,676366,653029,23337,3.5
26127,2/1/19,11653,10626,1027,8.8
26129,2/1/19,7820,7079,741,9.5
26131,2/1/19,2087,1926,161,7.7
26133,2/1/19,11092,10528,564,5.1
26135,2/1/19,2866,2628,238,8.3
26137,2/1/19,11442,10786,656,5.7
26139,2/1/19,161733,156927,4806,3
26141,2/1/19,4864,4269,595,12.2
26143,2/1/19,7539,6772,767,10.2
26145,2/1/19,87153,82310,4843,5.6
26147,2/1/19,76387,72019,4368,5.7
26149,2/1/19,27914,26760,1154,4.1
26151,2/1/19,19219,18050,1169,6.1
26153,2/1/19,3287,2970,317,9.6
26155,2/1/19,33818,32116,1702,5
26157,2/1/19,23869,22334,1535,6.4
26159,2/1/19,35413,33393,2020,5.7
26161,2/1/19,199435,193538,5897,3
26163,2/1/19,804744,763095,41649,5.2
26165,2/1/19,14795,13974,821,5.5
27001,2/1/19,7217,6559,658,9.1
27003,2/1/19,198807,191637,7170,3.6
27005,2/1/19,18485,17432,1053,5.7
27007,2/1/19,24380,23083,1297,5.3
27009,2/1/19,22291,21071,1220,5.5
27011,2/1/19,2419,2260,159,6.6
27013,2/1/19,40734,39395,1339,3.3
27015,2/1/19,14166,13443,723,5.1
27017,2/1/19,18107,17093,1014,5.6
27019,2/1/19,58593,56795,1798,3.1
27021,2/1/19,13813,12683,1130,8.2
27023,2/1/19,6903,6556,347,5
27025,2/1/19,30338,28764,1574,5.2
27027,2/1/19,36197,34767,1430,4
27029,2/1/19,4590,4013,577,12.6
27031,2/1/19,2885,2700,185,6.4
27033,2/1/19,5733,5488,245,4.3
27035,2/1/19,31667,29720,1947,6.1
27037,2/1/19,242560,234796,7764,3.2
27039,2/1/19,11820,11284,536,4.5
27041,2/1/19,20695,19810,885,4.3
27043,2/1/19,6757,6402,355,5.3
27045,2/1/19,11461,10879,582,5.1
27047,2/1/19,15959,15256,703,4.4
27049,2/1/19,26795,25723,1072,4
27051,2/1/19,3232,3025,207,6.4
27053,2/1/19,707021,686751,20270,2.9
27055,2/1/19,10443,9973,470,4.5
27057,2/1/19,9705,8935,770,7.9
27059,2/1/19,21640,20413,1227,5.7
27061,2/1/19,21777,20202,1575,7.2
27063,2/1/19,5580,5354,226,4.1
27065,2/1/19,9174,8327,847,9.2
27067,2/1/19,24064,22875,1189,4.9
27069,2/1/19,2288,2175,113,4.9
27071,2/1/19,5875,5530,345,5.9
27073,2/1/19,3509,3306,203,5.8
27075,2/1/19,5416,5174,242,4.5
27077,2/1/19,2476,2388,88,3.6
27079,2/1/19,16426,15305,1121,6.8
27081,2/1/19,3132,2962,170,5.4
27083,2/1/19,14454,13866,588,4.1
27085,2/1/19,19340,18397,943,4.9
27087,2/1/19,2320,2168,152,6.6
27089,2/1/19,5361,4839,522,9.7
27091,2/1/19,9907,9458,449,4.5
27093,2/1/19,13257,12532,725,5.5
27095,2/1/19,13273,12186,1087,8.2
27097,2/1/19,17591,16161,1430,8.1
27099,2/1/19,20307,19567,740,3.6
27101,2/1/19,4744,4415,329,6.9
27103,2/1/19,20945,20309,636,3
27105,2/1/19,10964,10593,371,3.4
27107,2/1/19,3222,2996,226,7
27109,2/1/19,88264,85689,2575,2.9
27111,2/1/19,30584,28734,1850,6
27113,2/1/19,8926,8293,633,7.1
27115,2/1/19,15143,13912,1231,8.1
27117,2/1/19,4736,4471,265,5.6
27119,2/1/19,16539,15712,827,5
27121,2/1/19,6405,6135,270,4.2
27123,2/1/19,290014,280922,9092,3.1
27125,2/1/19,2219,2053,166,7.5
27127,2/1/19,7485,7106,379,5.1
27129,2/1/19,8378,7863,515,6.1
27131,2/1/19,37018,35586,1432,3.9
27133,2/1/19,5512,5365,147,2.7
27135,2/1/19,7860,7464,396,5
27137,2/1/19,103104,98332,4772,4.6
27139,2/1/19,83886,81243,2643,3.2
27141,2/1/19,53084,50572,2512,4.7
27143,2/1/19,8482,8038,444,5.2
27145,2/1/19,90989,87271,3718,4.1
27147,2/1/19,20823,20039,784,3.8
27149,2/1/19,5291,5108,183,3.5
27151,2/1/19,4753,4499,254,5.3
27153,2/1/19,13450,12581,869,6.5
27155,2/1/19,1715,1626,89,5.2
27157,2/1/19,12134,11620,514,4.2
27159,2/1/19,5973,5448,525,8.8
27161,2/1/19,8749,8303,446,5.1
27163,2/1/19,143917,139310,4607,3.2
27165,2/1/19,6369,6035,334,5.2
27167,2/1/19,3416,3258,158,4.6
27169,2/1/19,28724,27822,902,3.1
27171,2/1/19,76358,73034,3324,4.4
27173,2/1/19,5262,5024,238,4.5
28001,2/1/19,11003,10231,772,7
28003,2/1/19,16305,15580,725,4.4
28005,2/1/19,4333,4059,274,6.3
28007,2/1/19,6980,6532,448,6.4
28009,2/1/19,3023,2850,173,5.7
28011,2/1/19,12261,11442,819,6.7
28013,2/1/19,5521,5229,292,5.3
28015,2/1/19,3429,3221,208,6.1
28017,2/1/19,6932,6566,366,5.3
28019,2/1/19,3741,3538,203,5.4
28021,2/1/19,2985,2706,279,9.3
28023,2/1/19,5979,5628,351,5.9
28025,2/1/19,7694,7184,510,6.6
28027,2/1/19,8311,7635,676,8.1
28029,2/1/19,11165,10445,720,6.4
28031,2/1/19,8020,7642,378,4.7
28033,2/1/19,90741,86932,3809,4.2
28035,2/1/19,33296,31682,1614,4.8
28037,2/1/19,2785,2617,168,6
28039,2/1/19,8700,8057,643,7.4
28041,2/1/19,4262,3950,312,7.3
28043,2/1/19,9621,9161,460,4.8
28045,2/1/19,18592,17562,1030,5.5
28047,2/1/19,85358,81134,4224,4.9
28049,2/1/19,106763,101551,5212,4.9
28051,2/1/19,5592,5031,561,10
28053,2/1/19,2180,1937,243,11.1
28055,2/1/19,365,316,49,13.4
28057,2/1/19,10410,9957,453,4.4
28059,2/1/19,57896,54424,3472,6
28061,2/1/19,6162,5753,409,6.6
28063,2/1/19,1978,1696,282,14.3
28065,2/1/19,4115,3845,270,6.6
28067,2/1/19,26217,24888,1329,5.1
28069,2/1/19,3536,3288,248,7
28071,2/1/19,28101,27012,1089,3.9
28073,2/1/19,30823,29558,1265,4.1
28075,2/1/19,30879,29338,1541,5
28077,2/1/19,4622,4312,310,6.7
28079,2/1/19,7904,7483,421,5.3
28081,2/1/19,40873,39232,1641,4
28083,2/1/19,9953,9186,767,7.7
28085,2/1/19,14453,13721,732,5.1
28087,2/1/19,25424,24132,1292,5.1
28089,2/1/19,53149,51023,2126,4
28091,2/1/19,9792,9242,550,5.6
28093,2/1/19,14341,13594,747,5.2
28095,2/1/19,15290,14516,774,5.1
28097,2/1/19,3948,3715,233,5.9
28099,2/1/19,9982,9437,545,5.5
28101,2/1/19,8720,8284,436,5
28103,2/1/19,3722,3477,245,6.6
28105,2/1/19,22526,21459,1067,4.7
28107,2/1/19,12172,11405,767,6.3
28109,2/1/19,23904,22729,1175,4.9
28111,2/1/19,4303,4008,295,6.9
28113,2/1/19,14393,13509,884,6.1
28115,2/1/19,14650,14063,587,4
28117,2/1/19,11300,10763,537,4.8
28119,2/1/19,2326,2135,191,8.2
28121,2/1/19,76086,73233,2853,3.7
28123,2/1/19,12537,12000,537,4.3
28125,2/1/19,1560,1416,144,9.2
28127,2/1/19,10719,10174,545,5.1
28129,2/1/19,6769,6412,357,5.3
28131,2/1/19,6786,6366,420,6.2
28133,2/1/19,7628,6921,707,9.3
28135,2/1/19,5310,4954,356,6.7
28137,2/1/19,12229,11593,636,5.2
28139,2/1/19,9406,8936,470,5
28141,2/1/19,8719,8303,416,4.8
28143,2/1/19,4410,4120,290,6.6
28145,2/1/19,13942,13371,571,4.1
28147,2/1/19,4868,4539,329,6.8
28149,2/1/19,20395,19162,1233,6
28151,2/1/19,16791,15482,1309,7.8
28153,2/1/19,7313,6902,411,5.6
28155,2/1/19,3947,3744,203,5.1
28157,2/1/19,2783,2520,263,9.5
28159,2/1/19,7326,6878,448,6.1
28161,2/1/19,5058,4783,275,5.4
28163,2/1/19,9295,8755,540,5.8
29001,2/1/19,10422,10000,422,4
29003,2/1/19,9760,9416,344,3.5
29005,2/1/19,2747,2652,95,3.5
29007,2/1/19,10793,10359,434,4
29009,2/1/19,15938,15260,678,4.3
29011,2/1/19,5216,5042,174,3.3
29013,2/1/19,7915,7517,398,5
29015,2/1/19,7237,6819,418,5.8
29017,2/1/19,5530,5273,257,4.6
29019,2/1/19,98958,96373,2585,2.6
29021,2/1/19,44508,42926,1582,3.6
29023,2/1/19,17843,17011,832,4.7
29025,2/1/19,4366,4193,173,4
29027,2/1/19,21289,20553,736,3.5
29029,2/1/19,17822,16678,1144,6.4
29031,2/1/19,40829,39594,1235,3
29033,2/1/19,5191,5004,187,3.6
29035,2/1/19,2480,2338,142,5.7
29037,2/1/19,54493,52509,1984,3.6
29039,2/1/19,5745,5507,238,4.1
29041,2/1/19,3790,3651,139,3.7
29043,2/1/19,44948,43505,1443,3.2
29045,2/1/19,3193,3043,150,4.7
29047,2/1/19,135011,130852,4159,3.1
29049,2/1/19,10697,10300,397,3.7
29051,2/1/19,38786,37608,1178,3
29053,2/1/19,7603,7138,465,6.1
29055,2/1/19,10954,10454,500,4.6
29057,2/1/19,3572,3459,113,3.2
29059,2/1/19,7048,6750,298,4.2
29061,2/1/19,4101,3917,184,4.5
29063,2/1/19,4866,4673,193,4
29065,2/1/19,6241,6007,234,3.7
29067,2/1/19,5143,4925,218,4.2
29069,2/1/19,11961,11184,777,6.5
29071,2/1/19,52889,50902,1987,3.8
29073,2/1/19,7740,7435,305,3.9
29075,2/1/19,3526,3437,89,2.5
29077,2/1/19,151018,146733,4285,2.8
29079,2/1/19,4524,4351,173,3.8
29081,2/1/19,3960,3784,176,4.4
29083,2/1/19,9780,9351,429,4.4
29085,2/1/19,3720,3526,194,5.2
29087,2/1/19,2626,2558,68,2.6
29089,2/1/19,5041,4834,207,4.1
29091,2/1/19,16462,15796,666,4
29093,2/1/19,3575,3379,196,5.5
29095,2/1/19,359431,344882,14549,4
29097,2/1/19,57117,55355,1762,3.1
29099,2/1/19,117460,112990,4470,3.8
29101,2/1/19,22996,22076,920,4
29103,2/1/19,1774,1712,62,3.5
29105,2/1/19,16933,16278,655,3.9
29107,2/1/19,16798,16163,635,3.8
29109,2/1/19,18169,17397,772,4.2
29111,2/1/19,5040,4854,186,3.7
29113,2/1/19,28375,27196,1179,4.2
29115,2/1/19,5149,4847,302,5.9
29117,2/1/19,7418,7171,247,3.3
29119,2/1/19,10622,10272,350,3.3
29121,2/1/19,7581,7245,336,4.4
29123,2/1/19,5492,5269,223,4.1
29125,2/1/19,3930,3757,173,4.4
29127,2/1/19,14458,13887,571,3.9
29129,2/1/19,1897,1809,88,4.6
29131,2/1/19,12063,11429,634,5.3
29133,2/1/19,5840,5603,237,4.1
29135,2/1/19,7326,7064,262,3.6
29137,2/1/19,3875,3689,186,4.8
29139,2/1/19,5682,5474,208,3.7
29141,2/1/19,8007,7509,498,6.2
29143,2/1/19,8316,7936,380,4.6
29145,2/1/19,27353,26423,930,3.4
29147,2/1/19,10761,10425,336,3.1
29149,2/1/19,4024,3867,157,3.9
29151,2/1/19,7107,6882,225,3.2
29153,2/1/19,3387,3164,223,6.6
29155,2/1/19,6380,6024,356,5.6
29157,2/1/19,10164,9847,317,3.1
29159,2/1/19,20996,20177,819,3.9
29161,2/1/19,19924,19177,747,3.7
29163,2/1/19,7583,7294,289,3.8
29165,2/1/19,58086,56456,1630,2.8
29167,2/1/19,14579,14006,573,3.9
29169,2/1/19,14776,14164,612,4.1
29171,2/1/19,2373,2271,102,4.3
29173,2/1/19,5652,5411,241,4.3
29175,2/1/19,10453,9971,482,4.6
29177,2/1/19,10949,10497,452,4.1
29179,2/1/19,3019,2883,136,4.5
29181,2/1/19,5052,4753,299,5.9
29183,2/1/19,225220,218745,6475,2.9
29185,2/1/19,3810,3612,198,5.2
29186,2/1/19,9157,8845,312,3.4
29187,2/1/19,26547,25416,1131,4.3
29189,2/1/19,527769,510196,17573,3.3
29195,2/1/19,10719,10339,380,3.5
29197,2/1/19,1992,1880,112,5.6
29199,2/1/19,2361,2267,94,4
29201,2/1/19,20101,19364,737,3.7
29203,2/1/19,3204,2972,232,7.2
29205,2/1/19,3100,2954,146,4.7
29207,2/1/19,13142,12443,699,5.3
29209,2/1/19,12863,11505,1358,10.6
29211,2/1/19,2777,2652,125,4.5
29213,2/1/19,25502,22374,3128,12.3
29215,2/1/19,9113,8641,472,5.2
29217,2/1/19,9648,9270,378,3.9
29219,2/1/19,17918,17250,668,3.7
29221,2/1/19,10288,9708,580,5.6
29223,2/1/19,5355,5064,291,5.4
29225,2/1/19,17275,16639,636,3.7
29227,2/1/19,1173,1133,40,3.4
29229,2/1/19,7516,7181,335,4.5
29510,2/1/19,151495,145283,6212,4.1
30001,2/1/19,5060,4899,161,3.2
30003,2/1/19,4854,4429,425,8.8
30005,2/1/19,2446,2344,102,4.2
30007,2/1/19,2542,2430,112,4.4
30009,2/1/19,5447,5203,244,4.5
30011,2/1/19,612,593,19,3.1
30013,2/1/19,37930,36362,1568,4.1
30015,2/1/19,2385,2308,77,3.2
30017,2/1/19,5962,5745,217,3.6
30019,2/1/19,868,850,18,2.1
30021,2/1/19,4549,4432,117,2.6
30023,2/1/19,5039,4843,196,3.9
30025,2/1/19,1668,1634,34,2
30027,2/1/19,5792,5524,268,4.6
30029,2/1/19,46720,43886,2834,6.1
30031,2/1/19,67252,65670,1582,2.4
30033,2/1/19,719,698,21,2.9
30035,2/1/19,5436,4921,515,9.5
30037,2/1/19,361,342,19,5.3
30039,2/1/19,1776,1634,142,8
30041,2/1/19,7593,7287,306,4
30043,2/1/19,5672,5438,234,4.1
30045,2/1/19,905,856,49,5.4
30047,2/1/19,12874,12204,670,5.2
30049,2/1/19,35633,34385,1248,3.5
30051,2/1/19,923,898,25,2.7
30053,2/1/19,7872,7155,717,9.1
30055,2/1/19,912,898,14,1.5
30057,2/1/19,5282,5072,210,4
30059,2/1/19,992,948,44,4.4
30061,2/1/19,1689,1547,142,8.4
30063,2/1/19,63570,61090,2480,3.9
30065,2/1/19,2239,2134,105,4.7
30067,2/1/19,8458,8095,363,4.3
30069,2/1/19,273,260,13,4.8
30071,2/1/19,1856,1763,93,5
30073,2/1/19,2683,2551,132,4.9
30075,2/1/19,926,895,31,3.3
30077,2/1/19,2831,2702,129,4.6
30079,2/1/19,472,455,17,3.6
30081,2/1/19,19824,18734,1090,5.5
30083,2/1/19,5765,5619,146,2.5
30085,2/1/19,4467,4257,210,4.7
30087,2/1/19,3732,3523,209,5.6
30089,2/1/19,4763,4368,395,8.3
30091,2/1/19,1725,1685,40,2.3
30093,2/1/19,17020,16274,746,4.4
30095,2/1/19,5035,4825,210,4.2
30097,2/1/19,1740,1683,57,3.3
30099,2/1/19,2667,2559,108,4
30101,2/1/19,2081,2032,49,2.4
30103,2/1/19,321,309,12,3.7
30105,2/1/19,3969,3824,145,3.7
30107,2/1/19,759,720,39,5.1
30109,2/1/19,445,433,12,2.7
30111,2/1/19,81482,78407,3075,3.8
31001,2/1/19,16518,15946,572,3.5
31003,2/1/19,3410,3301,109,3.2
31005,2/1/19,211,199,12,5.7
31007,2/1/19,354,344,10,2.8
31009,2/1/19,245,231,14,5.7
31011,2/1/19,2876,2777,99,3.4
31013,2/1/19,5360,5204,156,2.9
31015,2/1/19,1051,1008,43,4.1
31017,2/1/19,1355,1300,55,4.1
31019,2/1/19,27729,26975,754,2.7
31021,2/1/19,3421,3275,146,4.3
31023,2/1/19,4513,4393,120,2.7
31025,2/1/19,13451,12922,529,3.9
31027,2/1/19,4380,4277,103,2.4
31029,2/1/19,2205,2154,51,2.3
31031,2/1/19,3191,3106,85,2.7
31033,2/1/19,4394,4230,164,3.7
31035,2/1/19,3213,3079,134,4.2
31037,2/1/19,5566,5412,154,2.8
31039,2/1/19,4627,4497,130,2.8
31041,2/1/19,6292,6132,160,2.5
31043,2/1/19,10832,10289,543,5
31045,2/1/19,4972,4830,142,2.9
31047,2/1/19,13020,12564,456,3.5
31049,2/1/19,924,900,24,2.6
31051,2/1/19,2978,2875,103,3.5
31053,2/1/19,19378,18780,598,3.1
31055,2/1/19,297267,286392,10875,3.7
31057,2/1/19,1129,1103,26,2.3
31059,2/1/19,3066,2973,93,3
31061,2/1/19,1443,1390,53,3.7
31063,2/1/19,1593,1532,61,3.8
31065,2/1/19,2513,2446,67,2.7
31067,2/1/19,10920,10496,424,3.9
31069,2/1/19,1090,1058,32,2.9
31071,2/1/19,1100,1074,26,2.4
31073,2/1/19,1056,1030,26,2.5
31075,2/1/19,408,398,10,2.5
31077,2/1/19,1172,1138,34,2.9
31079,2/1/19,31740,30576,1164,3.7
31081,2/1/19,4676,4544,132,2.8
31083,2/1/19,1720,1673,47,2.7
31085,2/1/19,590,576,14,2.4
31087,2/1/19,1246,1195,51,4.1
31089,2/1/19,5606,5440,166,3
31091,2/1/19,363,349,14,3.9
31093,2/1/19,3310,3194,116,3.5
31095,2/1/19,4078,3960,118,2.9
31097,2/1/19,2059,1976,83,4
31099,2/1/19,3691,3618,73,2
31101,2/1/19,4395,4251,144,3.3
31103,2/1/19,557,543,14,2.5
31105,2/1/19,2038,1967,71,3.5
31107,2/1/19,4512,4332,180,4
31109,2/1/19,176809,171615,5194,2.9
31111,2/1/19,18128,17479,649,3.6
31113,2/1/19,454,442,12,2.6
31115,2/1/19,375,363,12,3.2
31117,2/1/19,432,422,10,2.3
31119,2/1/19,19840,19214,626,3.2
31121,2/1/19,3945,3819,126,3.2
31123,2/1/19,2534,2451,83,3.3
31125,2/1/19,1954,1895,59,3
31127,2/1/19,3648,3514,134,3.7
31129,2/1/19,2394,2319,75,3.1
31131,2/1/19,8282,7990,292,3.5
31133,2/1/19,1463,1418,45,3.1
31135,2/1/19,1770,1731,39,2.2
31137,2/1/19,4863,4737,126,2.6
31139,2/1/19,4017,3875,142,3.5
31141,2/1/19,17420,16860,560,3.2
31143,2/1/19,2840,2755,85,3
31145,2/1/19,5796,5642,154,2.7
31147,2/1/19,4207,4059,148,3.5
31149,2/1/19,824,792,32,3.9
31151,2/1/19,7414,7126,288,3.9
31153,2/1/19,95680,92702,2978,3.1
31155,2/1/19,10989,10671,318,2.9
31157,2/1/19,18212,17427,785,4.3
31159,2/1/19,8810,8559,251,2.8
31161,2/1/19,2604,2539,65,2.5
31163,2/1/19,1663,1600,63,3.8
31165,2/1/19,720,700,20,2.8
31167,2/1/19,3500,3388,112,3.2
31169,2/1/19,2782,2705,77,2.8
31171,2/1/19,411,395,16,3.9
31173,2/1/19,3021,2859,162,5.4
31175,2/1/19,2084,2001,83,4
31177,2/1/19,11165,10780,385,3.4
31179,2/1/19,5777,5627,150,2.6
31181,2/1/19,1606,1559,47,2.9
31183,2/1/19,546,528,18,3.3
31185,2/1/19,7131,6934,197,2.8
32001,2/1/19,10920,10460,460,4.2
32003,2/1/19,1124004,1076313,47691,4.2
32005,2/1/19,22974,21894,1080,4.7
32007,2/1/19,27621,26644,977,3.5
32009,2/1/19,426,408,18,4.2
32011,2/1/19,1107,1081,26,2.3
32013,2/1/19,8246,7981,265,3.2
32015,2/1/19,3224,3111,113,3.5
32017,2/1/19,2079,1977,102,4.9
32019,2/1/19,23469,22125,1344,5.7
32021,2/1/19,2020,1922,98,4.9
32023,2/1/19,17049,16100,949,5.6
32027,2/1/19,2587,2453,134,5.2
32029,2/1/19,2028,1931,97,4.8
32031,2/1/19,253725,244033,9692,3.8
32033,2/1/19,4518,4361,157,3.5
32510,2/1/19,26076,24820,1256,4.8
33001,2/1/19,30595,29637,958,3.1
33003,2/1/19,23448,22721,727,3.1
33005,2/1/19,41201,39874,1327,3.2
33007,2/1/19,14582,13989,593,4.1
33009,2/1/19,50254,48956,1298,2.6
33011,2/1/19,241554,234079,7475,3.1
33013,2/1/19,83786,81500,2286,2.7
33015,2/1/19,185271,179295,5976,3.2
33017,2/1/19,74351,72239,2112,2.8
33019,2/1/19,23078,22479,599,2.6
34001,2/1/19,119234,111923,7311,6.1
34003,2/1/19,480072,464201,15871,3.3
34005,2/1/19,229134,220494,8640,3.8
34007,2/1/19,251788,240316,11472,4.6
34009,2/1/19,39834,34991,4843,12.2
34011,2/1/19,64759,60429,4330,6.7
34013,2/1/19,367086,349404,17682,4.8
34015,2/1/19,149005,142691,6314,4.2
34017,2/1/19,359715,346694,13021,3.6
34019,2/1/19,64139,61983,2156,3.4
34021,2/1/19,201467,194264,7203,3.6
34023,2/1/19,433117,417864,15253,3.5
34025,2/1/19,324553,312309,12244,3.8
34027,2/1/19,255742,247304,8438,3.3
34029,2/1/19,272532,260076,12456,4.6
34031,2/1/19,241974,229899,12075,5
34033,2/1/19,28926,27315,1611,5.6
34035,2/1/19,170644,164765,5879,3.4
34037,2/1/19,73762,70664,3098,4.2
34039,2/1/19,275667,264009,11658,4.2
34041,2/1/19,55554,53325,2229,4
35001,2/1/19,332003,316964,15039,4.5
35003,2/1/19,1118,1036,82,7.3
35005,2/1/19,27138,25888,1250,4.6
35006,2/1/19,8965,8364,601,6.7
35007,2/1/19,5328,5071,257,4.8
35009,2/1/19,21732,20845,887,4.1
35011,2/1/19,803,766,37,4.6
35013,2/1/19,97519,91465,6054,6.2
35015,2/1/19,33621,32586,1035,3.1
35017,2/1/19,12294,11674,620,5
35019,2/1/19,1513,1424,89,5.9
35021,2/1/19,270,255,15,5.6
35023,2/1/19,2089,2007,82,3.9
35025,2/1/19,30954,29796,1158,3.7
35027,2/1/19,8614,8170,444,5.2
35028,2/1/19,9248,8952,296,3.2
35029,2/1/19,10145,8415,1730,17.1
35031,2/1/19,24237,22458,1779,7.3
35033,2/1/19,2141,1986,155,7.2
35035,2/1/19,24867,23614,1253,5
35037,2/1/19,3233,3064,169,5.2
35039,2/1/19,16508,15542,966,5.9
35041,2/1/19,7954,7611,343,4.3
35043,2/1/19,66077,62831,3246,4.9
35045,2/1/19,51950,48800,3150,6.1
35047,2/1/19,10940,10286,654,6
35049,2/1/19,74166,71073,3093,4.2
35051,2/1/19,3782,3453,329,8.7
35053,2/1/19,6454,6082,372,5.8
35055,2/1/19,15606,14583,1023,6.6
35057,2/1/19,5557,5127,430,7.7
35059,2/1/19,1813,1745,68,3.8
35061,2/1/19,30471,28848,1623,5.3
36001,2/1/19,156666,150373,6293,4
36003,2/1/19,19823,18495,1328,6.7
36005,2/1/19,606265,568856,37409,6.2
36007,2/1/19,83700,79102,4598,5.5
36009,2/1/19,34368,32281,2087,6.1
36011,2/1/19,36094,34188,1906,5.3
36013,2/1/19,54571,51492,3079,5.6
36015,2/1/19,35181,33519,1662,4.7
36017,2/1/19,22259,20984,1275,5.7
36019,2/1/19,36492,34675,1817,5
36021,2/1/19,30915,29689,1226,4
36023,2/1/19,23538,22086,1452,6.2
36025,2/1/19,19139,18000,1139,6
36027,2/1/19,143335,137659,5676,4
36029,2/1/19,439739,418558,21181,4.8
36031,2/1/19,17302,16243,1059,6.1
36033,2/1/19,19850,18654,1196,6
36035,2/1/19,22623,21187,1436,6.3
36037,2/1/19,29604,28053,1551,5.2
36039,2/1/19,20534,19462,1072,5.2
36041,2/1/19,2149,1960,189,8.8
36043,2/1/19,28206,26505,1701,6
36045,2/1/19,43765,40699,3066,7
36047,2/1/19,1212794,1156192,56602,4.7
36049,2/1/19,11702,10792,910,7.8
36051,2/1/19,31085,29419,1666,5.4
36053,2/1/19,32892,31046,1846,5.6
36055,2/1/19,361744,345319,16425,4.5
36057,2/1/19,22276,20848,1428,6.4
36059,2/1/19,698761,672805,25956,3.7
36061,2/1/19,922198,884869,37329,4
36063,2/1/19,98978,93054,5924,6
36065,2/1/19,101539,96543,4996,4.9
36067,2/1/19,219497,209706,9791,4.5
36069,2/1/19,55802,53141,2661,4.8
36071,2/1/19,183784,176268,7516,4.1
36073,2/1/19,17718,16747,971,5.5
36075,2/1/19,53122,49604,3518,6.6
36077,2/1/19,27914,26443,1471,5.3
36079,2/1/19,50952,48894,2058,4
36081,2/1/19,1152844,1106386,46458,4
36083,2/1/19,80919,77375,3544,4.4
36085,2/1/19,224842,214842,10000,4.4
36087,2/1/19,154259,148287,5972,3.9
36089,2/1/19,43904,41091,2813,6.4
36091,2/1/19,118704,113980,4724,4
36093,2/1/19,75796,72475,3321,4.4
36095,2/1/19,14819,13876,943,6.4
36097,2/1/19,8065,7538,527,6.5
36099,2/1/19,15948,15201,747,4.7
36101,2/1/19,42810,40327,2483,5.8
36103,2/1/19,769799,737356,32443,4.2
36105,2/1/19,35670,34003,1667,4.7
36107,2/1/19,22818,21648,1170,5.1
36109,2/1/19,51018,49072,1946,3.8
36111,2/1/19,86963,83195,3768,4.3
36113,2/1/19,30705,28886,1819,5.9
36115,2/1/19,27391,25915,1476,5.4
36117,2/1/19,44198,42050,2148,4.9
36119,2/1/19,481411,461863,19548,4.1
36121,2/1/19,18244,17122,1122,6.1
36123,2/1/19,12017,11452,565,4.7
37001,2/1/19,82393,79050,3343,4.1
37003,2/1/19,18188,17537,651,3.6
37005,2/1/19,4439,4213,226,5.1
37007,2/1/19,10890,10393,497,4.6
37009,2/1/19,12856,12275,581,4.5
37011,2/1/19,7434,7108,326,4.4
37013,2/1/19,19871,18890,981,4.9
37015,2/1/19,8035,7622,413,5.1
37017,2/1/19,14815,14043,772,5.2
37019,2/1/19,52186,49046,3140,6
37021,2/1/19,141338,136741,4597,3.3
37023,2/1/19,41296,39667,1629,3.9
37025,2/1/19,108783,104613,4170,3.8
37027,2/1/19,36891,35241,1650,4.5
37029,2/1/19,4737,4534,203,4.3
37031,2/1/19,31443,29855,1588,5.1
37033,2/1/19,9966,9486,480,4.8
37035,2/1/19,79345,76296,3049,3.8
37037,2/1/19,36073,34774,1299,3.6
37039,2/1/19,11318,10742,576,5.1
37041,2/1/19,5655,5359,296,5.2
37043,2/1/19,4109,3908,201,4.9
37045,2/1/19,48959,46929,2030,4.1
37047,2/1/19,22521,21302,1219,5.4
37049,2/1/19,41991,40098,1893,4.5
37051,2/1/19,129201,122175,7026,5.4
37053,2/1/19,14052,13450,602,4.3
37055,2/1/19,18090,16533,1557,8.6
37057,2/1/19,81713,78535,3178,3.9
37059,2/1/19,20908,20136,772,3.7
37061,2/1/19,25854,24724,1130,4.4
37063,2/1/19,172263,165966,6297,3.7
37065,2/1/19,21875,20520,1355,6.2
37067,2/1/19,189532,182017,7515,4
37069,2/1/19,31361,29997,1364,4.3
37071,2/1/19,110659,106123,4536,4.1
37073,2/1/19,5342,5109,233,4.4
37075,2/1/19,3200,2986,214,6.7
37077,2/1/19,30512,29409,1103,3.6
37079,2/1/19,9801,9417,384,3.9
37081,2/1/19,265002,253477,11525,4.3
37083,2/1/19,20658,19427,1231,6
37085,2/1/19,53680,51013,2667,5
37087,2/1/19,30215,29056,1159,3.8
37089,2/1/19,55579,53581,1998,3.6
37091,2/1/19,9289,8774,515,5.5
37093,2/1/19,20397,19334,1063,5.2
37095,2/1/19,1882,1651,231,12.3
37097,2/1/19,89260,85861,3399,3.8
37099,2/1/19,19539,18581,958,4.9
37101,2/1/19,99420,95543,3877,3.9
37103,2/1/19,4484,4298,186,4.1
37105,2/1/19,26343,25065,1278,4.9
37107,2/1/19,28253,27141,1112,3.9
37109,2/1/19,43439,41791,1648,3.8
37111,2/1/19,21181,20353,828,3.9
37113,2/1/19,15367,14638,729,4.7
37115,2/1/19,10250,9851,399,3.9
37117,2/1/19,9284,8780,504,5.4
37119,2/1/19,619717,595470,24247,3.9
37121,2/1/19,6118,5801,317,5.2
37123,2/1/19,11665,11180,485,4.2
37125,2/1/19,42883,41155,1728,4
37127,2/1/19,44370,42137,2233,5
37129,2/1/19,123369,118417,4952,4
37131,2/1/19,7890,7457,433,5.5
37133,2/1/19,65667,62368,3299,5
37135,2/1/19,79413,76634,2779,3.5
37137,2/1/19,5389,5168,221,4.1
37139,2/1/19,17025,16127,898,5.3
37141,2/1/19,28872,27622,1250,4.3
37143,2/1/19,5098,4820,278,5.5
37145,2/1/19,18637,17789,848,4.6
37147,2/1/19,91076,87101,3975,4.4
37149,2/1/19,9007,8637,370,4.1
37151,2/1/19,67092,64353,2739,4.1
37153,2/1/19,16905,15931,974,5.8
37155,2/1/19,50970,47996,2974,5.8
37157,2/1/19,40673,38717,1956,4.8
37159,2/1/19,66136,63317,2819,4.3
37161,2/1/19,25471,24116,1355,5.3
37163,2/1/19,30220,28989,1231,4.1
37165,2/1/19,11912,11015,897,7.5
37167,2/1/19,30107,28920,1187,3.9
37169,2/1/19,21962,21116,846,3.9
37171,2/1/19,34148,32801,1347,3.9
37173,2/1/19,6726,6365,361,5.4
37175,2/1/19,14460,13854,606,4.2
37177,2/1/19,1369,1257,112,8.2
37179,2/1/19,123782,119154,4628,3.7
37181,2/1/19,17384,16332,1052,6.1
37183,2/1/19,595350,573936,21414,3.6
37185,2/1/19,6645,6258,387,5.8
37187,2/1/19,4549,4244,305,6.7
37189,2/1/19,29308,28159,1149,3.9
37191,2/1/19,53403,51065,2338,4.4
37193,2/1/19,29768,28460,1308,4.4
37195,2/1/19,35301,33250,2051,5.8
37197,2/1/19,17993,17333,660,3.7
37199,2/1/19,8416,8066,350,4.2
38001,2/1/19,1021,996,25,2.4
38003,2/1/19,5173,5012,161,3.1
38005,2/1/19,2291,2172,119,5.2
38007,2/1/19,353,338,15,4.2
38009,2/1/19,2886,2738,148,5.1
38011,2/1/19,1707,1677,30,1.8
38013,2/1/19,1068,1040,28,2.6
38015,2/1/19,48722,47124,1598,3.3
38017,2/1/19,101560,98926,2634,2.6
38019,2/1/19,1825,1756,69,3.8
38021,2/1/19,2256,2208,48,2.1
38023,2/1/19,1429,1410,19,1.3
38025,2/1/19,3052,2993,59,1.9
38027,2/1/19,1201,1118,83,6.9
38029,2/1/19,1408,1315,93,6.6
38031,2/1/19,1505,1449,56,3.7
38033,2/1/19,837,817,20,2.4
38035,2/1/19,37003,36089,914,2.5
38037,2/1/19,1163,1130,33,2.8
38039,2/1/19,996,968,28,2.8
38041,2/1/19,1336,1305,31,2.3
38043,2/1/19,1256,1174,82,6.5
38045,2/1/19,2027,1970,57,2.8
38047,2/1/19,865,834,31,3.6
38049,2/1/19,3035,2862,173,5.7
38051,2/1/19,1090,1047,43,3.9
38053,2/1/19,9755,9592,163,1.7
38055,2/1/19,4547,4336,211,4.6
38057,2/1/19,3528,3313,215,6.1
38059,2/1/19,16134,15435,699,4.3
38061,2/1/19,7035,6921,114,1.6
38063,2/1/19,1346,1287,59,4.4
38065,2/1/19,860,811,49,5.7
38067,2/1/19,3269,3134,135,4.1
38069,2/1/19,1690,1617,73,4.3
38071,2/1/19,5507,5292,215,3.9
38073,2/1/19,2747,2690,57,2.1
38075,2/1/19,1218,1182,36,3
38077,2/1/19,8528,8260,268,3.1
38079,2/1/19,4559,4161,398,8.7
38081,2/1/19,2589,2527,62,2.4
38083,2/1/19,659,617,42,6.4
38085,2/1/19,1206,1159,47,3.9
38087,2/1/19,381,371,10,2.6
38089,2/1/19,18045,17600,445,2.5
38091,2/1/19,964,937,27,2.8
38093,2/1/19,10242,9953,289,2.8
38095,2/1/19,1122,1086,36,3.2
38097,2/1/19,4351,4219,132,3
38099,2/1/19,5043,4849,194,3.8
38101,2/1/19,30991,29923,1068,3.4
38103,2/1/19,1854,1775,79,4.3
38105,2/1/19,23862,23377,485,2
39001,2/1/19,10857,9916,941,8.7
39003,2/1/19,47626,45580,2046,4.3
39005,2/1/19,27025,25732,1293,4.8
39007,2/1/19,44089,41589,2500,5.7
39009,2/1/19,29423,27782,1641,5.6
39011,2/1/19,24944,24149,795,3.2
39013,2/1/19,29857,27891,1966,6.6
39015,2/1/19,19531,18364,1167,6
39017,2/1/19,192776,185194,7582,3.9
39019,2/1/19,12960,12212,748,5.8
39021,2/1/19,19988,19246,742,3.7
39023,2/1/19,63255,60381,2874,4.5
39025,2/1/19,105699,101360,4339,4.1
39027,2/1/19,17677,16734,943,5.3
39029,2/1/19,47026,44509,2517,5.4
39031,2/1/19,14397,13501,896,6.2
39033,2/1/19,17988,17070,918,5.1
39035,2/1/19,613941,584378,29563,4.8
39037,2/1/19,25997,24889,1108,4.3
39039,2/1/19,17941,17134,807,4.5
39041,2/1/19,108647,105222,3425,3.2
39043,2/1/19,35826,33689,2137,6
39045,2/1/19,77233,74130,3103,4
39047,2/1/19,13848,13251,597,4.3
39049,2/1/19,687640,662683,24957,3.6
39051,2/1/19,22627,21459,1168,5.2
39053,2/1/19,12538,11736,802,6.4
39055,2/1/19,49325,47170,2155,4.4
39057,2/1/19,82403,79190,3213,3.9
39059,2/1/19,18717,17476,1241,6.6
39061,2/1/19,410312,394425,15887,3.9
39063,2/1/19,41925,40550,1375,3.3
39065,2/1/19,14161,13581,580,4.1
39067,2/1/19,6817,6411,406,6
39069,2/1/19,13337,12517,820,6.1
39071,2/1/19,17251,16252,999,5.8
39073,2/1/19,13018,12278,740,5.7
39075,2/1/19,20622,19983,639,3.1
39077,2/1/19,27965,25899,2066,7.4
39079,2/1/19,12838,11879,959,7.5
39081,2/1/19,27714,25849,1865,6.7
39083,2/1/19,31818,30431,1387,4.4
39085,2/1/19,127102,121230,5872,4.6
39087,2/1/19,23646,22353,1293,5.5
39089,2/1/19,89455,85918,3537,4
39091,2/1/19,23125,22243,882,3.8
39093,2/1/19,154820,146739,8081,5.2
39095,2/1/19,209084,198603,10481,5
39097,2/1/19,20730,19936,794,3.8
39099,2/1/19,103107,96871,6236,6
39101,2/1/19,28649,27361,1288,4.5
39103,2/1/19,97921,93937,3984,4.1
39105,2/1/19,9296,8518,778,8.4
39107,2/1/19,23335,22666,669,2.9
39109,2/1/19,53772,51577,2195,4.1
39111,2/1/19,5441,4894,547,10.1
39113,2/1/19,249709,238744,10965,4.4
39115,2/1/19,6817,6249,568,8.3
39117,2/1/19,16740,15896,844,5
39119,2/1/19,39360,36977,2383,6.1
39121,2/1/19,4754,4346,408,8.6
39123,2/1/19,20187,18503,1684,8.3
39125,2/1/19,8643,8295,348,4
39127,2/1/19,15934,14907,1027,6.4
39129,2/1/19,26334,25108,1226,4.7
39131,2/1/19,10968,10158,810,7.4
39133,2/1/19,86954,82786,4168,4.8
39135,2/1/19,21093,20172,921,4.4
39137,2/1/19,18825,18138,687,3.6
39139,2/1/19,52266,49687,2579,4.9
39141,2/1/19,35057,33391,1666,4.8
39143,2/1/19,30525,29024,1501,4.9
39145,2/1/19,28938,26830,2108,7.3
39147,2/1/19,27389,26137,1252,4.6
39149,2/1/19,24214,23283,931,3.8
39151,2/1/19,184689,175382,9307,5
39153,2/1/19,270992,258051,12941,4.8
39155,2/1/19,86648,81109,5539,6.4
39157,2/1/19,44143,41941,2202,5
39159,2/1/19,28703,27737,966,3.4
39161,2/1/19,15017,14515,502,3.3
39163,2/1/19,5598,5195,403,7.2
39165,2/1/19,117681,113388,4293,3.6
39167,2/1/19,27135,25409,1726,6.4
39169,2/1/19,62433,60253,2180,3.5
39171,2/1/19,18932,18248,684,3.6
39173,2/1/19,70749,68021,2728,3.9
39175,2/1/19,13079,12628,451,3.4
40001,2/1/19,8134,7764,370,4.5
40003,2/1/19,2826,2765,61,2.2
40005,2/1/19,4958,4735,223,4.5
40007,2/1/19,2917,2854,63,2.2
40009,2/1/19,10894,10610,284,2.6
40011,2/1/19,4689,4594,95,2
40013,2/1/19,21097,20390,707,3.4
40015,2/1/19,11953,11549,404,3.4
40017,2/1/19,73677,71549,2128,2.9
40019,2/1/19,21451,20670,781,3.6
40021,2/1/19,18675,17881,794,4.3
40023,2/1/19,5522,5244,278,5
40025,2/1/19,1341,1316,25,1.9
40027,2/1/19,142055,137689,4366,3.1
40029,2/1/19,2601,2510,91,3.5
40031,2/1/19,47949,46096,1853,3.9
40033,2/1/19,2701,2615,86,3.2
40035,2/1/19,5929,5702,227,3.8
40037,2/1/19,31381,30143,1238,3.9
40039,2/1/19,15595,15205,390,2.5
40041,2/1/19,17717,16935,782,4.4
40043,2/1/19,2806,2750,56,2
40045,2/1/19,2207,2160,47,2.1
40047,2/1/19,27289,26424,865,3.2
40049,2/1/19,12809,12388,421,3.3
40051,2/1/19,26272,25460,812,3.1
40053,2/1/19,2691,2630,61,2.3
40055,2/1/19,1850,1764,86,4.6
40057,2/1/19,1158,1124,34,2.9
40059,2/1/19,1764,1714,50,2.8
40061,2/1/19,4249,4038,211,5
40063,2/1/19,5419,5166,253,4.7
40065,2/1/19,10692,10354,338,3.2
40067,2/1/19,2530,2449,81,3.2
40069,2/1/19,3843,3679,164,4.3
40071,2/1/19,18419,17578,841,4.6
40073,2/1/19,9233,9030,203,2.2
40075,2/1/19,3438,3304,134,3.9
40077,2/1/19,3161,2959,202,6.4
40079,2/1/19,19031,18073,958,5
40081,2/1/19,15707,15108,599,3.8
40083,2/1/19,21981,21279,702,3.2
40085,2/1/19,6173,6033,140,2.3
40087,2/1/19,19506,18950,556,2.9
40089,2/1/19,14322,13470,852,5.9
40091,2/1/19,6855,6423,432,6.3
40093,2/1/19,3967,3874,93,2.3
40095,2/1/19,6795,6530,265,3.9
40097,2/1/19,19314,18671,643,3.3
40099,2/1/19,6197,5988,209,3.4
40101,2/1/19,28925,27772,1153,4
40103,2/1/19,5742,5601,141,2.5
40105,2/1/19,4600,4412,188,4.1
40107,2/1/19,4640,4431,209,4.5
40109,2/1/19,382646,369757,12889,3.4
40111,2/1/19,15589,14783,806,5.2
40113,2/1/19,20556,19703,853,4.1
40115,2/1/19,14167,13631,536,3.8
40117,2/1/19,7312,7002,310,4.2
40119,2/1/19,38276,37076,1200,3.1
40121,2/1/19,17505,16810,695,4
40123,2/1/19,18853,18277,576,3.1
40125,2/1/19,32280,31042,1238,3.8
40127,2/1/19,4388,4186,202,4.6
40129,2/1/19,1892,1845,47,2.5
40131,2/1/19,44762,43269,1493,3.3
40133,2/1/19,9484,9012,472,5
40135,2/1/19,16153,15448,705,4.4
40137,2/1/19,18709,17954,755,4
40139,2/1/19,11275,11029,246,2.2
40141,2/1/19,3054,2937,117,3.8
40143,2/1/19,320899,310056,10843,3.4
40145,2/1/19,37646,36408,1238,3.3
40147,2/1/19,22325,21487,838,3.8
40149,2/1/19,5198,5035,163,3.1
40151,2/1/19,4666,4558,108,2.3
40153,2/1/19,8964,8718,246,2.7
41001,2/1/19,7101,6646,455,6.4
41003,2/1/19,48788,47167,1621,3.3
41005,2/1/19,219196,210512,8684,4
41007,2/1/19,18942,18002,940,5
41009,2/1/19,24530,23238,1292,5.3
41011,2/1/19,26449,24892,1557,5.9
41013,2/1/19,9471,8828,643,6.8
41015,2/1/19,8815,8219,596,6.8
41017,2/1/19,95242,90280,4962,5.2
41019,2/1/19,46507,43714,2793,6
41021,2/1/19,962,910,52,5.4
41023,2/1/19,3149,2793,356,11.3
41025,2/1/19,3524,3237,287,8.1
41027,2/1/19,13727,13025,702,5.1
41029,2/1/19,103304,97743,5561,5.4
41031,2/1/19,10046,9314,732,7.3
41033,2/1/19,35761,33501,2260,6.3
41035,2/1/19,29380,26882,2498,8.5
41037,2/1/19,3505,3227,278,7.9
41039,2/1/19,180902,172254,8648,4.8
41041,2/1/19,20455,19363,1092,5.3
41043,2/1/19,59152,56043,3109,5.3
41045,2/1/19,12027,11368,659,5.5
41047,2/1/19,160637,153063,7574,4.7
41049,2/1/19,5575,5270,305,5.5
41051,2/1/19,455161,437826,17335,3.8
41053,2/1/19,39687,37781,1906,4.8
41055,2/1/19,894,856,38,4.3
41057,2/1/19,11789,11214,575,4.9
41059,2/1/19,35806,33413,2393,6.7
41061,2/1/19,12036,11181,855,7.1
41063,2/1/19,3339,3038,301,9
41065,2/1/19,12531,11762,769,6.1
41067,2/1/19,324373,312849,11524,3.6
41069,2/1/19,727,694,33,4.5
41071,2/1/19,54640,52451,2189,4
42001,2/1/19,55508,53554,1954,3.5
42003,2/1/19,644885,617862,27023,4.2
42005,2/1/19,32224,30350,1874,5.8
42007,2/1/19,83612,79664,3948,4.7
42009,2/1/19,23277,21952,1325,5.7
42011,2/1/19,214502,205075,9427,4.4
42013,2/1/19,58787,56120,2667,4.5
42015,2/1/19,28685,27357,1328,4.6
42017,2/1/19,342040,328713,13327,3.9
42019,2/1/19,99319,95179,4140,4.2
42021,2/1/19,58026,54874,3152,5.4
42023,2/1/19,2076,1950,126,6.1
42025,2/1/19,31970,30205,1765,5.5
42027,2/1/19,80520,77850,2670,3.3
42029,2/1/19,282327,273403,8924,3.2
42031,2/1/19,17213,16247,966,5.6
42033,2/1/19,35920,33813,2107,5.9
42035,2/1/19,18520,17392,1128,6.1
42037,2/1/19,33634,31902,1732,5.1
42039,2/1/19,38327,36410,1917,5
42041,2/1/19,130725,126418,4307,3.3
42043,2/1/19,142838,137263,5575,3.9
42045,2/1/19,297880,286239,11641,3.9
42047,2/1/19,15624,15016,608,3.9
42049,2/1/19,128805,122633,6172,4.8
42051,2/1/19,57219,53357,3862,6.7
42053,2/1/19,1812,1668,144,7.9
42055,2/1/19,77261,74336,2925,3.8
42057,2/1/19,7869,7455,414,5.3
42059,2/1/19,16622,15766,856,5.1
42061,2/1/19,19806,18457,1349,6.8
42063,2/1/19,39276,37255,2021,5.1
42065,2/1/19,20463,19406,1057,5.2
42067,2/1/19,12443,11769,674,5.4
42069,2/1/19,104483,99347,5136,4.9
42071,2/1/19,281378,271509,9869,3.5
42073,2/1/19,40531,38164,2367,5.8
42075,2/1/19,71775,68970,2805,3.9
42077,2/1/19,191687,182892,8795,4.6
42079,2/1/19,157052,147653,9399,6
42081,2/1/19,57079,54118,2961,5.2
42083,2/1/19,17154,16247,907,5.3
42085,2/1/19,49305,46878,2427,4.9
42087,2/1/19,20845,19771,1074,5.2
42089,2/1/19,82794,78286,4508,5.4
42091,2/1/19,452011,436106,15905,3.5
42093,2/1/19,9125,8780,345,3.8
42095,2/1/19,160534,153156,7378,4.6
42097,2/1/19,42656,40026,2630,6.2
42099,2/1/19,24242,23265,977,4
42101,2/1/19,717607,679984,37623,5.2
42103,2/1/19,25120,23664,1456,5.8
42105,2/1/19,7110,6604,506,7.1
42107,2/1/19,65939,62206,3733,5.7
42109,2/1/19,20249,19292,957,4.7
42111,2/1/19,34018,31920,2098,6.2
42113,2/1/19,2596,2455,141,5.4
42115,2/1/19,20325,19271,1054,5.2
42117,2/1/19,18845,17700,1145,6.1
42119,2/1/19,19773,19032,741,3.7
42121,2/1/19,22347,21210,1137,5.1
42123,2/1/19,18882,17935,947,5
42125,2/1/19,106646,101542,5104,4.8
42127,2/1/19,21972,20687,1285,5.8
42129,2/1/19,180399,171742,8657,4.8
42131,2/1/19,13554,12809,745,5.5
42133,2/1/19,234322,225239,9083,3.9
44001,2/1/19,25832,24908,924,3.6
44003,2/1/19,90162,86710,3452,3.8
44005,2/1/19,44232,42366,1866,4.2
44007,2/1/19,323440,308991,14449,4.5
44009,2/1/19,68480,65681,2799,4.1
45001,2/1/19,10131,9739,392,3.9
45003,2/1/19,75099,72497,2602,3.5
45005,2/1/19,2765,2602,163,5.9
45007,2/1/19,91375,88406,2969,3.2
45009,2/1/19,5036,4741,295,5.9
45011,2/1/19,8352,7935,417,5
45013,2/1/19,76074,73546,2528,3.3
45015,2/1/19,103407,100202,3205,3.1
45017,2/1/19,6603,6325,278,4.2
45019,2/1/19,210679,204692,5987,2.8
45021,2/1/19,25128,24240,888,3.5
45023,2/1/19,13353,12716,637,4.8
45025,2/1/19,22340,21526,814,3.6
45027,2/1/19,12814,12228,586,4.6
45029,2/1/19,16736,16084,652,3.9
45031,2/1/19,30580,29302,1278,4.2
45033,2/1/19,13234,12459,775,5.9
45035,2/1/19,77723,75336,2387,3.1
45037,2/1/19,10797,10435,362,3.4
45039,2/1/19,9646,9113,533,5.5
45041,2/1/19,67177,64723,2454,3.7
45043,2/1/19,25175,23872,1303,5.2
45045,2/1/19,255280,247628,7652,3
45047,2/1/19,31628,30469,1159,3.7
45049,2/1/19,8382,8110,272,3.2
45051,2/1/19,143386,135960,7426,5.2
45053,2/1/19,12492,12094,398,3.2
45055,2/1/19,29190,28172,1018,3.5
45057,2/1/19,41116,39441,1675,4.1
45059,2/1/19,30313,29222,1091,3.6
45061,2/1/19,6556,6278,278,4.2
45063,2/1/19,149498,145242,4256,2.8
45065,2/1/19,3408,3277,131,3.8
45067,2/1/19,12952,12204,748,5.8
45069,2/1/19,9048,8145,903,10
45071,2/1/19,19434,18843,591,3
45073,2/1/19,34875,33692,1183,3.4
45075,2/1/19,35249,33404,1845,5.2
45077,2/1/19,57502,55642,1860,3.2
45079,2/1/19,197778,191084,6694,3.4
45081,2/1/19,8989,8700,289,3.2
45083,2/1/19,152910,148287,4623,3
45085,2/1/19,43799,42064,1735,4
45087,2/1/19,11679,11186,493,4.2
45089,2/1/19,12260,11601,659,5.4
45091,2/1/19,139369,134743,4626,3.3
46003,2/1/19,1505,1464,41,2.7
46005,2/1/19,9548,9203,345,3.6
46007,2/1/19,1065,1008,57,5.4
46009,2/1/19,2815,2719,96,3.4
46011,2/1/19,19173,18594,579,3
46013,2/1/19,20740,20044,696,3.4
46015,2/1/19,2385,2313,72,3
46017,2/1/19,680,651,29,4.3
46019,2/1/19,4980,4807,173,3.5
46021,2/1/19,751,722,29,3.9
46023,2/1/19,3691,3553,138,3.7
46025,2/1/19,1905,1795,110,5.8
46027,2/1/19,7714,7490,224,2.9
46029,2/1/19,15410,14845,565,3.7
46031,2/1/19,1361,1302,59,4.3
46033,2/1/19,3952,3726,226,5.7
46035,2/1/19,10976,10607,369,3.4
46037,2/1/19,2716,2544,172,6.3
46039,2/1/19,2103,1950,153,7.3
46041,2/1/19,2189,2054,135,6.2
46043,2/1/19,1568,1514,54,3.4
46045,2/1/19,2040,1978,62,3
46047,2/1/19,2968,2817,151,5.1
46049,2/1/19,1038,1006,32,3.1
46051,2/1/19,4436,4221,215,4.8
46053,2/1/19,1991,1907,84,4.2
46055,2/1/19,1052,1017,35,3.3
46057,2/1/19,3229,3089,140,4.3
46059,2/1/19,1784,1728,56,3.1
46061,2/1/19,1747,1645,102,5.8
46063,2/1/19,705,686,19,2.7
46065,2/1/19,9913,9588,325,3.3
46067,2/1/19,3545,3413,132,3.7
46069,2/1/19,684,659,25,3.7
46071,2/1/19,1185,1101,84,7.1
46073,2/1/19,1111,1076,35,3.2
46075,2/1/19,500,481,19,3.8
46077,2/1/19,2676,2574,102,3.8
46079,2/1/19,6690,6432,258,3.9
46081,2/1/19,12929,12498,431,3.3
46083,2/1/19,34199,33250,949,2.8
46085,2/1/19,1596,1508,88,5.5
46087,2/1/19,3067,2962,105,3.4
46089,2/1/19,1015,964,51,5
46091,2/1/19,2318,2216,102,4.4
46093,2/1/19,13739,13152,587,4.3
46095,2/1/19,737,696,41,5.6
46097,2/1/19,1166,1129,37,3.2
46099,2/1/19,111977,108326,3651,3.3
46101,2/1/19,3982,3850,132,3.3
46102,2/1/19,3499,3181,318,9.1
46103,2/1/19,54904,52808,2096,3.8
46105,2/1/19,1424,1384,40,2.8
46107,2/1/19,1016,983,33,3.2
46109,2/1/19,4769,4503,266,5.6
46111,2/1/19,1141,1108,33,2.9
46115,2/1/19,3204,3072,132,4.1
46117,2/1/19,1849,1771,78,4.2
46119,2/1/19,797,773,24,3
46121,2/1/19,3181,2996,185,5.8
46123,2/1/19,3018,2935,83,2.8
46125,2/1/19,4689,4516,173,3.7
46127,2/1/19,8450,8146,304,3.6
46129,2/1/19,2085,1940,145,7
46135,2/1/19,11836,11484,352,3
46137,2/1/19,921,884,37,4
47001,2/1/19,34694,33474,1220,3.5
47003,2/1/19,21074,20329,745,3.5
47005,2/1/19,6996,6696,300,4.3
47007,2/1/19,4333,4081,252,5.8
47009,2/1/19,63815,61679,2136,3.3
47011,2/1/19,51158,49395,1763,3.4
47013,2/1/19,14933,14202,731,4.9
47015,2/1/19,6595,6405,190,2.9
47017,2/1/19,12228,11616,612,5
47019,2/1/19,24381,23371,1010,4.1
47021,2/1/19,21925,21354,571,2.6
47023,2/1/19,8553,8274,279,3.3
47025,2/1/19,13209,12650,559,4.2
47027,2/1/19,2853,2689,164,5.7
47029,2/1/19,15011,14130,881,5.9
47031,2/1/19,25411,24585,826,3.3
47033,2/1/19,7048,6791,257,3.6
47035,2/1/19,23470,22284,1186,5.1
47037,2/1/19,404216,394271,9945,2.5
47039,2/1/19,4572,4312,260,5.7
47041,2/1/19,7794,7458,336,4.3
47043,2/1/19,27071,26257,814,3
47045,2/1/19,16700,15923,777,4.7
47047,2/1/19,19276,18614,662,3.4
47049,2/1/19,7543,7228,315,4.2
47051,2/1/19,20295,19645,650,3.2
47053,2/1/19,22066,21108,958,4.3
47055,2/1/19,15201,14642,559,3.7
47057,2/1/19,9589,9179,410,4.3
47059,2/1/19,30077,28641,1436,4.8
47061,2/1/19,5026,4811,215,4.3
47063,2/1/19,28243,27164,1079,3.8
47065,2/1/19,184279,178456,5823,3.2
47067,2/1/19,2124,1993,131,6.2
47069,2/1/19,9520,9025,495,5.2
47071,2/1/19,10262,9797,465,4.5
47073,2/1/19,23923,22978,945,4
47075,2/1/19,7733,7331,402,5.2
47077,2/1/19,12295,11688,607,4.9
47079,2/1/19,14271,13616,655,4.6
47081,2/1/19,11464,11116,348,3
47083,2/1/19,3333,3157,176,5.3
47085,2/1/19,9050,8681,369,4.1
47087,2/1/19,4707,4460,247,5.2
47089,2/1/19,24796,23772,1024,4.1
47091,2/1/19,7683,7388,295,3.8
47093,2/1/19,244335,237440,6895,2.8
47095,2/1/19,1815,1701,114,6.3
47097,2/1/19,9754,9197,557,5.7
47099,2/1/19,19247,18482,765,4
47101,2/1/19,5157,4928,229,4.4
47103,2/1/19,17107,16604,503,2.9
47105,2/1/19,23568,22780,788,3.3
47107,2/1/19,23445,22576,869,3.7
47109,2/1/19,8517,8057,460,5.4
47111,2/1/19,11317,10991,326,2.9
47113,2/1/19,49013,47262,1751,3.6
47115,2/1/19,12501,11998,503,4
47117,2/1/19,15785,15275,510,3.2
47119,2/1/19,49350,47962,1388,2.8
47121,2/1/19,5158,4925,233,4.5
47123,2/1/19,20295,19573,722,3.6
47125,2/1/19,85510,82307,3203,3.7
47127,2/1/19,3640,3545,95,2.6
47129,2/1/19,7936,7586,350,4.4
47131,2/1/19,12554,11968,586,4.7
47133,2/1/19,10000,9557,443,4.4
47135,2/1/19,3203,3029,174,5.4
47137,2/1/19,2287,2149,138,6
47139,2/1/19,7401,7101,300,4.1
47141,2/1/19,35207,33974,1233,3.5
47143,2/1/19,13309,12475,834,6.3
47145,2/1/19,23487,22513,974,4.1
47147,2/1/19,38084,37010,1074,2.8
47149,2/1/19,184076,179487,4589,2.5
47151,2/1/19,8511,8123,388,4.6
47153,2/1/19,6227,5962,265,4.3
47155,2/1/19,52822,49711,3111,5.9
47157,2/1/19,447257,429573,17684,4
47159,2/1/19,9490,9197,293,3.1
47161,2/1/19,5495,5207,288,5.2
47163,2/1/19,70932,68277,2655,3.7
47165,2/1/19,102435,99751,2684,2.6
47167,2/1/19,28331,27235,1096,3.9
47169,2/1/19,5442,5273,169,3.1
47171,2/1/19,7268,6865,403,5.5
47173,2/1/19,7663,7346,317,4.1
47175,2/1/19,2034,1929,105,5.2
47177,2/1/19,16816,16133,683,4.1
47179,2/1/19,61205,59131,2074,3.4
47181,2/1/19,6376,6014,362,5.7
47183,2/1/19,16514,15900,614,3.7
47185,2/1/19,12401,11946,455,3.7
47187,2/1/19,128492,125496,2996,2.3
47189,2/1/19,76719,74685,2034,2.7
48001,2/1/19,23810,23054,756,3.2
48003,2/1/19,9985,9768,217,2.2
48005,2/1/19,36086,34561,1525,4.2
48007,2/1/19,9468,9012,456,4.8
48009,2/1/19,4141,4012,129,3.1
48011,2/1/19,922,894,28,3
48013,2/1/19,21555,20743,812,3.8
48015,2/1/19,14068,13566,502,3.6
48017,2/1/19,2494,2391,103,4.1
48019,2/1/19,10018,9668,350,3.5
48021,2/1/19,42576,41239,1337,3.1
48023,2/1/19,1711,1670,41,2.4
48025,2/1/19,9984,9530,454,4.5
48027,2/1/19,143561,137718,5843,4.1
48029,2/1/19,943673,912716,30957,3.3
48031,2/1/19,6430,6263,167,2.6
48033,2/1/19,365,355,10,2.7
48035,2/1/19,8269,7979,290,3.5
48037,2/1/19,39894,37931,1963,4.9
48039,2/1/19,179021,171643,7378,4.1
48041,2/1/19,120783,117526,3257,2.7
48043,2/1/19,4182,4060,122,2.9
48045,2/1/19,556,533,23,4.1
48047,2/1/19,2644,2515,129,4.9
48049,2/1/19,15999,15412,587,3.7
48051,2/1/19,8474,8207,267,3.2
48053,2/1/19,23599,22941,658,2.8
48055,2/1/19,19519,18845,674,3.5
48057,2/1/19,12151,11760,391,3.2
48059,2/1/19,6072,5876,196,3.2
48061,2/1/19,166709,156891,9818,5.9
48063,2/1/19,4922,4703,219,4.4
48065,2/1/19,2998,2905,93,3.1
48067,2/1/19,12320,11742,578,4.7
48069,2/1/19,3406,3300,106,3.1
48071,2/1/19,19502,18573,929,4.8
48073,2/1/19,21021,20202,819,3.9
48075,2/1/19,2904,2831,73,2.5
48077,2/1/19,4913,4760,153,3.1
48079,2/1/19,1113,1074,39,3.5
48081,2/1/19,1410,1358,52,3.7
48083,2/1/19,2896,2772,124,4.3
48085,2/1/19,558439,540165,18274,3.3
48087,2/1/19,1134,1099,35,3.1
48089,2/1/19,9774,9456,318,3.3
48091,2/1/19,72940,70679,2261,3.1
48093,2/1/19,5534,5348,186,3.4
48095,2/1/19,1076,1041,35,3.3
48097,2/1/19,19854,19279,575,2.9
48099,2/1/19,24061,23061,1000,4.2
48101,2/1/19,544,517,27,5
48103,2/1/19,1545,1480,65,4.2
48105,2/1/19,1630,1589,41,2.5
48107,2/1/19,2460,2363,97,3.9
48109,2/1/19,996,966,30,3
48111,2/1/19,3916,3837,79,2
48113,2/1/19,1353130,1303206,49924,3.7
48115,2/1/19,4685,4502,183,3.9
48117,2/1/19,8329,8091,238,2.9
48119,2/1/19,2443,2361,82,3.4
48121,2/1/19,489715,474447,15268,3.1
48123,2/1/19,9749,9483,266,2.7
48125,2/1/19,665,634,31,4.7
48127,2/1/19,7680,7489,191,2.5
48129,2/1/19,1480,1428,52,3.5
48131,2/1/19,5005,4777,228,4.6
48133,2/1/19,8708,8427,281,3.2
48135,2/1/19,88895,86659,2236,2.5
48137,2/1/19,944,914,30,3.2
48139,2/1/19,91796,88820,2976,3.2
48141,2/1/19,363470,348760,14710,4
48143,2/1/19,21417,20768,649,3
48145,2/1/19,6522,6297,225,3.4
48147,2/1/19,17143,16646,497,2.9
48149,2/1/19,12563,12231,332,2.6
48151,2/1/19,1615,1567,48,3
48153,2/1/19,2577,2438,139,5.4
48155,2/1/19,583,565,18,3.1
48157,2/1/19,392452,378085,14367,3.7
48159,2/1/19,4620,4440,180,3.9
48161,2/1/19,6400,6074,326,5.1
48163,2/1/19,10502,10211,291,2.8
48165,2/1/19,9764,9526,238,2.4
48167,2/1/19,165524,158521,7003,4.2
48169,2/1/19,2189,2124,65,3
48171,2/1/19,13454,13087,367,2.7
48173,2/1/19,774,756,18,2.3
48175,2/1/19,3300,3182,118,3.6
48177,2/1/19,9545,9275,270,2.8
48179,2/1/19,8083,7776,307,3.8
48181,2/1/19,64091,62083,2008,3.1
48183,2/1/19,58286,56050,2236,3.8
48185,2/1/19,11283,10872,411,3.6
48187,2/1/19,80944,78421,2523,3.1
48189,2/1/19,12401,11842,559,4.5
48191,2/1/19,1078,1029,49,4.5
48193,2/1/19,3715,3595,120,3.2
48195,2/1/19,2792,2723,69,2.5
48197,2/1/19,1681,1628,53,3.2
48199,2/1/19,25535,24307,1228,4.8
48201,2/1/19,2318974,2226146,92828,4
48203,2/1/19,29532,28340,1192,4
48205,2/1/19,2798,2750,48,1.7
48207,2/1/19,2269,2187,82,3.6
48209,2/1/19,118992,115604,3388,2.8
48211,2/1/19,1912,1864,48,2.5
48213,2/1/19,36318,34997,1321,3.6
48215,2/1/19,353073,330611,22462,6.4
48217,2/1/19,16284,15714,570,3.5
48219,2/1/19,11409,11053,356,3.1
48221,2/1/19,27398,26436,962,3.5
48223,2/1/19,17458,16884,574,3.3
48225,2/1/19,10167,9849,318,3.1
48227,2/1/19,14015,13594,421,3
48229,2/1/19,1800,1727,73,4.1
48231,2/1/19,42998,41401,1597,3.7
48233,2/1/19,8553,8166,387,4.5
48235,2/1/19,763,745,18,2.4
48237,2/1/19,3438,3325,113,3.3
48239,2/1/19,7412,7181,231,3.1
48241,2/1/19,12968,12158,810,6.2
48243,2/1/19,1028,998,30,2.9
48245,2/1/19,107741,101362,6379,5.9
48247,2/1/19,1917,1813,104,5.4
48249,2/1/19,17105,16289,816,4.8
48251,2/1/19,81586,78910,2676,3.3
48253,2/1/19,5665,5415,250,4.4
48255,2/1/19,7123,6939,184,2.6
48257,2/1/19,63947,61749,2198,3.4
48259,2/1/19,21992,21362,630,2.9
48261,2/1/19,238,231,7,2.9
48263,2/1/19,447,437,10,2.2
48265,2/1/19,22178,21493,685,3.1
48267,2/1/19,1823,1767,56,3.1
48269,2/1/19,208,202,6,2.9
48271,2/1/19,1311,1252,59,4.5
48273,2/1/19,13628,13009,619,4.5
48275,2/1/19,1429,1378,51,3.6
48277,2/1/19,23939,23050,889,3.7
48279,2/1/19,5280,5052,228,4.3
48281,2/1/19,9190,8861,329,3.6
48283,2/1/19,4480,4377,103,2.3
48285,2/1/19,8602,8337,265,3.1
48287,2/1/19,9998,9717,281,2.8
48289,2/1/19,6271,5992,279,4.4
48291,2/1/19,33063,31358,1705,5.2
48293,2/1/19,8615,8260,355,4.1
48295,2/1/19,1682,1634,48,2.9
48297,2/1/19,5377,5198,179,3.3
48299,2/1/19,8489,8168,321,3.8
48301,2/1/19,359,355,4,1.1
48303,2/1/19,158005,153479,4526,2.9
48305,2/1/19,2743,2657,86,3.1
48307,2/1/19,3652,3496,156,4.3
48309,2/1/19,119276,115172,4104,3.4
48311,2/1/19,732,719,13,1.8
48313,2/1/19,4581,4395,186,4.1
48315,2/1/19,4221,4027,194,4.6
48317,2/1/19,2859,2786,73,2.6
48319,2/1/19,1780,1715,65,3.7
48321,2/1/19,16607,15671,936,5.6
48323,2/1/19,24221,22053,2168,9
48325,2/1/19,21668,20938,730,3.4
48327,2/1/19,839,807,32,3.8
48329,2/1/19,107162,104935,2227,2.1
48331,2/1/19,9830,9250,580,5.9
48333,2/1/19,1882,1812,70,3.7
48335,2/1/19,2318,2231,87,3.8
48337,2/1/19,9216,8936,280,3
48339,2/1/19,284126,274104,10022,3.5
48341,2/1/19,10747,10488,259,2.4
48343,2/1/19,4779,4513,266,5.6
48345,2/1/19,473,455,18,3.8
48347,2/1/19,28490,27419,1071,3.8
48349,2/1/19,24045,23170,875,3.6
48351,2/1/19,5208,4880,328,6.3
48353,2/1/19,6844,6630,214,3.1
48355,2/1/19,167880,160366,7514,4.5
48357,2/1/19,4380,4267,113,2.6
48359,2/1/19,903,878,25,2.8
48361,2/1/19,36665,34750,1915,5.2
48363,2/1/19,13544,13085,459,3.4
48365,2/1/19,10465,10044,421,4
48367,2/1/19,66935,64867,2068,3.1
48369,2/1/19,4875,4755,120,2.5
48371,2/1/19,6379,6169,210,3.3
48373,2/1/19,18074,17169,905,5
48375,2/1/19,55093,53520,1573,2.9
48377,2/1/19,3058,2886,172,5.6
48379,2/1/19,6094,5891,203,3.3
48381,2/1/19,71836,69998,1838,2.6
48383,2/1/19,1847,1805,42,2.3
48385,2/1/19,1016,972,44,4.3
48387,2/1/19,5065,4820,245,4.8
48389,2/1/19,11128,10948,180,1.6
48391,2/1/19,3145,3018,127,4
48393,2/1/19,404,391,13,3.2
48395,2/1/19,7767,7464,303,3.9
48397,2/1/19,51596,49933,1663,3.2
48399,2/1/19,4514,4378,136,3
48401,2/1/19,23031,22188,843,3.7
48403,2/1/19,3748,3482,266,7.1
48405,2/1/19,3465,3305,160,4.6
48407,2/1/19,11771,11207,564,4.8
48409,2/1/19,29971,28200,1771,5.9
48411,2/1/19,2666,2589,77,2.9
48413,2/1/19,1370,1332,38,2.8
48415,2/1/19,6672,6464,208,3.1
48417,2/1/19,1884,1843,41,2.2
48419,2/1/19,11047,10600,447,4
48421,2/1/19,1401,1367,34,2.4
48423,2/1/19,106791,103024,3767,3.5
48425,2/1/19,4345,4178,167,3.8
48427,2/1/19,25700,23212,2488,9.7
48429,2/1/19,4208,4074,134,3.2
48431,2/1/19,569,551,18,3.2
48433,2/1/19,571,553,18,3.2
48435,2/1/19,1515,1463,52,3.4
48437,2/1/19,2654,2547,107,4
48439,2/1/19,1075811,1039223,36588,3.4
48441,2/1/19,66344,64357,1987,3
48443,2/1/19,377,364,13,3.4
48445,2/1/19,5043,4839,204,4
48447,2/1/19,647,623,24,3.7
48449,2/1/19,12814,12262,552,4.3
48451,2/1/19,55134,53402,1732,3.1
48453,2/1/19,736440,716500,19940,2.7
48455,2/1/19,5291,5022,269,5.1
48457,2/1/19,7168,6747,421,5.9
48459,2/1/19,17891,17203,688,3.8
48461,2/1/19,1616,1565,51,3.2
48463,2/1/19,11363,10886,477,4.2
48465,2/1/19,22580,21770,810,3.6
48467,2/1/19,25896,25000,896,3.5
48469,2/1/19,43230,41712,1518,3.5
48471,2/1/19,24259,23330,929,3.8
48473,2/1/19,23428,22519,909,3.9
48475,2/1/19,7538,7364,174,2.3
48477,2/1/19,14980,14468,512,3.4
48479,2/1/19,118668,113960,4708,4
48481,2/1/19,21328,20591,737,3.5
48483,2/1/19,2277,2208,69,3
48485,2/1/19,56475,54590,1885,3.3
48487,2/1/19,4997,4811,186,3.7
48489,2/1/19,6601,6018,583,8.8
48491,2/1/19,311665,302476,9189,2.9
48493,2/1/19,24704,23974,730,3
48495,2/1/19,4103,3992,111,2.7
48497,2/1/19,31639,30609,1030,3.3
48499,2/1/19,17604,16870,734,4.2
48501,2/1/19,3774,3661,113,3
48503,2/1/19,7982,7737,245,3.1
48505,2/1/19,5309,5033,276,5.2
48507,2/1/19,3353,3059,294,8.8
49001,2/1/19,2902,2798,104,3.6
49003,2/1/19,25509,24671,838,3.3
49005,2/1/19,64348,62629,1719,2.7
49007,2/1/19,8419,8044,375,4.5
49009,2/1/19,330,307,23,7
49011,2/1/19,170915,166031,4884,2.9
49013,2/1/19,7680,7318,362,4.7
49015,2/1/19,4238,4009,229,5.4
49017,2/1/19,2352,2048,304,12.9
49019,2/1/19,5414,5013,401,7.4
49021,2/1/19,23793,22955,838,3.5
49023,2/1/19,5707,5519,188,3.3
49025,2/1/19,3527,3368,159,4.5
49027,2/1/19,5856,5650,206,3.5
49029,2/1/19,5466,5312,154,2.8
49031,2/1/19,479,451,28,5.8
49033,2/1/19,931,882,49,5.3
49035,2/1/19,624913,606139,18774,3
49037,2/1/19,5505,5119,386,7
49039,2/1/19,12457,11969,488,3.9
49041,2/1/19,9639,9245,394,4.1
49043,2/1/19,26889,26235,654,2.4
49045,2/1/19,33514,32363,1151,3.4
49047,2/1/19,13486,12847,639,4.7
49049,2/1/19,305745,297112,8633,2.8
49051,2/1/19,15938,15453,485,3
49053,2/1/19,75008,72381,2627,3.5
49055,2/1/19,1278,1149,129,10.1
49057,2/1/19,125683,121232,4451,3.5
50001,2/1/19,20345,19772,573,2.8
50003,2/1/19,18280,17669,611,3.3
50005,2/1/19,14243,13699,544,3.8
50007,2/1/19,96406,94741,1665,1.7
50009,2/1/19,2651,2540,111,4.2
50011,2/1/19,27390,26619,771,2.8
50013,2/1/19,4095,3926,169,4.1
50015,2/1/19,13962,13428,534,3.8
50017,2/1/19,15754,15281,473,3
50019,2/1/19,13533,12763,770,5.7
50021,2/1/19,30506,29597,909,3
50023,2/1/19,34548,33586,962,2.8
50025,2/1/19,22371,21733,638,2.9
50027,2/1/19,29343,28715,628,2.1
51001,2/1/19,16518,15741,777,4.7
51003,2/1/19,57156,55602,1554,2.7
51005,2/1/19,7017,6741,276,3.9
51007,2/1/19,6283,6044,239,3.8
51009,2/1/19,15148,14626,522,3.4
51011,2/1/19,7226,6940,286,4
51013,2/1/19,153729,150532,3197,2.1
51015,2/1/19,37448,36429,1019,2.7
51017,2/1/19,2447,2373,74,3
51019,2/1/19,38764,37534,1230,3.2
51021,2/1/19,2877,2787,90,3.1
51023,2/1/19,17421,16932,489,2.8
51025,2/1/19,6154,5794,360,5.8
51027,2/1/19,6805,6414,391,5.7
51029,2/1/19,6455,6128,327,5.1
51031,2/1/19,26212,25314,898,3.4
51033,2/1/19,15274,14721,553,3.6
51035,2/1/19,13284,12713,571,4.3
51036,2/1/19,3668,3521,147,4
51037,2/1/19,5328,5132,196,3.7
51041,2/1/19,187639,181969,5670,3
51043,2/1/19,7564,7345,219,2.9
51045,2/1/19,2315,2222,93,4
51047,2/1/19,24509,23771,738,3
51049,2/1/19,4684,4512,172,3.7
51051,2/1/19,4690,4443,247,5.3
51053,2/1/19,13667,13160,507,3.7
51057,2/1/19,5553,5299,254,4.6
51059,2/1/19,633030,616948,16082,2.5
51061,2/1/19,37093,36031,1062,2.9
51063,2/1/19,8336,8091,245,2.9
51065,2/1/19,13893,13549,344,2.5
51067,2/1/19,26405,25536,869,3.3
51069,2/1/19,48017,46680,1337,2.8
51071,2/1/19,8076,7786,290,3.6
51073,2/1/19,19539,18953,586,3
51075,2/1/19,11212,10864,348,3.1
51077,2/1/19,8037,7757,280,3.5
51079,2/1/19,10480,10210,270,2.6
51081,2/1/19,4353,4178,175,4
51083,2/1/19,15633,14977,656,4.2
51085,2/1/19,59239,57654,1585,2.7
51087,2/1/19,182264,176613,5651,3.1
51089,2/1/19,24019,23122,897,3.7
51091,2/1/19,1252,1213,39,3.1
51093,2/1/19,19381,18769,612,3.2
51095,2/1/19,36548,35426,1122,3.1
51097,2/1/19,3865,3741,124,3.2
51099,2/1/19,13370,12946,424,3.2
51101,2/1/19,9183,8871,312,3.4
51103,2/1/19,5412,5010,402,7.4
51105,2/1/19,8295,7950,345,4.2
51107,2/1/19,221800,216113,5687,2.6
51109,2/1/19,19808,19214,594,3
51111,2/1/19,5368,5193,175,3.3
51113,2/1/19,7307,7116,191,2.6
51115,2/1/19,4139,3998,141,3.4
51117,2/1/19,12880,12343,537,4.2
51119,2/1/19,5228,5059,169,3.2
51121,2/1/19,51393,49809,1584,3.1
51125,2/1/19,7426,7194,232,3.1
51127,2/1/19,12470,12143,327,2.6
51131,2/1/19,5247,4923,324,6.2
51133,2/1/19,5628,5248,380,6.8
51135,2/1/19,7259,7035,224,3.1
51137,2/1/19,17194,16623,571,3.3
51139,2/1/19,11916,11226,690,5.8
51141,2/1/19,7470,7153,317,4.2
51143,2/1/19,30333,29237,1096,3.6
51145,2/1/19,14155,13743,412,2.9
51147,2/1/19,10487,10073,414,3.9
51149,2/1/19,15091,14546,545,3.6
51153,2/1/19,245031,237970,7061,2.9
51155,2/1/19,16424,15863,561,3.4
51157,2/1/19,3676,3565,111,3
51159,2/1/19,4046,3900,146,3.6
51161,2/1/19,49431,48055,1376,2.8
51163,2/1/19,10618,10265,353,3.3
51165,2/1/19,42481,41324,1157,2.7
51167,2/1/19,11294,10718,576,5.1
51169,2/1/19,9148,8818,330,3.6
51171,2/1/19,22288,21637,651,2.9
51173,2/1/19,13670,13093,577,4.2
51175,2/1/19,9050,8795,255,2.8
51177,2/1/19,66909,64700,2209,3.3
51179,2/1/19,71898,69673,2225,3.1
51181,2/1/19,3689,3547,142,3.8
51183,2/1/19,3793,3598,195,5.1
51185,2/1/19,15859,15064,795,5
51187,2/1/19,20387,19716,671,3.3
51191,2/1/19,26833,25802,1031,3.8
51193,2/1/19,9339,8902,437,4.7
51195,2/1/19,13571,12900,671,4.9
51197,2/1/19,13728,13195,533,3.9
51199,2/1/19,32761,31739,1022,3.1
51510,2/1/19,100938,98600,2338,2.3
51520,2/1/19,7218,6915,303,4.2
51530,2/1/19,3388,3282,106,3.1
51540,2/1/19,26425,25741,684,2.6
51550,2/1/19,122531,118577,3954,3.2
51570,2/1/19,8827,8506,321,3.6
51580,2/1/19,2418,2312,106,4.4
51590,2/1/19,19302,18271,1031,5.3
51595,2/1/19,2341,2204,137,5.9
51600,2/1/19,13412,13083,329,2.5
51610,2/1/19,8559,8371,188,2.2
51620,2/1/19,3568,3416,152,4.3
51630,2/1/19,14139,13602,537,3.8
51640,2/1/19,2925,2819,106,3.6
51650,2/1/19,64448,61642,2806,4.4
51660,2/1/19,25447,24532,915,3.6
51670,2/1/19,9693,9251,442,4.6
51678,2/1/19,2106,1998,108,5.1
51680,2/1/19,36660,35217,1443,3.9
51683,2/1/19,22058,21373,685,3.1
51685,2/1/19,9368,9087,281,3
51690,2/1/19,5522,5280,242,4.4
51700,2/1/19,88885,85338,3547,4
51710,2/1/19,111598,107266,4332,3.9
51720,2/1/19,1709,1637,72,4.2
51730,2/1/19,13085,12274,811,6.2
51735,2/1/19,6362,6189,173,2.7
51740,2/1/19,44283,42346,1937,4.4
51750,2/1/19,8866,8536,330,3.7
51760,2/1/19,118480,114197,4283,3.6
51770,2/1/19,49237,47612,1625,3.3
51775,2/1/19,13007,12606,401,3.1
51790,2/1/19,12242,11884,358,2.9
51800,2/1/19,44583,43062,1521,3.4
51810,2/1/19,232646,225616,7030,3
51820,2/1/19,10712,10367,345,3.2
51830,2/1/19,6703,6400,303,4.5
51840,2/1/19,14766,14282,484,3.3
53001,2/1/19,8457,7686,771,9.1
53003,2/1/19,10356,9855,501,4.8
53005,2/1/19,99233,92050,7183,7.2
53007,2/1/19,42347,39380,2967,7
53009,2/1/19,28786,26189,2597,9
53011,2/1/19,241192,228836,12356,5.1
53013,2/1/19,1816,1688,128,7
53015,2/1/19,47884,44701,3183,6.6
53017,2/1/19,20700,19002,1698,8.2
53019,2/1/19,2514,2133,381,15.2
53021,2/1/19,40707,36844,3863,9.5
53023,2/1/19,884,819,65,7.4
53025,2/1/19,44980,40618,4362,9.7
53027,2/1/19,29085,26533,2552,8.8
53029,2/1/19,35370,33282,2088,5.9
53031,2/1/19,12530,11639,891,7.1
53033,2/1/19,1290113,1251418,38695,3
53035,2/1/19,127585,120681,6904,5.4
53037,2/1/19,22755,21106,1649,7.2
53039,2/1/19,9900,9104,796,8
53041,2/1/19,34804,32109,2695,7.7
53043,2/1/19,4902,4584,318,6.5
53045,2/1/19,25078,23046,2032,8.1
53047,2/1/19,19552,17653,1899,9.7
53049,2/1/19,8399,7719,680,8.1
53051,2/1/19,5080,4594,486,9.6
53053,2/1/19,438949,412240,26709,6.1
53055,2/1/19,7854,7469,385,4.9
53057,2/1/19,62138,57821,4317,6.9
53059,2/1/19,5594,5209,385,6.9
53061,2/1/19,440431,424843,15588,3.5
53063,2/1/19,254303,237962,16341,6.4
53065,2/1/19,19109,17361,1748,9.1
53067,2/1/19,142026,133997,8029,5.7
53069,2/1/19,1374,1270,104,7.6
53071,2/1/19,29160,27337,1823,6.3
53073,2/1/19,115073,108038,7035,6.1
53075,2/1/19,24566,23501,1065,4.3
53077,2/1/19,124686,111637,13049,10.5
54001,2/1/19,7301,6735,566,7.8
54003,2/1/19,57122,54697,2425,4.2
54005,2/1/19,7362,6920,442,6
54007,2/1/19,5247,4735,512,9.8
54009,2/1/19,9925,9326,599,6
54011,2/1/19,41122,39173,1949,4.7
54013,2/1/19,2689,2215,474,17.6
54015,2/1/19,3201,2829,372,11.6
54017,2/1/19,3869,3661,208,5.4
54019,2/1/19,16122,15019,1103,6.8
54021,2/1/19,2355,2164,191,8.1
54023,2/1/19,5857,5423,434,7.4
54025,2/1/19,15498,14530,968,6.2
54027,2/1/19,10687,10164,523,4.9
54029,2/1/19,12931,12213,718,5.6
54031,2/1/19,5856,5452,404,6.9
54033,2/1/19,34340,32544,1796,5.2
54035,2/1/19,13020,12184,836,6.4
54037,2/1/19,29783,28732,1051,3.5
54039,2/1/19,81846,77326,4520,5.5
54041,2/1/19,6980,6514,466,6.7
54043,2/1/19,7199,6628,571,7.9
54045,2/1/19,11029,10303,726,6.6
54047,2/1/19,4495,4018,477,10.6
54049,2/1/19,25608,24112,1496,5.8
54051,2/1/19,14083,12951,1132,8
54053,2/1/19,10206,9459,747,7.3
54055,2/1/19,20904,19557,1347,6.4
54057,2/1/19,12610,11872,738,5.9
54059,2/1/19,6766,6280,486,7.2
54061,2/1/19,54495,52216,2279,4.2
54063,2/1/19,5928,5609,319,5.4
54065,2/1/19,8003,7618,385,4.8
54067,2/1/19,9447,8716,731,7.7
54069,2/1/19,20861,19778,1083,5.2
54071,2/1/19,3645,3463,182,5
54073,2/1/19,2899,2658,241,8.3
54075,2/1/19,4227,3960,267,6.3
54077,2/1/19,15657,14706,951,6.1
54079,2/1/19,26654,25207,1447,5.4
54081,2/1/19,30165,28480,1685,5.6
54083,2/1/19,12237,11337,900,7.4
54085,2/1/19,4415,4050,365,8.3
54087,2/1/19,5217,4534,683,13.1
54089,2/1/19,4207,3901,306,7.3
54091,2/1/19,7820,7333,487,6.2
54093,2/1/19,3400,3173,227,6.7
54095,2/1/19,3232,2916,316,9.8
54097,2/1/19,9544,8891,653,6.8
54099,2/1/19,15759,14726,1033,6.6
54101,2/1/19,3295,3003,292,8.9
54103,2/1/19,6693,6071,622,9.3
54105,2/1/19,2317,2074,243,10.5
54107,2/1/19,36399,34081,2318,6.4
54109,2/1/19,6691,6142,549,8.2
55001,2/1/19,8035,7452,583,7.3
55003,2/1/19,7587,7162,425,5.6
55005,2/1/19,24487,23065,1422,5.8
55007,2/1/19,7341,6768,573,7.8
55009,2/1/19,141741,137033,4708,3.3
55011,2/1/19,6325,5977,348,5.5
55013,2/1/19,7081,6553,528,7.5
55015,2/1/19,27422,26588,834,3
55017,2/1/19,33439,31670,1769,5.3
55019,2/1/19,17425,16641,784,4.5
55021,2/1/19,31589,30343,1246,3.9
55023,2/1/19,7630,7161,469,6.1
55025,2/1/19,320566,312422,8144,2.5
55027,2/1/19,47145,45455,1690,3.6
55029,2/1/19,13925,13073,852,6.1
55031,2/1/19,23431,22210,1221,5.2
55033,2/1/19,24815,23713,1102,4.4
55035,2/1/19,58936,56978,1958,3.3
55037,2/1/19,2239,2105,134,6
55039,2/1/19,57104,55240,1864,3.3
55041,2/1/19,3971,3718,253,6.4
55043,2/1/19,27980,26850,1130,4
55045,2/1/19,20909,20130,779,3.7
55047,2/1/19,9301,8787,514,5.5
55049,2/1/19,13594,13046,548,4
55051,2/1/19,2550,2347,203,8
55053,2/1/19,10131,9565,566,5.6
55055,2/1/19,45830,44050,1780,3.9
55057,2/1/19,13234,12646,588,4.4
55059,2/1/19,89336,85419,3917,4.4
55061,2/1/19,10934,10475,459,4.2
55063,2/1/19,67186,64979,2207,3.3
55065,2/1/19,9889,9534,355,3.6
55067,2/1/19,9383,8876,507,5.4
55069,2/1/19,15124,14432,692,4.6
55071,2/1/19,40925,39312,1613,3.9
55073,2/1/19,73263,70875,2388,3.3
55075,2/1/19,19391,18376,1015,5.2
55077,2/1/19,7652,7191,461,6
55078,2/1/19,1560,1473,87,5.6
55079,2/1/19,468628,449594,19034,4.1
55081,2/1/19,23213,22300,913,3.9
55083,2/1/19,20539,19571,968,4.7
55085,2/1/19,17660,16645,1015,5.7
55087,2/1/19,103381,99908,3473,3.4
55089,2/1/19,48936,47479,1457,3
55091,2/1/19,4048,3820,228,5.6
55093,2/1/19,25455,24284,1171,4.6
55095,2/1/19,24691,23172,1519,6.2
55097,2/1/19,39021,37494,1527,3.9
55099,2/1/19,6327,6022,305,4.8
55101,2/1/19,99147,94630,4517,4.6
55103,2/1/19,9089,8734,355,3.9
55105,2/1/19,84948,81459,3489,4.1
55107,2/1/19,6848,6399,449,6.6
55109,2/1/19,50678,48469,2209,4.4
55111,2/1/19,34775,33536,1239,3.6
55113,2/1/19,7667,7160,507,6.6
55115,2/1/19,20764,19910,854,4.1
55117,2/1/19,61720,59928,1792,2.9
55119,2/1/19,10954,10351,603,5.5
55121,2/1/19,15908,15121,787,4.9
55123,2/1/19,15092,14392,700,4.6
55125,2/1/19,9569,9021,548,5.7
55127,2/1/19,57568,55297,2271,3.9
55129,2/1/19,7640,7184,456,6
55131,2/1/19,77453,74999,2454,3.2
55133,2/1/19,225502,218552,6950,3.1
55135,2/1/19,25832,24856,976,3.8
55137,2/1/19,11524,10881,643,5.6
55139,2/1/19,91955,89170,2785,3
55141,2/1/19,35003,33323,1680,4.8
56001,2/1/19,20542,19968,574,2.8
56003,2/1/19,5022,4778,244,4.9
56005,2/1/19,22870,22056,814,3.6
56007,2/1/19,7564,7260,304,4
56009,2/1/19,8285,8054,231,2.8
56011,2/1/19,3545,3433,112,3.2
56013,2/1/19,18590,17624,966,5.2
56015,2/1/19,6559,6324,235,3.6
56017,2/1/19,2166,2093,73,3.4
56019,2/1/19,4029,3850,179,4.4
56021,2/1/19,48335,46685,1650,3.4
56023,2/1/19,8753,8449,304,3.5
56025,2/1/19,39226,37576,1650,4.2
56027,2/1/19,1231,1203,28,2.3
56029,2/1/19,14395,13630,765,5.3
56031,2/1/19,4715,4559,156,3.3
56033,2/1/19,15483,14840,643,4.2
56035,2/1/19,3970,3775,195,4.9
56037,2/1/19,21256,20357,899,4.2
56039,2/1/19,14989,14664,325,2.2
56041,2/1/19,8951,8586,365,4.1
56043,2/1/19,3924,3749,175,4.5
56045,2/1/19,3820,3694,126,3.3
72001,2/1/19,4240,3437,803,18.9
72003,2/1/19,11875,10524,1351,11.4
72005,2/1/19,14436,12838,1598,11.1
72007,2/1/19,6418,5786,632,9.8
72009,2/1/19,6354,5618,736,11.6
72011,2/1/19,8746,7939,807,9.2
72013,2/1/19,23364,20979,2385,10.2
72015,2/1/19,4695,3999,696,14.8
72017,2/1/19,5820,5121,699,12
72019,2/1/19,7192,6540,652,9.1
72021,2/1/19,63766,59620,4146,6.5
72023,2/1/19,13244,11985,1259,9.5
72025,2/1/19,46865,43398,3467,7.4
72027,2/1/19,9290,8438,852,9.2
72029,2/1/19,15701,14592,1109,7.1
72031,2/1/19,60103,56387,3716,6.2
72033,2/1/19,7670,7087,583,7.6
72035,2/1/19,15787,14612,1175,7.4
72037,2/1/19,3682,3252,430,11.7
72039,2/1/19,3610,3212,398,11
72041,2/1/19,15276,14069,1207,7.9
72043,2/1/19,9874,8558,1316,13.3
72045,2/1/19,4798,4341,457,9.5
72047,2/1/19,8744,7927,817,9.3
72049,2/1/19,886,861,25,2.8
72051,2/1/19,12825,12089,736,5.7
72053,2/1/19,10861,9567,1294,11.9
72054,2/1/19,3287,2885,402,12.2
72055,2/1/19,3918,3293,625,16
72057,2/1/19,11059,9612,1447,13.1
72059,2/1/19,4851,4081,770,15.9
72061,2/1/19,36701,35150,1551,4.2
72063,2/1/19,17671,16594,1077,6.1
72065,2/1/19,13582,11513,2069,15.2
72067,2/1/19,5283,4792,491,9.3
72069,2/1/19,16967,15031,1936,11.4
72071,2/1/19,12262,11050,1212,9.9
72073,2/1/19,4309,3625,684,15.9
72075,2/1/19,14838,13287,1551,10.5
72077,2/1/19,12005,10948,1057,8.8
72079,2/1/19,5091,4377,714,14
72081,2/1/19,6904,5662,1242,18
72083,2/1/19,2702,2327,375,13.9
72085,2/1/19,11043,10018,1025,9.3
72087,2/1/19,8191,7574,617,7.5
72089,2/1/19,6118,5464,654,10.7
72091,2/1/19,11266,10340,926,8.2
72093,2/1/19,1917,1603,314,16.4
72095,2/1/19,2992,2446,546,18.2
72097,2/1/19,21574,19080,2494,11.6
72099,2/1/19,10381,9206,1175,11.3
72101,2/1/19,7778,7050,728,9.4
72103,2/1/19,8030,7227,803,10
72105,2/1/19,6883,6305,578,8.4
72107,2/1/19,4910,4337,573,11.7
72109,2/1/19,4480,3621,859,19.2
72111,2/1/19,5846,4982,864,14.8
72113,2/1/19,45127,40455,4672,10.4
72115,2/1/19,6035,5208,827,13.7
72117,2/1/19,4916,4039,877,17.8
72119,2/1/19,16604,15268,1336,8
72121,2/1/19,6032,5158,874,14.5
72123,2/1/19,7089,6040,1049,14.8
72125,2/1/19,9554,8354,1200,12.6
72127,2/1/19,131088,123547,7541,5.8
72129,2/1/19,11483,10387,1096,9.5
72131,2/1/19,10323,8666,1657,16.1
72133,2/1/19,9370,8484,886,9.5
72135,2/1/19,26445,24894,1551,5.9
72137,2/1/19,28501,26790,1711,6
72139,2/1/19,26441,25073,1368,5.2
72141,2/1/19,6584,5796,788,12
72143,2/1/19,9471,8691,780,8.2
72145,2/1/19,12977,11676,1301,10
72147,2/1/19,2645,2415,230,8.7
72149,2/1/19,7621,6186,1435,18.8
72151,2/1/19,8731,7484,1247,14.3
72153,2/1/19,9897,8228,1669,16.9
1001,3/1/19,26255,25424,831,3.2
1003,3/1/19,97617,94468,3149,3.2
1005,3/1/19,8426,8069,357,4.2
1007,3/1/19,8694,8384,310,3.6
1009,3/1/19,25331,24538,793,3.1
1011,3/1/19,4800,4628,172,3.6
1013,3/1/19,9190,8826,364,4
1015,3/1/19,46300,44442,1858,4
1017,3/1/19,15763,15226,537,3.4
1019,3/1/19,11733,11345,388,3.3
1021,3/1/19,19813,19194,619,3.1
1023,3/1/19,4905,4668,237,4.8
1025,3/1/19,7640,7183,457,6
1027,3/1/19,6112,5906,206,3.4
1029,3/1/19,5818,5597,221,3.8
1031,3/1/19,21534,20804,730,3.4
1033,3/1/19,23709,22724,985,4.2
1035,3/1/19,4544,4337,207,4.6
1037,3/1/19,4554,4396,158,3.5
1039,3/1/19,15731,15112,619,3.9
1041,3/1/19,6490,6264,226,3.5
1043,3/1/19,38907,37714,1193,3.1
1045,3/1/19,20827,20064,763,3.7
1047,3/1/19,14893,14028,865,5.8
1049,3/1/19,31078,30026,1052,3.4
1051,3/1/19,37670,36540,1130,3
1053,3/1/19,14846,14283,563,3.8
1055,3/1/19,43087,41434,1653,3.8
1057,3/1/19,6588,6356,232,3.5
1059,3/1/19,14646,14173,473,3.2
1061,3/1/19,11080,10705,375,3.4
1063,3/1/19,2854,2699,155,5.4
1065,3/1/19,6091,5838,253,4.2
1067,3/1/19,6982,6688,294,4.2
1069,3/1/19,46447,44834,1613,3.5
1071,3/1/19,23817,22892,925,3.9
1073,3/1/19,318826,308404,10422,3.3
1075,3/1/19,5827,5623,204,3.5
1077,3/1/19,42587,41081,1506,3.5
1079,3/1/19,14326,13819,507,3.5
1081,3/1/19,76430,73908,2522,3.3
1083,3/1/19,43933,42577,1356,3.1
1085,3/1/19,3601,3379,222,6.2
1087,3/1/19,7814,7434,380,4.9
1089,3/1/19,185552,180020,5532,3
1091,3/1/19,7754,7446,308,4
1093,3/1/19,12967,12459,508,3.9
1095,3/1/19,43974,42676,1298,3
1097,3/1/19,189946,182035,7911,4.2
1099,3/1/19,7286,6900,386,5.3
1101,3/1/19,106155,102427,3728,3.5
1103,3/1/19,58362,56634,1728,3
1105,3/1/19,3419,3237,182,5.3
1107,3/1/19,7910,7598,312,3.9
1109,3/1/19,15401,14830,571,3.7
1111,3/1/19,9672,9319,353,3.6
1113,3/1/19,24205,23395,810,3.3
1115,3/1/19,40538,39271,1267,3.1
1117,3/1/19,115923,112944,2979,2.6
1119,3/1/19,4822,4584,238,4.9
1121,3/1/19,35966,34633,1333,3.7
1123,3/1/19,18523,17864,659,3.6
1125,3/1/19,104769,101520,3249,3.1
1127,3/1/19,25355,24404,951,3.8
1129,3/1/19,6881,6535,346,5
1131,3/1/19,2738,2528,210,7.7
1133,3/1/19,9949,9573,376,3.8
2013,3/1/19,2841,2775,66,2.3
2016,3/1/19,4560,4434,126,2.8
2020,3/1/19,146913,138995,7918,5.4
2050,3/1/19,6922,5999,923,13.3
2060,3/1/19,243,210,33,13.6
2068,3/1/19,593,481,112,18.9
2070,3/1/19,1835,1657,178,9.7
2090,3/1/19,44388,41714,2674,6
2100,3/1/19,929,800,129,13.9
2105,3/1/19,1007,822,185,18.4
2110,3/1/19,16519,15658,861,5.2
2122,3/1/19,25347,23313,2034,8
2130,3/1/19,6305,5825,480,7.6
2150,3/1/19,6071,5757,314,5.2
2158,3/1/19,2754,2183,571,20.7
2164,3/1/19,633,548,85,13.4
2170,3/1/19,47202,43537,3665,7.8
2180,3/1/19,4056,3593,463,11.4
2185,3/1/19,3673,3449,224,6.1
2188,3/1/19,2827,2440,387,13.7
2195,3/1/19,1326,1175,151,11.4
2198,3/1/19,2830,2460,370,13.1
2220,3/1/19,4113,3925,188,4.6
2230,3/1/19,596,492,104,17.4
2240,3/1/19,2731,2442,289,10.6
2261,3/1/19,4208,3808,400,9.5
2275,3/1/19,948,861,87,9.2
2282,3/1/19,214,189,25,11.7
2290,3/1/19,2479,2064,415,16.7
4001,3/1/19,20724,18654,2070,10
4003,3/1/19,50888,47900,2988,5.9
4005,3/1/19,76714,72173,4541,5.9
4007,3/1/19,21680,20464,1216,5.6
4009,3/1/19,15563,14783,780,5
4011,3/1/19,4453,4269,184,4.1
4012,3/1/19,9705,9109,596,6.1
4013,3/1/19,2283827,2188827,95000,4.2
4015,3/1/19,86827,81819,5008,5.8
4017,3/1/19,40780,37562,3218,7.9
4019,3/1/19,497331,475077,22254,4.5
4021,3/1/19,186693,177398,9295,5
4023,3/1/19,19999,18480,1519,7.6
4025,3/1/19,105992,101216,4776,4.5
4027,3/1/19,99841,87403,12438,12.5
5001,3/1/19,9347,9045,302,3.2
5003,3/1/19,7761,7321,440,5.7
5005,3/1/19,16288,15596,692,4.2
5007,3/1/19,136211,132674,3537,2.6
5009,3/1/19,16112,15594,518,3.2
5011,3/1/19,4460,4260,200,4.5
5013,3/1/19,2434,2313,121,5
5015,3/1/19,12410,11991,419,3.4
5017,3/1/19,3231,2989,242,7.5
5019,3/1/19,9701,9406,295,3
5021,3/1/19,5641,5349,292,5.2
5023,3/1/19,9184,8759,425,4.6
5025,3/1/19,3200,3070,130,4.1
5027,3/1/19,9178,8792,386,4.2
5029,3/1/19,8211,7879,332,4
5031,3/1/19,55107,53612,1495,2.7
5033,3/1/19,26789,25924,865,3.2
5035,3/1/19,21202,20331,871,4.1
5037,3/1/19,7289,6975,314,4.3
5039,3/1/19,2841,2703,138,4.9
5041,3/1/19,5369,5133,236,4.4
5043,3/1/19,7864,7425,439,5.6
5045,3/1/19,62445,60632,1813,2.9
5047,3/1/19,7408,7176,232,3.1
5049,3/1/19,4916,4720,196,4
5051,3/1/19,41557,40059,1498,3.6
5053,3/1/19,8369,8117,252,3
5055,3/1/19,20059,19387,672,3.4
5057,3/1/19,9983,9607,376,3.8
5059,3/1/19,13970,13465,505,3.6
5061,3/1/19,5708,5528,180,3.2
5063,3/1/19,16649,16042,607,3.6
5065,3/1/19,4945,4695,250,5.1
5067,3/1/19,5795,5434,361,6.2
5069,3/1/19,27719,26261,1458,5.3
5071,3/1/19,10436,9975,461,4.4
5073,3/1/19,2473,2362,111,4.5
5075,3/1/19,6817,6555,262,3.8
5077,3/1/19,2788,2657,131,4.7
5079,3/1/19,3921,3743,178,4.5
5081,3/1/19,5483,5250,233,4.2
5083,3/1/19,8552,8212,340,4
5085,3/1/19,34318,33288,1030,3
5087,3/1/19,7277,7103,174,2.4
5089,3/1/19,6636,6363,273,4.1
5091,3/1/19,19666,18841,825,4.2
5093,3/1/19,17223,16411,812,4.7
5095,3/1/19,2748,2629,119,4.3
5097,3/1/19,2931,2794,137,4.7
5099,3/1/19,3678,3548,130,3.5
5101,3/1/19,3334,3213,121,3.6
5103,3/1/19,9833,9292,541,5.5
5105,3/1/19,4276,4090,186,4.3
5107,3/1/19,6453,6070,383,5.9
5109,3/1/19,4205,4051,154,3.7
5111,3/1/19,10097,9766,331,3.3
5113,3/1/19,8012,7717,295,3.7
5115,3/1/19,28937,27774,1163,4
5117,3/1/19,3519,3371,148,4.2
5119,3/1/19,190490,184185,6305,3.3
5121,3/1/19,7227,6946,281,3.9
5123,3/1/19,8142,7692,450,5.5
5125,3/1/19,59196,57577,1619,2.7
5127,3/1/19,4291,4146,145,3.4
5129,3/1/19,2857,2719,138,4.8
5131,3/1/19,56510,54723,1787,3.2
5133,3/1/19,5403,5150,253,4.7
5135,3/1/19,5808,5539,269,4.6
5137,3/1/19,4736,4497,239,5
5139,3/1/19,15915,15108,807,5.1
5141,3/1/19,5726,5438,288,5
5143,3/1/19,124010,121081,2929,2.4
5145,3/1/19,34037,32430,1607,4.7
5147,3/1/19,2725,2578,147,5.4
5149,3/1/19,8386,8046,340,4.1
6001,3/1/19,846106,819509,26597,3.1
6003,3/1/19,670,640,30,4.5
6005,3/1/19,14742,14062,680,4.6
6007,3/1/19,100421,94271,6150,6.1
6009,3/1/19,21090,20120,970,4.6
6011,3/1/19,11009,8801,2208,20.1
6013,3/1/19,563308,544394,18914,3.4
6015,3/1/19,9655,9056,599,6.2
6017,3/1/19,92355,88572,3783,4.1
6019,3/1/19,450465,410151,40314,8.9
6021,3/1/19,13048,12052,996,7.6
6023,3/1/19,62962,60380,2582,4.1
6025,3/1/19,71080,59311,11769,16.6
6027,3/1/19,8697,8310,387,4.4
6029,3/1/19,383237,346556,36681,9.6
6031,3/1/19,58193,52463,5730,9.8
6033,3/1/19,29240,27506,1734,5.9
6035,3/1/19,9831,9231,600,6.1
6037,3/1/19,5116385,4886823,229562,4.5
6039,3/1/19,61899,56640,5259,8.5
6041,3/1/19,139556,136046,3510,2.5
6043,3/1/19,7395,6925,470,6.4
6045,3/1/19,39148,37212,1936,4.9
6047,3/1/19,117654,105568,12086,10.3
6049,3/1/19,3073,2754,319,10.4
6051,3/1/19,8927,8586,341,3.8
6053,3/1/19,215483,194300,21183,9.8
6055,3/1/19,73303,70888,2415,3.3
6057,3/1/19,49116,47226,1890,3.8
6059,3/1/19,1625454,1576388,49066,3
6061,3/1/19,188249,181655,6594,3.5
6063,3/1/19,7538,6617,921,12.2
6065,3/1/19,1105024,1056716,48308,4.4
6067,3/1/19,713215,684390,28825,4
6069,3/1/19,31632,29592,2040,6.4
6071,3/1/19,968591,929215,39376,4.1
6073,3/1/19,1590122,1535235,54887,3.5
6075,3/1/19,580288,566190,14098,2.4
6077,3/1/19,327051,304728,22323,6.8
6079,3/1/19,141534,137104,4430,3.1
6081,3/1/19,457709,447409,10300,2.3
6083,3/1/19,216468,206375,10093,4.7
6085,3/1/19,1053571,1025058,28513,2.7
6087,3/1/19,141236,131932,9304,6.6
6089,3/1/19,74448,70175,4273,5.7
6091,3/1/19,1285,1186,99,7.7
6093,3/1/19,16927,15359,1568,9.3
6095,3/1/19,209461,200540,8921,4.3
6097,3/1/19,258219,250315,7904,3.1
6099,3/1/19,243865,226717,17148,7
6101,3/1/19,45311,40793,4518,10
6103,3/1/19,25458,23735,1723,6.8
6105,3/1/19,4541,4186,355,7.8
6107,3/1/19,202617,178824,23793,11.7
6109,3/1/19,21308,20119,1189,5.6
6111,3/1/19,425351,409123,16228,3.8
6113,3/1/19,108859,103405,5454,5
6115,3/1/19,29767,27571,2196,7.4
8001,3/1/19,271709,262346,9363,3.4
8003,3/1/19,8521,8150,371,4.4
8005,3/1/19,363763,353022,10741,3
8007,3/1/19,6686,6420,266,4
8009,3/1/19,1991,1951,40,2
8011,3/1/19,1748,1686,62,3.5
8013,3/1/19,196468,191347,5121,2.6
8014,3/1/19,39933,38857,1076,2.7
8015,3/1/19,9610,9346,264,2.7
8017,3/1/19,1036,1018,18,1.7
8019,3/1/19,6024,5863,161,2.7
8021,3/1/19,3983,3790,193,4.8
8023,3/1/19,1803,1712,91,5
8025,3/1/19,1491,1420,71,4.8
8027,3/1/19,1994,1927,67,3.4
8029,3/1/19,13889,13265,624,4.5
8031,3/1/19,416191,403527,12664,3
8033,3/1/19,1078,1031,47,4.4
8035,3/1/19,193570,188471,5099,2.6
8037,3/1/19,38788,37927,861,2.2
8039,3/1/19,14887,14521,366,2.5
8041,3/1/19,339580,326972,12608,3.7
8043,3/1/19,15068,14266,802,5.3
8045,3/1/19,33872,32771,1101,3.3
8047,3/1/19,3777,3676,101,2.7
8049,3/1/19,10436,10202,234,2.2
8051,3/1/19,11770,11493,277,2.4
8053,3/1/19,388,375,13,3.4
8055,3/1/19,2477,2287,190,7.7
8057,3/1/19,880,855,25,2.8
8059,3/1/19,334542,324972,9570,2.9
8061,3/1/19,850,835,15,1.8
8063,3/1/19,3968,3892,76,1.9
8065,3/1/19,5247,5124,123,2.3
8067,3/1/19,31851,30834,1017,3.2
8069,3/1/19,202331,196844,5487,2.7
8071,3/1/19,6580,6283,297,4.5
8073,3/1/19,2341,2274,67,2.9
8075,3/1/19,10970,10679,291,2.7
8077,3/1/19,76563,73578,2985,3.9
8079,3/1/19,579,566,13,2.2
8081,3/1/19,7551,7205,346,4.6
8083,3/1/19,12683,11930,753,5.9
8085,3/1/19,21400,20516,884,4.1
8087,3/1/19,15959,15465,494,3.1
8089,3/1/19,8209,7811,398,4.8
8091,3/1/19,2278,2201,77,3.4
8093,3/1/19,11161,10833,328,2.9
8095,3/1/19,2305,2265,40,1.7
8097,3/1/19,11629,11368,261,2.2
8099,3/1/19,6043,5867,176,2.9
8101,3/1/19,75855,72366,3489,4.6
8103,3/1/19,2941,2810,131,4.5
8105,3/1/19,5064,4809,255,5
8107,3/1/19,17084,16699,385,2.3
8109,3/1/19,3296,3148,148,4.5
8111,3/1/19,501,479,22,4.4
8113,3/1/19,6314,6193,121,1.9
8115,3/1/19,1123,1099,24,2.1
8117,3/1/19,25707,25302,405,1.6
8119,3/1/19,12769,12322,447,3.5
8121,3/1/19,2817,2758,59,2.1
8123,3/1/19,166439,161629,4810,2.9
8125,3/1/19,5748,5645,103,1.8
9001,3/1/19,475119,456625,18494,3.9
9003,3/1/19,480963,461381,19582,4.1
9005,3/1/19,103785,99493,4292,4.1
9007,3/1/19,92970,89714,3256,3.5
9009,3/1/19,457133,438065,19068,4.2
9011,3/1/19,135577,130288,5289,3.9
9013,3/1/19,86782,83633,3149,3.6
9015,3/1/19,63797,60941,2856,4.5
10001,3/1/19,79490,76375,3115,3.9
10003,3/1/19,302554,292146,10408,3.4
10005,3/1/19,104065,99719,4346,4.2
11001,3/1/19,409447,386482,22965,5.6
12001,3/1/19,139002,134849,4153,3
12003,3/1/19,11656,11280,376,3.2
12005,3/1/19,83984,80236,3748,4.5
12007,3/1/19,10894,10540,354,3.2
12009,3/1/19,279950,270699,9251,3.3
12011,3/1/19,1031298,999320,31978,3.1
12013,3/1/19,4809,4600,209,4.3
12015,3/1/19,72270,69570,2700,3.7
12017,3/1/19,47766,45427,2339,4.9
12019,3/1/19,105873,102574,3299,3.1
12021,3/1/19,184789,179381,5408,2.9
12023,3/1/19,29367,28397,970,3.3
12027,3/1/19,14381,13874,507,3.5
12029,3/1/19,5864,5647,217,3.7
12031,3/1/19,483521,467421,16100,3.3
12033,3/1/19,144715,139985,4730,3.3
12035,3/1/19,46930,45107,1823,3.9
12037,3/1/19,4641,4452,189,4.1
12039,3/1/19,18736,17956,780,4.2
12041,3/1/19,7137,6884,253,3.5
12043,3/1/19,5622,5418,204,3.6
12045,3/1/19,5762,5446,316,5.5
12047,3/1/19,4343,4156,187,4.3
12049,3/1/19,8726,8307,419,4.8
12051,3/1/19,16031,15292,739,4.6
12053,3/1/19,71158,68080,3078,4.3
12055,3/1/19,36197,34552,1645,4.5
12057,3/1/19,743822,720322,23500,3.2
12059,3/1/19,6915,6667,248,3.6
12061,3/1/19,65690,63196,2494,3.8
12063,3/1/19,17175,16523,652,3.8
12065,3/1/19,5620,5427,193,3.4
12067,3/1/19,2921,2832,89,3
12069,3/1/19,157396,152187,5209,3.3
12071,3/1/19,350207,339088,11119,3.2
12073,3/1/19,155324,150575,4749,3.1
12075,3/1/19,16849,16190,659,3.9
12077,3/1/19,2639,2539,100,3.8
12079,3/1/19,7351,7067,284,3.9
12081,3/1/19,180677,175055,5622,3.1
12083,3/1/19,136656,131246,5410,4
12085,3/1/19,73957,71578,2379,3.2
12086,3/1/19,1366682,1327849,38833,2.8
12087,3/1/19,47416,46401,1015,2.1
12089,3/1/19,40545,39315,1230,3
12091,3/1/19,95726,93032,2694,2.8
12093,3/1/19,17918,17291,627,3.5
12095,3/1/19,754795,732490,22305,3
12097,3/1/19,182357,176344,6013,3.3
12099,3/1/19,733448,709534,23914,3.3
12101,3/1/19,235415,226923,8492,3.6
12103,3/1/19,489001,473774,15227,3.1
12105,3/1/19,303081,291801,11280,3.7
12107,3/1/19,26827,25639,1188,4.4
12109,3/1/19,130410,126816,3594,2.8
12111,3/1/19,144600,138925,5675,3.9
12113,3/1/19,82084,79580,2504,3.1
12115,3/1/19,190046,183983,6063,3.2
12117,3/1/19,253126,245510,7616,3
12119,3/1/19,32592,31003,1589,4.9
12121,3/1/19,17888,17261,627,3.5
12123,3/1/19,8163,7871,292,3.6
12125,3/1/19,4627,4490,137,3
12127,3/1/19,253645,244732,8913,3.5
12129,3/1/19,14910,14469,441,3
12131,3/1/19,31226,30289,937,3
12133,3/1/19,9682,9337,345,3.6
13001,3/1/19,9144,8807,337,3.7
13003,3/1/19,4771,4622,149,3.1
13005,3/1/19,5019,4849,170,3.4
13007,3/1/19,1178,1127,51,4.3
13009,3/1/19,17407,16629,778,4.5
13011,3/1/19,9655,9372,283,2.9
13013,3/1/19,40248,39008,1240,3.1
13015,3/1/19,50315,48602,1713,3.4
13017,3/1/19,5383,5090,293,5.4
13019,3/1/19,7542,7263,279,3.7
13021,3/1/19,68337,65568,2769,4.1
13023,3/1/19,4661,4423,238,5.1
13025,3/1/19,7200,6900,300,4.2
13027,3/1/19,6970,6726,244,3.5
13029,3/1/19,18407,17827,580,3.2
13031,3/1/19,36949,35532,1417,3.8
13033,3/1/19,9170,8727,443,4.8
13035,3/1/19,10701,10319,382,3.6
13037,3/1/19,2234,2146,88,3.9
13039,3/1/19,20943,20130,813,3.9
13043,3/1/19,5525,5358,167,3
13045,3/1/19,54983,52991,1992,3.6
13047,3/1/19,33437,32389,1048,3.1
13049,3/1/19,4774,4587,187,3.9
13051,3/1/19,140564,135726,4838,3.4
13053,3/1/19,2033,1926,107,5.3
13055,3/1/19,10268,9877,391,3.8
13057,3/1/19,135157,131198,3959,2.9
13059,3/1/19,59254,56997,2257,3.8
13061,3/1/19,872,817,55,6.3
13063,3/1/19,137181,131171,6010,4.4
13065,3/1/19,2750,2649,101,3.7
13067,3/1/19,423129,409755,13374,3.2
13069,3/1/19,18949,18212,737,3.9
13071,3/1/19,21617,20917,700,3.2
13073,3/1/19,75295,72886,2409,3.2
13075,3/1/19,8010,7738,272,3.4
13077,3/1/19,74252,71959,2293,3.1
13079,3/1/19,5650,5442,208,3.7
13081,3/1/19,9405,9012,393,4.2
13083,3/1/19,8179,7890,289,3.5
13085,3/1/19,12277,11891,386,3.1
13087,3/1/19,11702,11263,439,3.8
13089,3/1/19,397574,383095,14479,3.6
13091,3/1/19,7049,6759,290,4.1
13093,3/1/19,5100,4908,192,3.8
13095,3/1/19,38330,36449,1881,4.9
13097,3/1/19,72889,70161,2728,3.7
13099,3/1/19,4317,4139,178,4.1
13101,3/1/19,1943,1887,56,2.9
13103,3/1/19,31118,30170,948,3
13105,3/1/19,7628,7323,305,4
13107,3/1/19,8268,7873,395,4.8
13109,3/1/19,4866,4698,168,3.5
13111,3/1/19,11520,11131,389,3.4
13113,3/1/19,57739,55895,1844,3.2
13115,3/1/19,44207,42528,1679,3.8
13117,3/1/19,121555,117972,3583,2.9
13119,3/1/19,10148,9779,369,3.6
13121,3/1/19,554496,534075,20421,3.7
13123,3/1/19,11877,11434,443,3.7
13125,3/1/19,1274,1225,49,3.8
13127,3/1/19,38958,37597,1361,3.5
13129,3/1/19,27615,26668,947,3.4
13131,3/1/19,10732,10367,365,3.4
13133,3/1/19,7068,6779,289,4.1
13135,3/1/19,487176,471549,15627,3.2
13137,3/1/19,19323,18595,728,3.8
13139,3/1/19,101899,98866,3033,3
13141,3/1/19,2461,2327,134,5.4
13143,3/1/19,12488,12056,432,3.5
13145,3/1/19,16799,16264,535,3.2
13147,3/1/19,11613,11220,393,3.4
13149,3/1/19,5228,5046,182,3.5
13151,3/1/19,115100,110751,4349,3.8
13153,3/1/19,70604,68144,2460,3.5
13155,3/1/19,3396,3232,164,4.8
13157,3/1/19,36245,35198,1047,2.9
13159,3/1/19,6922,6691,231,3.3
13161,3/1/19,6078,5817,261,4.3
13163,3/1/19,6575,6279,296,4.5
13165,3/1/19,3161,3008,153,4.8
13167,3/1/19,4115,3965,150,3.6
13169,3/1/19,13793,13337,456,3.3
13171,3/1/19,8187,7856,331,4
13173,3/1/19,3768,3609,159,4.2
13175,3/1/19,19419,18595,824,4.2
13177,3/1/19,14710,14246,464,3.2
13179,3/1/19,26182,25215,967,3.7
13181,3/1/19,3587,3435,152,4.2
13183,3/1/19,8190,7888,302,3.7
13185,3/1/19,51369,49482,1887,3.7
13187,3/1/19,16670,16123,547,3.3
13189,3/1/19,8837,8414,423,4.8
13191,3/1/19,6137,5911,226,3.7
13193,3/1/19,4706,4487,219,4.7
13195,3/1/19,13299,12868,431,3.2
13197,3/1/19,3335,3189,146,4.4
13199,3/1/19,8874,8465,409,4.6
13201,3/1/19,2779,2689,90,3.2
13205,3/1/19,8505,8118,387,4.6
13207,3/1/19,13092,12639,453,3.5
13209,3/1/19,3822,3629,193,5
13211,3/1/19,9219,8914,305,3.3
13213,3/1/19,15595,14821,774,5
13215,3/1/19,78077,74492,3585,4.6
13217,3/1/19,52000,49885,2115,4.1
13219,3/1/19,19543,19001,542,2.8
13221,3/1/19,6961,6726,235,3.4
13223,3/1/19,85544,82891,2653,3.1
13225,3/1/19,11882,11388,494,4.2
13227,3/1/19,15207,14720,487,3.2
13229,3/1/19,8718,8413,305,3.5
13231,3/1/19,8862,8577,285,3.2
13233,3/1/19,18354,17648,706,3.8
13235,3/1/19,4077,3913,164,4
13237,3/1/19,8148,7759,389,4.8
13239,3/1/19,809,765,44,5.4
13241,3/1/19,7007,6742,265,3.8
13243,3/1/19,2579,2456,123,4.8
13245,3/1/19,85258,81331,3927,4.6
13247,3/1/19,44550,42774,1776,4
13249,3/1/19,2164,2078,86,4
13251,3/1/19,5090,4846,244,4.8
13253,3/1/19,3074,2932,142,4.6
13255,3/1/19,28593,27360,1233,4.3
13257,3/1/19,10778,10346,432,4
13259,3/1/19,2371,2272,99,4.2
13261,3/1/19,12515,11884,631,5
13263,3/1/19,2838,2700,138,4.9
13265,3/1/19,567,542,25,4.4
13267,3/1/19,9667,9272,395,4.1
13269,3/1/19,2943,2818,125,4.2
13271,3/1/19,4167,3948,219,5.3
13273,3/1/19,3524,3332,192,5.4
13275,3/1/19,16905,16218,687,4.1
13277,3/1/19,19830,19123,707,3.6
13279,3/1/19,11687,11138,549,4.7
13281,3/1/19,3848,3650,198,5.1
13283,3/1/19,2721,2599,122,4.5
13285,3/1/19,37233,36029,1204,3.2
13287,3/1/19,3151,3028,123,3.9
13289,3/1/19,2913,2743,170,5.8
13291,3/1/19,10361,10009,352,3.4
13293,3/1/19,11314,10883,431,3.8
13295,3/1/19,31227,30143,1084,3.5
13297,3/1/19,45855,44330,1525,3.3
13299,3/1/19,15571,15000,571,3.7
13301,3/1/19,2772,2661,111,4
13303,3/1/19,7042,6725,317,4.5
13305,3/1/19,11594,11119,475,4.1
13307,3/1/19,1009,956,53,5.3
13309,3/1/19,1621,1531,90,5.6
13311,3/1/19,16120,15645,475,2.9
13313,3/1/19,43820,41874,1946,4.4
13315,3/1/19,2757,2643,114,4.1
13317,3/1/19,3852,3685,167,4.3
13319,3/1/19,3933,3791,142,3.6
13321,3/1/19,8905,8567,338,3.8
15001,3/1/19,90582,87511,3071,3.4
15003,3/1/19,452267,440671,11596,2.6
15007,3/1/19,36036,35040,996,2.8
15009,3/1/19,86596,84318,2278,2.6
16001,3/1/19,251861,244908,6953,2.8
16003,3/1/19,1716,1517,199,11.6
16005,3/1/19,42955,41642,1313,3.1
16007,3/1/19,2909,2807,102,3.5
16009,3/1/19,4146,3710,436,10.5
16011,3/1/19,23106,22386,720,3.1
16013,3/1/19,12312,11881,431,3.5
16015,3/1/19,3519,3329,190,5.4
16017,3/1/19,19878,18699,1179,5.9
16019,3/1/19,55931,54368,1563,2.8
16021,3/1/19,5244,4892,352,6.7
16023,3/1/19,1352,1306,46,3.4
16025,3/1/19,678,656,22,3.2
16027,3/1/19,103167,99515,3652,3.5
16029,3/1/19,4049,3924,125,3.1
16031,3/1/19,11737,11412,325,2.8
16033,3/1/19,352,337,15,4.3
16035,3/1/19,2971,2625,346,11.6
16037,3/1/19,2000,1873,127,6.4
16039,3/1/19,11278,10841,437,3.9
16041,3/1/19,7048,6866,182,2.6
16043,3/1/19,7720,7470,250,3.2
16045,3/1/19,8225,7900,325,4
16047,3/1/19,8111,7846,265,3.3
16049,3/1/19,6447,6035,412,6.4
16051,3/1/19,13636,13264,372,2.7
16053,3/1/19,12105,11728,377,3.1
16055,3/1/19,78371,74475,3896,5
16057,3/1/19,20913,20158,755,3.6
16059,3/1/19,3395,3158,237,7
16061,3/1/19,1599,1478,121,7.6
16063,3/1/19,2654,2519,135,5.1
16065,3/1/19,21680,21249,431,2
16067,3/1/19,11056,10735,321,2.9
16069,3/1/19,20939,20161,778,3.7
16071,3/1/19,2267,2207,60,2.6
16073,3/1/19,5374,5161,213,4
16075,3/1/19,11556,11095,461,4
16077,3/1/19,3874,3737,137,3.5
16079,3/1/19,5298,4886,412,7.8
16081,3/1/19,6083,5911,172,2.8
16083,3/1/19,40915,39597,1318,3.2
16085,3/1/19,5407,5104,303,5.6
16087,3/1/19,4529,4286,243,5.4
17001,3/1/19,32630,31354,1276,3.9
17003,3/1/19,2053,1922,131,6.4
17005,3/1/19,7759,7411,348,4.5
17007,3/1/19,26580,24840,1740,6.5
17009,3/1/19,2950,2869,81,2.7
17011,3/1/19,17300,16308,992,5.7
17013,3/1/19,2320,2196,124,5.3
17015,3/1/19,7076,6701,375,5.3
17017,3/1/19,6127,5807,320,5.2
17019,3/1/19,110426,105777,4649,4.2
17021,3/1/19,14758,13943,815,5.5
17023,3/1/19,7690,7262,428,5.6
17025,3/1/19,6413,6085,328,5.1
17027,3/1/19,20399,19651,748,3.7
17029,3/1/19,24477,23364,1113,4.5
17031,3/1/19,2602041,2498789,103252,4
17033,3/1/19,9004,8620,384,4.3
17035,3/1/19,6145,5885,260,4.2
17037,3/1/19,55133,52489,2644,4.8
17039,3/1/19,7517,7105,412,5.5
17041,3/1/19,10232,9824,408,4
17043,3/1/19,508860,493307,15553,3.1
17045,3/1/19,9066,8612,454,5
17047,3/1/19,2708,2574,134,4.9
17049,3/1/19,19408,18639,769,4
17051,3/1/19,9896,9370,526,5.3
17053,3/1/19,6520,6182,338,5.2
17055,3/1/19,16584,15554,1030,6.2
17057,3/1/19,15281,14275,1006,6.6
17059,3/1/19,2379,2250,129,5.4
17061,3/1/19,6000,5706,294,4.9
17063,3/1/19,25622,24279,1343,5.2
17065,3/1/19,4459,4241,218,4.9
17067,3/1/19,8367,7893,474,5.7
17069,3/1/19,1320,1221,99,7.5
17071,3/1/19,3584,3363,221,6.2
17073,3/1/19,25082,23648,1434,5.7
17075,3/1/19,14248,13528,720,5.1
17077,3/1/19,28498,27299,1199,4.2
17079,3/1/19,4572,4351,221,4.8
17081,3/1/19,17643,16754,889,5
17083,3/1/19,11014,10455,559,5.1
17085,3/1/19,10667,10067,600,5.6
17087,3/1/19,4268,3947,321,7.5
17089,3/1/19,274791,259257,15534,5.7
17091,3/1/19,55974,52629,3345,6
17093,3/1/19,68680,66223,2457,3.6
17095,3/1/19,21806,20508,1298,6
17097,3/1/19,378320,357988,20332,5.4
17099,3/1/19,55336,51597,3739,6.8
17101,3/1/19,5956,5615,341,5.7
17103,3/1/19,17522,16679,843,4.8
17105,3/1/19,16515,15693,822,5
17107,3/1/19,12852,12247,605,4.7
17109,3/1/19,13678,13013,665,4.9
17111,3/1/19,166384,160088,6296,3.8
17113,3/1/19,88619,84781,3838,4.3
17115,3/1/19,48648,45825,2823,5.8
17117,3/1/19,23024,21870,1154,5
17119,3/1/19,134444,128553,5891,4.4
17121,3/1/19,17754,16932,822,4.6
17123,3/1/19,5371,5048,323,6
17125,3/1/19,6246,5863,383,6.1
17127,3/1/19,5620,5278,342,6.1
17129,3/1/19,6568,6245,323,4.9
17131,3/1/19,8158,7625,533,6.5
17133,3/1/19,18785,18127,658,3.5
17135,3/1/19,11875,11124,751,6.3
17137,3/1/19,16517,15732,785,4.8
17139,3/1/19,7607,7332,275,3.6
17141,3/1/19,25242,23745,1497,5.9
17143,3/1/19,85573,80544,5029,5.9
17145,3/1/19,8450,7962,488,5.8
17147,3/1/19,8702,8329,373,4.3
17149,3/1/19,6992,6602,390,5.6
17151,3/1/19,1713,1607,106,6.2
17153,3/1/19,1968,1807,161,8.2
17155,3/1/19,3072,2864,208,6.8
17157,3/1/19,14315,13734,581,4.1
17159,3/1/19,7283,6924,359,4.9
17161,3/1/19,71766,67650,4116,5.7
17163,3/1/19,126998,120673,6325,5
17165,3/1/19,9773,9201,572,5.9
17167,3/1/19,101845,97066,4779,4.7
17169,3/1/19,3235,3071,164,5.1
17171,3/1/19,2511,2354,157,6.3
17173,3/1/19,10624,10136,488,4.6
17175,3/1/19,2551,2365,186,7.3
17177,3/1/19,21684,20577,1107,5.1
17179,3/1/19,64189,60842,3347,5.2
17181,3/1/19,7537,6996,541,7.2
17183,3/1/19,33329,31431,1898,5.7
17185,3/1/19,5825,5561,264,4.5
17187,3/1/19,8629,8228,401,4.6
17189,3/1/19,10128,9840,288,2.8
17191,3/1/19,6965,6575,390,5.6
17193,3/1/19,6692,6391,301,4.5
17195,3/1/19,28618,27264,1354,4.7
17197,3/1/19,358180,343139,15041,4.2
17199,3/1/19,32770,31122,1648,5
17201,3/1/19,140607,132267,8340,5.9
17203,3/1/19,18833,17996,837,4.4
18001,3/1/19,17348,16864,484,2.8
18003,3/1/19,185409,179296,6113,3.3
18005,3/1/19,44883,43615,1268,2.8
18007,3/1/19,4574,4410,164,3.6
18009,3/1/19,5111,4870,241,4.7
18011,3/1/19,36132,35179,953,2.6
18013,3/1/19,7684,7417,267,3.5
18015,3/1/19,10287,9915,372,3.6
18017,3/1/19,18058,17306,752,4.2
18019,3/1/19,61698,59479,2219,3.6
18021,3/1/19,12202,11709,493,4
18023,3/1/19,17255,16744,511,3
18025,3/1/19,4901,4660,241,4.9
18027,3/1/19,16722,16260,462,2.8
18029,3/1/19,25846,24814,1032,4
18031,3/1/19,15120,14594,526,3.5
18033,3/1/19,22685,22008,677,3
18035,3/1/19,54766,52472,2294,4.2
18037,3/1/19,23103,22492,611,2.6
18039,3/1/19,114568,111036,3532,3.1
18041,3/1/19,9035,8608,427,4.7
18043,3/1/19,41680,40236,1444,3.5
18045,3/1/19,8028,7706,322,4
18047,3/1/19,11402,10937,465,4.1
18049,3/1/19,9869,9492,377,3.8
18051,3/1/19,19557,19000,557,2.8
18053,3/1/19,32543,31242,1301,4
18055,3/1/19,13906,13214,692,5
18057,3/1/19,183429,178464,4965,2.7
18059,3/1/19,40239,38948,1291,3.2
18061,3/1/19,20348,19594,754,3.7
18063,3/1/19,89894,87265,2629,2.9
18065,3/1/19,22175,21334,841,3.8
18067,3/1/19,36850,35283,1567,4.3
18069,3/1/19,18369,17657,712,3.9
18071,3/1/19,22830,22177,653,2.9
18073,3/1/19,16544,15736,808,4.9
18075,3/1/19,9502,9180,322,3.4
18077,3/1/19,15225,14680,545,3.6
18079,3/1/19,13583,13015,568,4.2
18081,3/1/19,82895,80432,2463,3
18083,3/1/19,18727,18127,600,3.2
18085,3/1/19,42637,41423,1214,2.8
18087,3/1/19,20126,19535,591,2.9
18089,3/1/19,235736,220244,15492,6.6
18091,3/1/19,48258,45690,2568,5.3
18093,3/1/19,21520,20661,859,4
18095,3/1/19,59316,56742,2574,4.3
18097,3/1/19,490391,472838,17553,3.6
18099,3/1/19,23180,22380,800,3.5
18101,3/1/19,5328,5168,160,3
18103,3/1/19,15721,15083,638,4.1
18105,3/1/19,70896,68394,2502,3.5
18107,3/1/19,18866,18261,605,3.2
18109,3/1/19,36342,35043,1299,3.6
18111,3/1/19,7093,6686,407,5.7
18113,3/1/19,23756,22994,762,3.2
18115,3/1/19,3196,3065,131,4.1
18117,3/1/19,8754,8425,329,3.8
18119,3/1/19,9525,9063,462,4.9
18121,3/1/19,6999,6718,281,4
18123,3/1/19,9326,8993,333,3.6
18125,3/1/19,6132,5902,230,3.8
18127,3/1/19,88005,83948,4057,4.6
18129,3/1/19,13731,13324,407,3
18131,3/1/19,6633,6410,223,3.4
18133,3/1/19,16741,16121,620,3.7
18135,3/1/19,11537,11026,511,4.4
18137,3/1/19,14412,13871,541,3.8
18139,3/1/19,9011,8735,276,3.1
18141,3/1/19,137275,131990,5285,3.8
18143,3/1/19,10589,10162,427,4
18145,3/1/19,23124,22384,740,3.2
18147,3/1/19,10614,10233,381,3.6
18149,3/1/19,9975,9441,534,5.4
18151,3/1/19,20488,19908,580,2.8
18153,3/1/19,8507,8097,410,4.8
18155,3/1/19,5017,4835,182,3.6
18157,3/1/19,99395,96304,3091,3.1
18159,3/1/19,9378,9093,285,3
18161,3/1/19,3561,3427,134,3.8
18163,3/1/19,95573,92436,3137,3.3
18165,3/1/19,7132,6676,456,6.4
18167,3/1/19,48943,46540,2403,4.9
18169,3/1/19,15240,14705,535,3.5
18171,3/1/19,4204,4066,138,3.3
18173,3/1/19,33390,32332,1058,3.2
18175,3/1/19,13677,13178,499,3.6
18177,3/1/19,31200,29971,1229,3.9
18179,3/1/19,14403,13969,434,3
18181,3/1/19,13538,13111,427,3.2
18183,3/1/19,17786,17195,591,3.3
19001,3/1/19,4140,4006,134,3.2
19003,3/1/19,2148,2096,52,2.4
19005,3/1/19,7432,7025,407,5.5
19007,3/1/19,5966,5741,225,3.8
19009,3/1/19,3165,3061,104,3.3
19011,3/1/19,13680,13179,501,3.7
19013,3/1/19,70507,68180,2327,3.3
19015,3/1/19,15102,14678,424,2.8
19017,3/1/19,14100,13749,351,2.5
19019,3/1/19,11343,10939,404,3.6
19021,3/1/19,11875,11626,249,2.1
19023,3/1/19,7870,7534,336,4.3
19025,3/1/19,4230,4095,135,3.2
19027,3/1/19,10818,10581,237,2.2
19029,3/1/19,6977,6699,278,4
19031,3/1/19,10948,10608,340,3.1
19033,3/1/19,23548,22785,763,3.2
19035,3/1/19,6145,5967,178,2.9
19037,3/1/19,6507,6281,226,3.5
19039,3/1/19,4941,4732,209,4.2
19041,3/1/19,8539,8231,308,3.6
19043,3/1/19,10117,9520,597,5.9
19045,3/1/19,22843,21965,878,3.8
19047,3/1/19,8158,7756,402,4.9
19049,3/1/19,49529,48483,1046,2.1
19051,3/1/19,4193,4085,108,2.6
19053,3/1/19,4484,4366,118,2.6
19055,3/1/19,10500,10183,317,3
19057,3/1/19,19543,18733,810,4.1
19059,3/1/19,9323,8939,384,4.1
19061,3/1/19,56576,54731,1845,3.3
19063,3/1/19,5235,5078,157,3
19065,3/1/19,10899,10382,517,4.7
19067,3/1/19,9002,8675,327,3.6
19069,3/1/19,5712,5528,184,3.2
19071,3/1/19,3688,3592,96,2.6
19073,3/1/19,5379,5241,138,2.6
19075,3/1/19,6609,6388,221,3.3
19077,3/1/19,5639,5389,250,4.4
19079,3/1/19,6949,6709,240,3.5
19081,3/1/19,5882,5724,158,2.7
19083,3/1/19,8223,7896,327,4
19085,3/1/19,7373,7136,237,3.2
19087,3/1/19,10075,9812,263,2.6
19089,3/1/19,5197,4976,221,4.3
19091,3/1/19,5122,4948,174,3.4
19093,3/1/19,4153,4038,115,2.8
19095,3/1/19,10567,10237,330,3.1
19097,3/1/19,11055,10597,458,4.1
19099,3/1/19,19683,18962,721,3.7
19101,3/1/19,10257,9996,261,2.5
19103,3/1/19,87527,85769,1758,2
19105,3/1/19,10877,10377,500,4.6
19107,3/1/19,5279,5063,216,4.1
19109,3/1/19,8461,8215,246,2.9
19111,3/1/19,16132,15452,680,4.2
19113,3/1/19,123633,119705,3928,3.2
19115,3/1/19,6019,5810,209,3.5
19117,3/1/19,4684,4572,112,2.4
19119,3/1/19,6989,6845,144,2.1
19121,3/1/19,8695,8233,462,5.3
19123,3/1/19,11895,11565,330,2.8
19125,3/1/19,18325,17854,471,2.6
19127,3/1/19,18417,17200,1217,6.6
19129,3/1/19,7379,7188,191,2.6
19131,3/1/19,6243,6106,137,2.2
19133,3/1/19,4482,4324,158,3.5
19135,3/1/19,4017,3873,144,3.6
19137,3/1/19,5013,4859,154,3.1
19139,3/1/19,21941,21187,754,3.4
19141,3/1/19,8230,8005,225,2.7
19143,3/1/19,3472,3394,78,2.2
19145,3/1/19,6457,6299,158,2.4
19147,3/1/19,4838,4714,124,2.6
19149,3/1/19,14813,14467,346,2.3
19151,3/1/19,4247,4150,97,2.3
19153,3/1/19,270446,261379,9067,3.4
19155,3/1/19,48683,47279,1404,2.9
19157,3/1/19,10613,10245,368,3.5
19159,3/1/19,2471,2380,91,3.7
19161,3/1/19,5323,5151,172,3.2
19163,3/1/19,89887,86639,3248,3.6
19165,3/1/19,6680,6506,174,2.6
19167,3/1/19,21209,20668,541,2.6
19169,3/1/19,59940,58900,1040,1.7
19171,3/1/19,9627,9192,435,4.5
19173,3/1/19,3200,3137,63,2
19175,3/1/19,6286,6020,266,4.2
19177,3/1/19,3659,3547,112,3.1
19179,3/1/19,18145,17502,643,3.5
19181,3/1/19,28473,27555,918,3.2
19183,3/1/19,12200,11799,401,3.3
19185,3/1/19,2822,2737,85,3
19187,3/1/19,19457,18764,693,3.6
19189,3/1/19,5100,4946,154,3
19191,3/1/19,12201,11702,499,4.1
19193,3/1/19,56260,54477,1783,3.2
19195,3/1/19,4152,4004,148,3.6
19197,3/1/19,6790,6585,205,3
20001,3/1/19,6506,6278,228,3.5
20003,3/1/19,4087,3930,157,3.8
20005,3/1/19,6954,6626,328,4.7
20007,3/1/19,2256,2202,54,2.4
20009,3/1/19,13674,13198,476,3.5
20011,3/1/19,6795,6475,320,4.7
20013,3/1/19,5260,5077,183,3.5
20015,3/1/19,32243,31173,1070,3.3
20017,3/1/19,1461,1401,60,4.1
20019,3/1/19,1413,1354,59,4.2
20021,3/1/19,10063,9708,355,3.5
20023,3/1/19,1249,1216,33,2.6
20025,3/1/19,1029,1005,24,2.3
20027,3/1/19,3709,3572,137,3.7
20029,3/1/19,3717,3591,126,3.4
20031,3/1/19,3923,3734,189,4.8
20033,3/1/19,851,830,21,2.5
20035,3/1/19,16390,15839,551,3.4
20037,3/1/19,18696,17980,716,3.8
20039,3/1/19,1196,1158,38,3.2
20041,3/1/19,8690,8318,372,4.3
20043,3/1/19,4092,3939,153,3.7
20045,3/1/19,66081,64074,2007,3
20047,3/1/19,1435,1391,44,3.1
20049,3/1/19,1138,1092,46,4
20051,3/1/19,16943,16527,416,2.5
20053,3/1/19,2659,2584,75,2.8
20055,3/1/19,20522,20039,483,2.4
20057,3/1/19,16947,16494,453,2.7
20059,3/1/19,13979,13452,527,3.8
20061,3/1/19,11383,10848,535,4.7
20063,3/1/19,1413,1380,33,2.3
20065,3/1/19,1083,1047,36,3.3
20067,3/1/19,3131,3027,104,3.3
20069,3/1/19,3135,3071,64,2
20071,3/1/19,772,754,18,2.3
20073,3/1/19,3146,3045,101,3.2
20075,3/1/19,1507,1476,31,2.1
20077,3/1/19,2980,2912,68,2.3
20079,3/1/19,16845,16340,505,3
20081,3/1/19,2136,2081,55,2.6
20083,3/1/19,917,893,24,2.6
20085,3/1/19,7135,6892,243,3.4
20087,3/1/19,10064,9692,372,3.7
20089,3/1/19,1261,1220,41,3.3
20091,3/1/19,334295,324560,9735,2.9
20093,3/1/19,1996,1947,49,2.5
20095,3/1/19,3372,3248,124,3.7
20097,3/1/19,1275,1244,31,2.4
20099,3/1/19,10146,9712,434,4.3
20101,3/1/19,717,696,21,2.9
20103,3/1/19,36009,34644,1365,3.8
20105,3/1/19,1598,1554,44,2.8
20107,3/1/19,4436,4095,341,7.7
20109,3/1/19,1654,1616,38,2.3
20111,3/1/19,16767,16128,639,3.8
20113,3/1/19,16987,16597,390,2.3
20115,3/1/19,5939,5748,191,3.2
20117,3/1/19,5402,5213,189,3.5
20119,3/1/19,2130,2075,55,2.6
20121,3/1/19,17322,16627,695,4
20123,3/1/19,3366,3271,95,2.8
20125,3/1/19,14910,14310,600,4
20127,3/1/19,2947,2857,90,3.1
20129,3/1/19,1119,1085,34,3
20131,3/1/19,5263,5116,147,2.8
20133,3/1/19,6037,5773,264,4.4
20135,3/1/19,1282,1246,36,2.8
20137,3/1/19,2650,2586,64,2.4
20139,3/1/19,7960,7621,339,4.3
20141,3/1/19,2006,1959,47,2.3
20143,3/1/19,2957,2871,86,2.9
20145,3/1/19,2775,2689,86,3.1
20147,3/1/19,2606,2533,73,2.8
20149,3/1/19,12558,12175,383,3
20151,3/1/19,4855,4725,130,2.7
20153,3/1/19,1426,1392,34,2.4
20155,3/1/19,29506,28546,960,3.3
20157,3/1/19,2190,2130,60,2.7
20159,3/1/19,5105,4947,158,3.1
20161,3/1/19,35486,34477,1009,2.8
20163,3/1/19,2512,2416,96,3.8
20165,3/1/19,1610,1551,59,3.7
20167,3/1/19,3309,3210,99,3
20169,3/1/19,30169,29161,1008,3.3
20171,3/1/19,2686,2632,54,2
20173,3/1/19,249955,240911,9044,3.6
20175,3/1/19,9557,9265,292,3.1
20177,3/1/19,90196,86901,3295,3.7
20179,3/1/19,1348,1314,34,2.5
20181,3/1/19,2797,2724,73,2.6
20183,3/1/19,1950,1898,52,2.7
20185,3/1/19,1941,1889,52,2.7
20187,3/1/19,940,916,24,2.6
20189,3/1/19,2472,2402,70,2.8
20191,3/1/19,10774,10388,386,3.6
20193,3/1/19,4268,4169,99,2.3
20195,3/1/19,1391,1340,51,3.7
20197,3/1/19,3590,3453,137,3.8
20199,3/1/19,761,740,21,2.8
20201,3/1/19,2813,2710,103,3.7
20203,3/1/19,1360,1332,28,2.1
20205,3/1/19,3879,3732,147,3.8
20207,3/1/19,1592,1524,68,4.3
20209,3/1/19,76302,72712,3590,4.7
21001,3/1/19,7211,6771,440,6.1
21003,3/1/19,8940,8520,420,4.7
21005,3/1/19,11832,11360,472,4
21007,3/1/19,3521,3287,234,6.6
21009,3/1/19,19005,18042,963,5.1
21011,3/1/19,4583,4262,321,7
21013,3/1/19,8611,8078,533,6.2
21015,3/1/19,71366,68678,2688,3.8
21017,3/1/19,9310,8891,419,4.5
21019,3/1/19,18121,17000,1121,6.2
21021,3/1/19,12825,12197,628,4.9
21023,3/1/19,3853,3628,225,5.8
21025,3/1/19,3594,3315,279,7.8
21027,3/1/19,7901,7414,487,6.2
21029,3/1/19,43076,41181,1895,4.4
21031,3/1/19,5209,4940,269,5.2
21033,3/1/19,5443,5147,296,5.4
21035,3/1/19,19123,18265,858,4.5
21037,3/1/19,51185,49244,1941,3.8
21039,3/1/19,2180,2077,103,4.7
21041,3/1/19,5288,5052,236,4.5
21043,3/1/19,9828,8960,868,8.8
21045,3/1/19,6663,6350,313,4.7
21047,3/1/19,24824,23428,1396,5.6
21049,3/1/19,17148,16398,750,4.4
21051,3/1/19,5255,4875,380,7.2
21053,3/1/19,3950,3685,265,6.7
21055,3/1/19,3824,3592,232,6.1
21057,3/1/19,3116,2951,165,5.3
21059,3/1/19,47414,45387,2027,4.3
21061,3/1/19,4890,4607,283,5.8
21063,3/1/19,2010,1845,165,8.2
21065,3/1/19,5426,5127,299,5.5
21067,3/1/19,174435,167948,6487,3.7
21069,3/1/19,6195,5828,367,5.9
21071,3/1/19,11257,10501,756,6.7
21073,3/1/19,24883,23833,1050,4.2
21075,3/1/19,2014,1898,116,5.8
21077,3/1/19,4079,3888,191,4.7
21079,3/1/19,7748,7357,391,5
21081,3/1/19,11816,11245,571,4.8
21083,3/1/19,15696,14870,826,5.3
21085,3/1/19,11003,10408,595,5.4
21087,3/1/19,5099,4862,237,4.6
21089,3/1/19,13553,12608,945,7
21091,3/1/19,3975,3803,172,4.3
21093,3/1/19,49544,47309,2235,4.5
21095,3/1/19,6864,6350,514,7.5
21097,3/1/19,8710,8293,417,4.8
21099,3/1/19,8049,7671,378,4.7
21101,3/1/19,22268,21350,918,4.1
21103,3/1/19,8193,7845,348,4.2
21105,3/1/19,1705,1610,95,5.6
21107,3/1/19,18671,17693,978,5.2
21109,3/1/19,4154,3858,296,7.1
21111,3/1/19,403866,386372,17494,4.3
21113,3/1/19,26603,25516,1087,4.1
21115,3/1/19,6819,6325,494,7.2
21117,3/1/19,88337,84926,3411,3.9
21119,3/1/19,4531,4200,331,7.3
21121,3/1/19,10032,9394,638,6.4
21123,3/1/19,6058,5755,303,5
21125,3/1/19,24908,23611,1297,5.2
21127,3/1/19,5159,4772,387,7.5
21129,3/1/19,2098,1968,130,6.2
21131,3/1/19,2682,2496,186,6.9
21133,3/1/19,6297,5867,430,6.8
21135,3/1/19,4679,4224,455,9.7
21137,3/1/19,9543,8989,554,5.8
21139,3/1/19,3683,3425,258,7
21141,3/1/19,12572,12028,544,4.3
21143,3/1/19,3047,2882,165,5.4
21145,3/1/19,29388,27783,1605,5.5
21147,3/1/19,4701,4363,338,7.2
21149,3/1/19,4160,3946,214,5.1
21151,3/1/19,47659,45630,2029,4.3
21153,3/1/19,3106,2745,361,11.6
21155,3/1/19,9673,9261,412,4.3
21157,3/1/19,15056,14206,850,5.6
21159,3/1/19,2896,2691,205,7.1
21161,3/1/19,7200,6763,437,6.1
21163,3/1/19,12341,11721,620,5
21165,3/1/19,2343,2148,195,8.3
21167,3/1/19,10104,9607,497,4.9
21169,3/1/19,4055,3871,184,4.5
21171,3/1/19,4612,4394,218,4.7
21173,3/1/19,11731,11033,698,6
21175,3/1/19,4626,4337,289,6.2
21177,3/1/19,10941,10261,680,6.2
21179,3/1/19,23315,22119,1196,5.1
21181,3/1/19,3246,3090,156,4.8
21183,3/1/19,9804,9248,556,5.7
21185,3/1/19,33545,32306,1239,3.7
21187,3/1/19,5076,4800,276,5.4
21189,3/1/19,1129,1041,88,7.8
21191,3/1/19,7046,6739,307,4.4
21193,3/1/19,8382,7874,508,6.1
21195,3/1/19,20130,18923,1207,6
21197,3/1/19,5012,4702,310,6.2
21199,3/1/19,26755,25264,1491,5.6
21201,3/1/19,788,735,53,6.7
21203,3/1/19,6732,6375,357,5.3
21205,3/1/19,10568,9968,600,5.7
21207,3/1/19,6169,5743,426,6.9
21209,3/1/19,28962,27861,1101,3.8
21211,3/1/19,25453,24494,959,3.8
21213,3/1/19,8977,8539,438,4.9
21215,3/1/19,10297,9891,406,3.9
21217,3/1/19,12755,12193,562,4.4
21219,3/1/19,5329,5101,228,4.3
21221,3/1/19,5919,5592,327,5.5
21223,3/1/19,3875,3687,188,4.9
21225,3/1/19,6031,5716,315,5.2
21227,3/1/19,65790,63033,2757,4.2
21229,3/1/19,6179,5900,279,4.5
21231,3/1/19,7314,6810,504,6.9
21233,3/1/19,5708,5447,261,4.6
21235,3/1/19,13812,13058,754,5.5
21237,3/1/19,1981,1826,155,7.8
21239,3/1/19,14282,13788,494,3.5
22001,3/1/19,23643,22563,1080,4.6
22003,3/1/19,8665,8251,414,4.8
22005,3/1/19,64287,62061,2226,3.5
22007,3/1/19,8789,8297,492,5.6
22009,3/1/19,14989,14283,706,4.7
22011,3/1/19,14354,13702,652,4.5
22013,3/1/19,5474,5182,292,5.3
22015,3/1/19,57355,55274,2081,3.6
22017,3/1/19,102797,98099,4698,4.6
22019,3/1/19,107098,103483,3615,3.4
22021,3/1/19,3773,3573,200,5.3
22023,3/1/19,3981,3852,129,3.2
22025,3/1/19,3256,3074,182,5.6
22027,3/1/19,5797,5519,278,4.8
22029,3/1/19,6766,6374,392,5.8
22031,3/1/19,10789,10231,558,5.2
22033,3/1/19,231235,222994,8241,3.6
22035,3/1/19,1858,1677,181,9.7
22037,3/1/19,8002,7692,310,3.9
22039,3/1/19,11874,11278,596,5
22041,3/1/19,7230,6767,463,6.4
22043,3/1/19,8046,7670,376,4.7
22045,3/1/19,27816,26536,1280,4.6
22047,3/1/19,14095,13377,718,5.1
22049,3/1/19,6720,6437,283,4.2
22051,3/1/19,211400,203702,7698,3.6
22053,3/1/19,12978,12455,523,4
22055,3/1/19,112675,108523,4152,3.7
22057,3/1/19,41520,39904,1616,3.9
22059,3/1/19,6597,6360,237,3.6
22061,3/1/19,22073,21092,981,4.4
22063,3/1/19,69064,66683,2381,3.4
22065,3/1/19,3472,3226,246,7.1
22067,3/1/19,10023,9293,730,7.3
22069,3/1/19,16234,15435,799,4.9
22071,3/1/19,176441,169186,7255,4.1
22073,3/1/19,70085,66854,3231,4.6
22075,3/1/19,9950,9579,371,3.7
22077,3/1/19,9900,9445,455,4.6
22079,3/1/19,54513,52108,2405,4.4
22081,3/1/19,3730,3577,153,4.1
22083,3/1/19,8217,7747,470,5.7
22085,3/1/19,9042,8642,400,4.4
22087,3/1/19,19601,18780,821,4.2
22089,3/1/19,24826,23925,901,3.6
22091,3/1/19,4276,4060,216,5.1
22093,3/1/19,9097,8637,460,5.1
22095,3/1/19,19378,18454,924,4.8
22097,3/1/19,31521,29809,1712,5.4
22099,3/1/19,22029,21054,975,4.4
22101,3/1/19,19580,18516,1064,5.4
22103,3/1/19,117870,113689,4181,3.5
22105,3/1/19,53752,51246,2506,4.7
22107,3/1/19,1373,1287,86,6.3
22109,3/1/19,45767,43920,1847,4
22111,3/1/19,9124,8640,484,5.3
22113,3/1/19,23899,22823,1076,4.5
22115,3/1/19,15526,14701,825,5.3
22117,3/1/19,16588,15723,865,5.2
22119,3/1/19,14393,13647,746,5.2
22121,3/1/19,13710,13187,523,3.8
22123,3/1/19,3649,3227,422,11.6
22125,3/1/19,5407,5220,187,3.5
22127,3/1/19,4825,4565,260,5.4
23001,3/1/19,55279,53251,2028,3.7
23003,3/1/19,30397,28768,1629,5.4
23005,3/1/19,162236,157501,4735,2.9
23007,3/1/19,14715,14088,627,4.3
23009,3/1/19,27264,25754,1510,5.5
23011,3/1/19,61892,59617,2275,3.7
23013,3/1/19,19709,18882,827,4.2
23015,3/1/19,16030,15359,671,4.2
23017,3/1/19,26547,25352,1195,4.5
23019,3/1/19,76469,73374,3095,4
23021,3/1/19,7234,6882,352,4.9
23023,3/1/19,19357,18779,578,3
23025,3/1/19,22362,21136,1226,5.5
23027,3/1/19,20358,19505,853,4.2
23029,3/1/19,13513,12664,849,6.3
23031,3/1/19,111888,107853,4035,3.6
24001,3/1/19,32727,31006,1721,5.3
24003,3/1/19,315309,305268,10041,3.2
24005,3/1/19,454048,436439,17609,3.9
24009,3/1/19,50248,48604,1644,3.3
24011,3/1/19,18503,17767,736,4
24013,3/1/19,96454,93439,3015,3.1
24015,3/1/19,53746,51397,2349,4.4
24017,3/1/19,87524,84310,3214,3.7
24019,3/1/19,15663,14839,824,5.3
24021,3/1/19,135174,130672,4502,3.3
24023,3/1/19,15954,15152,802,5
24025,3/1/19,141096,136145,4951,3.5
24027,3/1/19,187539,182176,5363,2.9
24029,3/1/19,10565,10104,461,4.4
24031,3/1/19,561776,544507,17269,3.1
24033,3/1/19,510971,491563,19408,3.8
24035,3/1/19,28388,27436,952,3.4
24037,3/1/19,57357,55349,2008,3.5
24039,3/1/19,9210,8613,597,6.5
24041,3/1/19,19291,18514,777,4
24043,3/1/19,74792,71507,3285,4.4
24045,3/1/19,49983,47430,2553,5.1
24047,3/1/19,25555,23137,2418,9.5
24510,3/1/19,287840,272923,14917,5.2
25001,3/1/19,108374,102156,6218,5.7
25003,3/1/19,64618,61843,2775,4.3
25005,3/1/19,304292,290983,13309,4.4
25007,3/1/19,8155,7561,594,7.3
25009,3/1/19,429545,415295,14250,3.3
25011,3/1/19,41212,39895,1317,3.2
25013,3/1/19,231251,220902,10349,4.5
25015,3/1/19,91300,88515,2785,3.1
25017,3/1/19,926480,903064,23416,2.5
25019,3/1/19,6212,5644,568,9.1
25021,3/1/19,394153,383387,10766,2.7
25023,3/1/19,285313,275417,9896,3.5
25025,3/1/19,459164,446742,12422,2.7
25027,3/1/19,451158,435186,15972,3.5
26001,3/1/19,3780,3461,319,8.4
26003,3/1/19,3069,2765,304,9.9
26005,3/1/19,61911,59504,2407,3.9
26007,3/1/19,13284,12471,813,6.1
26009,3/1/19,9899,9194,705,7.1
26011,3/1/19,5953,5419,534,9
26013,3/1/19,3147,2895,252,8
26015,3/1/19,31883,30623,1260,4
26017,3/1/19,50299,47524,2775,5.5
26019,3/1/19,8635,8003,632,7.3
26021,3/1/19,73588,70161,3427,4.7
26023,3/1/19,19227,18414,813,4.2
26025,3/1/19,63089,60167,2922,4.6
26027,3/1/19,24770,23576,1194,4.8
26029,3/1/19,12555,11758,797,6.3
26031,3/1/19,10418,8624,1794,17.2
26033,3/1/19,16134,14790,1344,8.3
26035,3/1/19,11773,10853,920,7.8
26037,3/1/19,41543,40125,1418,3.4
26039,3/1/19,5469,5079,390,7.1
26041,3/1/19,17019,15942,1077,6.3
26043,3/1/19,12212,11636,576,4.7
26045,3/1/19,57859,55743,2116,3.7
26047,3/1/19,17006,15612,1394,8.2
26049,3/1/19,182521,172612,9909,5.4
26051,3/1/19,9895,9230,665,6.7
26053,3/1/19,6233,5863,370,5.9
26055,3/1/19,47919,45676,2243,4.7
26057,3/1/19,18001,17066,935,5.2
26059,3/1/19,20357,19397,960,4.7
26061,3/1/19,16708,15724,984,5.9
26063,3/1/19,15247,14351,896,5.9
26065,3/1/19,153000,147164,5836,3.8
26067,3/1/19,30150,28954,1196,4
26069,3/1/19,9899,9103,796,8
26071,3/1/19,5183,4817,366,7.1
26073,3/1/19,34714,33116,1598,4.6
26075,3/1/19,74845,71640,3205,4.3
26077,3/1/19,134833,129871,4962,3.7
26079,3/1/19,7710,7110,600,7.8
26081,3/1/19,361986,350291,11695,3.2
26083,3/1/19,909,837,72,7.9
26085,3/1/19,3613,3329,284,7.9
26087,3/1/19,41775,38956,2819,6.7
26089,3/1/19,10194,9609,585,5.7
26091,3/1/19,46609,44561,2048,4.4
26093,3/1/19,104109,100048,4061,3.9
26095,3/1/19,2309,2140,169,7.3
26097,3/1/19,4536,3601,935,20.6
26099,3/1/19,450368,429523,20845,4.6
26101,3/1/19,9982,9253,729,7.3
26103,3/1/19,32889,30952,1937,5.9
26105,3/1/19,13275,12446,829,6.2
26107,3/1/19,18495,17448,1047,5.7
26109,3/1/19,10950,10450,500,4.6
26111,3/1/19,40736,38921,1815,4.5
26113,3/1/19,6916,6481,435,6.3
26115,3/1/19,75770,72507,3263,4.3
26117,3/1/19,28606,27182,1424,5
26119,3/1/19,2947,2621,326,11.1
26121,3/1/19,76784,73077,3707,4.8
26123,3/1/19,23111,21912,1199,5.2
26125,3/1/19,678266,652839,25427,3.7
26127,3/1/19,11701,10705,996,8.5
26129,3/1/19,7825,7097,728,9.3
26131,3/1/19,2094,1912,182,8.7
26133,3/1/19,11098,10525,573,5.2
26135,3/1/19,2866,2631,235,8.2
26137,3/1/19,11447,10758,689,6
26139,3/1/19,161892,156789,5103,3.2
26141,3/1/19,4889,4352,537,11
26143,3/1/19,7462,6701,761,10.2
26145,3/1/19,87158,82420,4738,5.4
26147,3/1/19,76502,72022,4480,5.9
26149,3/1/19,27977,26774,1203,4.3
26151,3/1/19,19379,18232,1147,5.9
26153,3/1/19,3283,2976,307,9.4
26155,3/1/19,33725,32016,1709,5.1
26157,3/1/19,23910,22428,1482,6.2
26159,3/1/19,35468,33506,1962,5.5
26161,3/1/19,199992,193741,6251,3.1
26163,3/1/19,807165,763927,43238,5.4
26165,3/1/19,14770,13986,784,5.3
27001,3/1/19,7236,6609,627,8.7
27003,3/1/19,198820,191511,7309,3.7
27005,3/1/19,18505,17420,1085,5.9
27007,3/1/19,24443,23145,1298,5.3
27009,3/1/19,22256,21084,1172,5.3
27011,3/1/19,2417,2256,161,6.7
27013,3/1/19,40837,39494,1343,3.3
27015,3/1/19,14197,13478,719,5.1
27017,3/1/19,18090,17079,1011,5.6
27019,3/1/19,58602,56770,1832,3.1
27021,3/1/19,13789,12704,1085,7.9
27023,3/1/19,6949,6592,357,5.1
27025,3/1/19,30317,28739,1578,5.2
27027,3/1/19,36217,34767,1450,4
27029,3/1/19,4508,3976,532,11.8
27031,3/1/19,2891,2716,175,6.1
27033,3/1/19,5846,5595,251,4.3
27035,3/1/19,31653,29768,1885,6
27037,3/1/19,242654,234652,8002,3.3
27039,3/1/19,11925,11357,568,4.8
27041,3/1/19,20720,19847,873,4.2
27043,3/1/19,6855,6511,344,5
27045,3/1/19,11521,10957,564,4.9
27047,3/1/19,16031,15330,701,4.4
27049,3/1/19,26870,25828,1042,3.9
27051,3/1/19,3280,3082,198,6
27053,3/1/19,707163,686013,21150,3
27055,3/1/19,10478,10004,474,4.5
27057,3/1/19,9741,9009,732,7.5
27059,3/1/19,21597,20401,1196,5.5
27061,3/1/19,21852,20314,1538,7
27063,3/1/19,5628,5409,219,3.9
27065,3/1/19,9173,8347,826,9
27067,3/1/19,24243,23087,1156,4.8
27069,3/1/19,2295,2193,102,4.4
27071,3/1/19,5911,5554,357,6
27073,3/1/19,3523,3333,190,5.4
27075,3/1/19,5418,5167,251,4.6
27077,3/1/19,2459,2366,93,3.8
27079,3/1/19,16398,15305,1093,6.7
27081,3/1/19,3141,2974,167,5.3
27083,3/1/19,14582,13998,584,4
27085,3/1/19,19358,18423,935,4.8
27087,3/1/19,2322,2182,140,6
27089,3/1/19,5379,4894,485,9
27091,3/1/19,9897,9478,419,4.2
27093,3/1/19,13331,12595,736,5.5
27095,3/1/19,13237,12179,1058,8
27097,3/1/19,17655,16334,1321,7.5
27099,3/1/19,20374,19621,753,3.7
27101,3/1/19,4821,4502,319,6.6
27103,3/1/19,21000,20357,643,3.1
27105,3/1/19,10969,10573,396,3.6
27107,3/1/19,3253,3037,216,6.6
27109,3/1/19,88856,86132,2724,3.1
27111,3/1/19,30761,28998,1763,5.7
27113,3/1/19,8944,8343,601,6.7
27115,3/1/19,15109,13918,1191,7.9
27117,3/1/19,4777,4513,264,5.5
27119,3/1/19,16664,15842,822,4.9
27121,3/1/19,6407,6140,267,4.2
27123,3/1/19,290127,280672,9455,3.3
27125,3/1/19,2235,2060,175,7.8
27127,3/1/19,7555,7178,377,5
27129,3/1/19,8529,8005,524,6.1
27131,3/1/19,37134,35704,1430,3.9
27133,3/1/19,5596,5435,161,2.9
27135,3/1/19,7943,7554,389,4.9
27137,3/1/19,103027,98250,4777,4.6
27139,3/1/19,83885,81188,2697,3.2
27141,3/1/19,53018,50550,2468,4.7
27143,3/1/19,8505,8064,441,5.2
27145,3/1/19,91085,87375,3710,4.1
27147,3/1/19,20888,20081,807,3.9
27149,3/1/19,5358,5170,188,3.5
27151,3/1/19,4791,4547,244,5.1
27153,3/1/19,13553,12699,854,6.3
27155,3/1/19,1734,1643,91,5.2
27157,3/1/19,12198,11698,500,4.1
27159,3/1/19,6000,5480,520,8.7
27161,3/1/19,8833,8395,438,5
27163,3/1/19,143974,139245,4729,3.3
27165,3/1/19,6440,6094,346,5.4
27167,3/1/19,3437,3285,152,4.4
27169,3/1/19,28922,27966,956,3.3
27171,3/1/19,76239,72984,3255,4.3
27173,3/1/19,5293,5018,275,5.2
28001,3/1/19,11013,10236,777,7.1
28003,3/1/19,16210,15513,697,4.3
28005,3/1/19,4402,4129,273,6.2
28007,3/1/19,7004,6558,446,6.4
28009,3/1/19,3016,2849,167,5.5
28011,3/1/19,12371,11591,780,6.3
28013,3/1/19,5672,5378,294,5.2
28015,3/1/19,3450,3251,199,5.8
28017,3/1/19,6959,6610,349,5
28019,3/1/19,3804,3601,203,5.3
28021,3/1/19,2985,2730,255,8.5
28023,3/1/19,5996,5660,336,5.6
28025,3/1/19,7737,7198,539,7
28027,3/1/19,8385,7730,655,7.8
28029,3/1/19,11214,10485,729,6.5
28031,3/1/19,8057,7692,365,4.5
28033,3/1/19,90536,86775,3761,4.2
28035,3/1/19,33087,31488,1599,4.8
28037,3/1/19,2826,2657,169,6
28039,3/1/19,8757,8199,558,6.4
28041,3/1/19,4314,4022,292,6.8
28043,3/1/19,9626,9180,446,4.6
28045,3/1/19,18584,17573,1011,5.4
28047,3/1/19,85426,81263,4163,4.9
28049,3/1/19,106546,101210,5336,5
28051,3/1/19,5667,5116,551,9.7
28053,3/1/19,2260,2028,232,10.3
28055,3/1/19,378,330,48,12.7
28057,3/1/19,10428,9965,463,4.4
28059,3/1/19,57902,54530,3372,5.8
28061,3/1/19,6205,5807,398,6.4
28063,3/1/19,1992,1719,273,13.7
28065,3/1/19,4149,3887,262,6.3
28067,3/1/19,26307,24992,1315,5
28069,3/1/19,3585,3346,239,6.7
28071,3/1/19,28101,27006,1095,3.9
28073,3/1/19,30571,29338,1233,4
28075,3/1/19,30935,29377,1558,5
28077,3/1/19,4675,4388,287,6.1
28079,3/1/19,8027,7608,419,5.2
28081,3/1/19,40708,39058,1650,4.1
28083,3/1/19,9983,9240,743,7.4
28085,3/1/19,14455,13694,761,5.3
28087,3/1/19,25308,24035,1273,5
28089,3/1/19,53104,50852,2252,4.2
28091,3/1/19,9871,9352,519,5.3
28093,3/1/19,14327,13591,736,5.1
28095,3/1/19,15260,14485,775,5.1
28097,3/1/19,3979,3752,227,5.7
28099,3/1/19,10146,9605,541,5.3
28101,3/1/19,8778,8341,437,5
28103,3/1/19,3775,3520,255,6.8
28105,3/1/19,22427,21326,1101,4.9
28107,3/1/19,12543,11745,798,6.4
28109,3/1/19,23692,22533,1159,4.9
28111,3/1/19,4265,3999,266,6.2
28113,3/1/19,14453,13587,866,6
28115,3/1/19,14614,14028,586,4
28117,3/1/19,11349,10808,541,4.8
28119,3/1/19,2407,2220,187,7.8
28121,3/1/19,75799,73003,2796,3.7
28123,3/1/19,12616,12097,519,4.1
28125,3/1/19,1615,1471,144,8.9
28127,3/1/19,10724,10201,523,4.9
28129,3/1/19,6853,6513,340,5
28131,3/1/19,6877,6470,407,5.9
28133,3/1/19,7750,7105,645,8.3
28135,3/1/19,5396,5090,306,5.7
28137,3/1/19,12277,11645,632,5.1
28139,3/1/19,9423,8951,472,5
28141,3/1/19,8833,8444,389,4.4
28143,3/1/19,4453,4175,278,6.2
28145,3/1/19,13985,13432,553,4
28147,3/1/19,4949,4629,320,6.5
28149,3/1/19,20437,19261,1176,5.8
28151,3/1/19,16924,15656,1268,7.5
28153,3/1/19,7440,7030,410,5.5
28155,3/1/19,4001,3800,201,5
28157,3/1/19,2770,2511,259,9.4
28159,3/1/19,7401,6954,447,6
28161,3/1/19,5042,4769,273,5.4
28163,3/1/19,9412,8848,564,6
29001,3/1/19,10437,9964,473,4.5
29003,3/1/19,9744,9413,331,3.4
29005,3/1/19,2764,2670,94,3.4
29007,3/1/19,10794,10389,405,3.8
29009,3/1/19,15828,15138,690,4.4
29011,3/1/19,5198,5001,197,3.8
29013,3/1/19,7907,7526,381,4.8
29015,3/1/19,7318,6898,420,5.7
29017,3/1/19,5497,5263,234,4.3
29019,3/1/19,99258,96638,2620,2.6
29021,3/1/19,44464,42881,1583,3.6
29023,3/1/19,17965,17076,889,4.9
29025,3/1/19,4367,4198,169,3.9
29027,3/1/19,21370,20676,694,3.2
29029,3/1/19,18073,17089,984,5.4
29031,3/1/19,40745,39485,1260,3.1
29033,3/1/19,5206,5026,180,3.5
29035,3/1/19,2526,2376,150,5.9
29037,3/1/19,54495,52542,1953,3.6
29039,3/1/19,5787,5540,247,4.3
29041,3/1/19,3799,3673,126,3.3
29043,3/1/19,44904,43471,1433,3.2
29045,3/1/19,3219,3084,135,4.2
29047,3/1/19,135123,130901,4222,3.1
29049,3/1/19,10695,10305,390,3.6
29051,3/1/19,38961,37840,1121,2.9
29053,3/1/19,7555,7127,428,5.7
29055,3/1/19,10909,10457,452,4.1
29057,3/1/19,3563,3439,124,3.5
29059,3/1/19,7036,6745,291,4.1
29061,3/1/19,4163,3970,193,4.6
29063,3/1/19,4865,4669,196,4
29065,3/1/19,6305,6074,231,3.7
29067,3/1/19,5074,4867,207,4.1
29069,3/1/19,11883,11138,745,6.3
29071,3/1/19,52738,50894,1844,3.5
29073,3/1/19,7685,7406,279,3.6
29075,3/1/19,3526,3435,91,2.6
29077,3/1/19,150958,146565,4393,2.9
29079,3/1/19,4459,4289,170,3.8
29081,3/1/19,3941,3780,161,4.1
29083,3/1/19,9803,9408,395,4
29085,3/1/19,3763,3588,175,4.7
29087,3/1/19,2615,2542,73,2.8
29089,3/1/19,5017,4832,185,3.7
29091,3/1/19,16530,15883,647,3.9
29093,3/1/19,3581,3396,185,5.2
29095,3/1/19,360065,345057,15008,4.2
29097,3/1/19,57249,55392,1857,3.2
29099,3/1/19,117317,112980,4337,3.7
29101,3/1/19,22996,22023,973,4.2
29103,3/1/19,1794,1735,59,3.3
29105,3/1/19,16986,16231,755,4.4
29107,3/1/19,16788,16170,618,3.7
29109,3/1/19,18207,17425,782,4.3
29111,3/1/19,5072,4875,197,3.9
29113,3/1/19,28334,27190,1144,4
29115,3/1/19,5147,4873,274,5.3
29117,3/1/19,7391,7158,233,3.2
29119,3/1/19,10617,10273,344,3.2
29121,3/1/19,7586,7255,331,4.4
29123,3/1/19,5515,5313,202,3.7
29125,3/1/19,3923,3772,151,3.8
29127,3/1/19,14538,14008,530,3.6
29129,3/1/19,1909,1820,89,4.7
29131,3/1/19,12176,11611,565,4.6
29133,3/1/19,5850,5597,253,4.3
29135,3/1/19,7363,7103,260,3.5
29137,3/1/19,3888,3697,191,4.9
29139,3/1/19,5707,5492,215,3.8
29141,3/1/19,8010,7575,435,5.4
29143,3/1/19,8349,7949,400,4.8
29145,3/1/19,27404,26442,962,3.5
29147,3/1/19,10795,10459,336,3.1
29149,3/1/19,4017,3861,156,3.9
29151,3/1/19,7101,6923,178,2.5
29153,3/1/19,3449,3250,199,5.8
29155,3/1/19,6407,6061,346,5.4
29157,3/1/19,10119,9816,303,3
29159,3/1/19,21001,20195,806,3.8
29161,3/1/19,19959,19249,710,3.6
29163,3/1/19,7611,7328,283,3.7
29165,3/1/19,58198,56476,1722,3
29167,3/1/19,14557,14008,549,3.8
29169,3/1/19,14694,14059,635,4.3
29171,3/1/19,2343,2249,94,4
29173,3/1/19,5693,5456,237,4.2
29175,3/1/19,10493,10055,438,4.2
29177,3/1/19,10936,10501,435,4
29179,3/1/19,3038,2907,131,4.3
29181,3/1/19,5074,4781,293,5.8
29183,3/1/19,225141,218649,6492,2.9
29185,3/1/19,3788,3610,178,4.7
29186,3/1/19,9221,8925,296,3.2
29187,3/1/19,26537,25465,1072,4
29189,3/1/19,528174,510087,18087,3.4
29195,3/1/19,10726,10339,387,3.6
29197,3/1/19,1982,1877,105,5.3
29199,3/1/19,2385,2291,94,3.9
29201,3/1/19,20114,19373,741,3.7
29203,3/1/19,3222,3002,220,6.8
29205,3/1/19,3103,2961,142,4.6
29207,3/1/19,13142,12444,698,5.3
29209,3/1/19,13440,12585,855,6.4
29211,3/1/19,2759,2632,127,4.6
29213,3/1/19,26270,24561,1709,6.5
29215,3/1/19,9082,8623,459,5.1
29217,3/1/19,9686,9286,400,4.1
29219,3/1/19,17881,17247,634,3.5
29221,3/1/19,10312,9747,565,5.5
29223,3/1/19,5391,5095,296,5.5
29225,3/1/19,17257,16629,628,3.6
29227,3/1/19,1176,1146,30,2.6
29229,3/1/19,7521,7175,346,4.6
29510,3/1/19,151722,145238,6484,4.3
30001,3/1/19,5011,4836,175,3.5
30003,3/1/19,4894,4474,420,8.6
30005,3/1/19,2479,2373,106,4.3
30007,3/1/19,2568,2453,115,4.5
30009,3/1/19,5483,5235,248,4.5
30011,3/1/19,621,598,23,3.7
30013,3/1/19,38029,36495,1534,4
30015,3/1/19,2372,2293,79,3.3
30017,3/1/19,5941,5724,217,3.7
30019,3/1/19,864,844,20,2.3
30021,3/1/19,4528,4411,117,2.6
30023,3/1/19,5008,4830,178,3.6
30025,3/1/19,1636,1600,36,2.2
30027,3/1/19,5757,5499,258,4.5
30029,3/1/19,46977,44140,2837,6
30031,3/1/19,67140,65450,1690,2.5
30033,3/1/19,720,698,22,3.1
30035,3/1/19,5494,5009,485,8.8
30037,3/1/19,365,346,19,5.2
30039,3/1/19,1738,1629,109,6.3
30041,3/1/19,7607,7313,294,3.9
30043,3/1/19,5667,5433,234,4.1
30045,3/1/19,900,864,36,4
30047,3/1/19,12955,12307,648,5
30049,3/1/19,35644,34375,1269,3.6
30051,3/1/19,930,903,27,2.9
30053,3/1/19,7922,7209,713,9
30055,3/1/19,913,894,19,2.1
30057,3/1/19,5277,5094,183,3.5
30059,3/1/19,969,928,41,4.2
30061,3/1/19,1689,1572,117,6.9
30063,3/1/19,63711,61236,2475,3.9
30065,3/1/19,2248,2143,105,4.7
30067,3/1/19,8526,8142,384,4.5
30069,3/1/19,271,259,12,4.4
30071,3/1/19,1847,1762,85,4.6
30073,3/1/19,2666,2536,130,4.9
30075,3/1/19,912,885,27,3
30077,3/1/19,2860,2725,135,4.7
30079,3/1/19,463,446,17,3.7
30081,3/1/19,19952,18904,1048,5.3
30083,3/1/19,5802,5623,179,3.1
30085,3/1/19,4472,4239,233,5.2
30087,3/1/19,3748,3531,217,5.8
30089,3/1/19,4717,4346,371,7.9
30091,3/1/19,1763,1714,49,2.8
30093,3/1/19,16957,16192,765,4.5
30095,3/1/19,5030,4821,209,4.2
30097,3/1/19,1727,1676,51,3
30099,3/1/19,2650,2543,107,4
30101,3/1/19,2073,2020,53,2.6
30103,3/1/19,333,318,15,4.5
30105,3/1/19,3966,3819,147,3.7
30107,3/1/19,759,727,32,4.2
30109,3/1/19,442,428,14,3.2
30111,3/1/19,81709,78674,3035,3.7
31001,3/1/19,16574,15997,577,3.5
31003,3/1/19,3498,3388,110,3.1
31005,3/1/19,227,214,13,5.7
31007,3/1/19,366,352,14,3.8
31009,3/1/19,259,245,14,5.4
31011,3/1/19,2982,2874,108,3.6
31013,3/1/19,5366,5207,159,3
31015,3/1/19,1090,1045,45,4.1
31017,3/1/19,1377,1323,54,3.9
31019,3/1/19,27838,27079,759,2.7
31021,3/1/19,3454,3317,137,4
31023,3/1/19,4581,4458,123,2.7
31025,3/1/19,13496,12957,539,4
31027,3/1/19,4495,4376,119,2.6
31029,3/1/19,2292,2231,61,2.7
31031,3/1/19,3314,3229,85,2.6
31033,3/1/19,4416,4254,162,3.7
31035,3/1/19,3287,3157,130,4
31037,3/1/19,5600,5443,157,2.8
31039,3/1/19,4711,4574,137,2.9
31041,3/1/19,6413,6244,169,2.6
31043,3/1/19,10821,10316,505,4.7
31045,3/1/19,4971,4834,137,2.8
31047,3/1/19,13058,12597,461,3.5
31049,3/1/19,931,906,25,2.7
31051,3/1/19,3038,2932,106,3.5
31053,3/1/19,19433,18809,624,3.2
31055,3/1/19,296971,285928,11043,3.7
31057,3/1/19,1166,1137,29,2.5
31059,3/1/19,3127,3037,90,2.9
31061,3/1/19,1480,1430,50,3.4
31063,3/1/19,1631,1570,61,3.7
31065,3/1/19,2564,2492,72,2.8
31067,3/1/19,10958,10527,431,3.9
31069,3/1/19,1109,1073,36,3.2
31071,3/1/19,1123,1092,31,2.8
31073,3/1/19,1083,1052,31,2.9
31075,3/1/19,425,414,11,2.6
31077,3/1/19,1222,1184,38,3.1
31079,3/1/19,31914,30742,1172,3.7
31081,3/1/19,4762,4620,142,3
31083,3/1/19,1768,1716,52,2.9
31085,3/1/19,586,568,18,3.1
31087,3/1/19,1271,1217,54,4.2
31089,3/1/19,5751,5587,164,2.9
31091,3/1/19,401,387,14,3.5
31093,3/1/19,3351,3241,110,3.3
31095,3/1/19,4125,4002,123,3
31097,3/1/19,2101,2013,88,4.2
31099,3/1/19,3760,3679,81,2.2
31101,3/1/19,4473,4334,139,3.1
31103,3/1/19,596,582,14,2.3
31105,3/1/19,2038,1975,63,3.1
31107,3/1/19,4619,4437,182,3.9
31109,3/1/19,176445,171107,5338,3
31111,3/1/19,18134,17481,653,3.6
31113,3/1/19,470,459,11,2.3
31115,3/1/19,391,377,14,3.6
31117,3/1/19,448,437,11,2.5
31119,3/1/19,19852,19208,644,3.2
31121,3/1/19,4012,3880,132,3.3
31123,3/1/19,2592,2509,83,3.2
31125,3/1/19,1989,1924,65,3.3
31127,3/1/19,3663,3539,124,3.4
31129,3/1/19,2419,2349,70,2.9
31131,3/1/19,8352,8069,283,3.4
31133,3/1/19,1484,1439,45,3
31135,3/1/19,1814,1769,45,2.5
31137,3/1/19,4981,4851,130,2.6
31139,3/1/19,4052,3926,126,3.1
31141,3/1/19,17458,16885,573,3.3
31143,3/1/19,2885,2806,79,2.7
31145,3/1/19,5848,5686,162,2.8
31147,3/1/19,4264,4116,148,3.5
31149,3/1/19,848,817,31,3.7
31151,3/1/19,7464,7167,297,4
31153,3/1/19,95534,92507,3027,3.2
31155,3/1/19,11095,10751,344,3.1
31157,3/1/19,18098,17323,775,4.3
31159,3/1/19,8890,8634,256,2.9
31161,3/1/19,2665,2589,76,2.9
31163,3/1/19,1686,1630,56,3.3
31165,3/1/19,734,712,22,3
31167,3/1/19,3519,3414,105,3
31169,3/1/19,2831,2744,87,3.1
31171,3/1/19,420,406,14,3.3
31173,3/1/19,3059,2893,166,5.4
31175,3/1/19,2114,2033,81,3.8
31177,3/1/19,11201,10810,391,3.5
31179,3/1/19,5827,5674,153,2.6
31181,3/1/19,1665,1611,54,3.2
31183,3/1/19,584,568,16,2.7
31185,3/1/19,7186,6966,220,3.1
32001,3/1/19,11088,10653,435,3.9
32003,3/1/19,1122507,1075988,46519,4.1
32005,3/1/19,22917,21895,1022,4.5
32007,3/1/19,27923,27022,901,3.2
32009,3/1/19,417,403,14,3.4
32011,3/1/19,1188,1162,26,2.2
32013,3/1/19,8433,8196,237,2.8
32015,3/1/19,3294,3176,118,3.6
32017,3/1/19,2143,2048,95,4.4
32019,3/1/19,23536,22290,1246,5.3
32021,3/1/19,2044,1950,94,4.6
32023,3/1/19,17200,16287,913,5.3
32027,3/1/19,2661,2540,121,4.5
32029,3/1/19,2010,1923,87,4.3
32031,3/1/19,252710,243658,9052,3.6
32033,3/1/19,4571,4424,147,3.2
32510,3/1/19,26020,24842,1178,4.5
33001,3/1/19,30703,29760,943,3.1
33003,3/1/19,23143,22413,730,3.2
33005,3/1/19,41213,39932,1281,3.1
33007,3/1/19,14596,14010,586,4
33009,3/1/19,49994,48736,1258,2.5
33011,3/1/19,242976,235674,7302,3
33013,3/1/19,83999,81812,2187,2.6
33015,3/1/19,186241,180416,5825,3.1
33017,3/1/19,74449,72449,2000,2.7
33019,3/1/19,23177,22577,600,2.6
34001,3/1/19,119237,112706,6531,5.5
34003,3/1/19,479056,464873,14183,3
34005,3/1/19,229003,221358,7645,3.3
34007,3/1/19,251717,241420,10297,4.1
34009,3/1/19,39870,35530,4340,10.9
34011,3/1/19,64385,60528,3857,6
34013,3/1/19,366004,349705,16299,4.5
34015,3/1/19,148879,143339,5540,3.7
34017,3/1/19,359251,347451,11800,3.3
34019,3/1/19,63803,61902,1901,3
34021,3/1/19,200508,194172,6336,3.2
34023,3/1/19,433559,419951,13608,3.1
34025,3/1/19,324028,313189,10839,3.3
34027,3/1/19,255019,247461,7558,3
34029,3/1/19,271652,260828,10824,4
34031,3/1/19,241370,230402,10968,4.5
34033,3/1/19,28834,27388,1446,5
34035,3/1/19,170135,164931,5204,3.1
34037,3/1/19,73389,70612,2777,3.8
34039,3/1/19,275110,264399,10711,3.9
34041,3/1/19,55378,53366,2012,3.6
35001,3/1/19,330704,316589,14115,4.3
35003,3/1/19,1059,988,71,6.7
35005,3/1/19,27041,25828,1213,4.5
35006,3/1/19,8924,8385,539,6
35007,3/1/19,5259,5013,246,4.7
35009,3/1/19,21730,20889,841,3.9
35011,3/1/19,807,772,35,4.3
35013,3/1/19,97029,91206,5823,6
35015,3/1/19,33785,32849,936,2.8
35017,3/1/19,12215,11647,568,4.7
35019,3/1/19,1518,1434,84,5.5
35021,3/1/19,268,255,13,4.9
35023,3/1/19,2022,1939,83,4.1
35025,3/1/19,30548,29455,1093,3.6
35027,3/1/19,8640,8227,413,4.8
35028,3/1/19,9278,9001,277,3
35029,3/1/19,10172,8510,1662,16.3
35031,3/1/19,24069,22442,1627,6.8
35033,3/1/19,2184,2038,146,6.7
35035,3/1/19,24733,23568,1165,4.7
35037,3/1/19,3236,3061,175,5.4
35039,3/1/19,16549,15661,888,5.4
35041,3/1/19,7913,7585,328,4.1
35043,3/1/19,65767,62757,3010,4.6
35045,3/1/19,51684,48839,2845,5.5
35047,3/1/19,10931,10332,599,5.5
35049,3/1/19,73746,70914,2832,3.8
35051,3/1/19,3737,3428,309,8.3
35053,3/1/19,6457,6119,338,5.2
35055,3/1/19,15468,14552,916,5.9
35057,3/1/19,5540,5156,384,6.9
35059,3/1/19,1836,1775,61,3.3
35061,3/1/19,30316,28789,1527,5
36001,3/1/19,156674,150834,5840,3.7
36003,3/1/19,19490,18281,1209,6.2
36005,3/1/19,602784,568115,34669,5.8
36007,3/1/19,83874,79601,4273,5.1
36009,3/1/19,33853,31951,1902,5.6
36011,3/1/19,35433,33697,1736,4.9
36013,3/1/19,54120,51266,2854,5.3
36015,3/1/19,35147,33616,1531,4.4
36017,3/1/19,21774,20630,1144,5.3
36019,3/1/19,36108,34422,1686,4.7
36021,3/1/19,30557,29429,1128,3.7
36023,3/1/19,23248,21910,1338,5.8
36025,3/1/19,18782,17789,993,5.3
36027,3/1/19,143761,138538,5223,3.6
36029,3/1/19,440828,421448,19380,4.4
36031,3/1/19,17007,16022,985,5.8
36033,3/1/19,19544,18433,1111,5.7
36035,3/1/19,22587,21277,1310,5.8
36037,3/1/19,29117,27746,1371,4.7
36039,3/1/19,20255,19282,973,4.8
36041,3/1/19,2120,1956,164,7.7
36043,3/1/19,27912,26347,1565,5.6
36045,3/1/19,43497,40699,2798,6.4
36047,3/1/19,1209006,1156009,52997,4.4
36049,3/1/19,11448,10589,859,7.5
36051,3/1/19,30622,29113,1509,4.9
36053,3/1/19,32544,30810,1734,5.3
36055,3/1/19,361387,346222,15165,4.2
36057,3/1/19,22038,20757,1281,5.8
36059,3/1/19,704349,680551,23798,3.4
36061,3/1/19,919632,884928,34704,3.8
36063,3/1/19,98906,93466,5440,5.5
36065,3/1/19,101010,96372,4638,4.6
36067,3/1/19,219364,210343,9021,4.1
36069,3/1/19,55372,52978,2394,4.3
36071,3/1/19,183830,176836,6994,3.8
36073,3/1/19,17338,16451,887,5.1
36075,3/1/19,52754,49627,3127,5.9
36077,3/1/19,27796,26502,1294,4.7
36079,3/1/19,51229,49343,1886,3.7
36081,3/1/19,1148990,1105748,43242,3.8
36083,3/1/19,80818,77563,3255,4
36085,3/1/19,223943,214603,9340,4.2
36087,3/1/19,154980,149497,5483,3.5
36089,3/1/19,43256,40557,2699,6.2
36091,3/1/19,118588,114212,4376,3.7
36093,3/1/19,75768,72697,3071,4.1
36095,3/1/19,14534,13737,797,5.5
36097,3/1/19,7934,7462,472,5.9
36099,3/1/19,15767,15089,678,4.3
36101,3/1/19,42182,39953,2229,5.3
36103,3/1/19,774308,744797,29511,3.8
36105,3/1/19,35642,34077,1565,4.4
36107,3/1/19,22777,21700,1077,4.7
36109,3/1/19,50805,49015,1790,3.5
36111,3/1/19,87153,83724,3429,3.9
36113,3/1/19,30666,28947,1719,5.6
36115,3/1/19,26968,25616,1352,5
36117,3/1/19,43586,41578,2008,4.6
36119,3/1/19,484086,465993,18093,3.7
36121,3/1/19,17662,16684,978,5.5
36123,3/1/19,11607,11117,490,4.2
37001,3/1/19,82651,79408,3243,3.9
37003,3/1/19,18224,17591,633,3.5
37005,3/1/19,4304,4085,219,5.1
37007,3/1/19,10865,10415,450,4.1
37009,3/1/19,12693,12147,546,4.3
37011,3/1/19,7233,6919,314,4.3
37013,3/1/19,19706,18735,971,4.9
37015,3/1/19,7971,7591,380,4.8
37017,3/1/19,14684,13976,708,4.8
37019,3/1/19,53022,50211,2811,5.3
37021,3/1/19,141456,137010,4446,3.1
37023,3/1/19,41357,39768,1589,3.8
37025,3/1/19,109553,105505,4048,3.7
37027,3/1/19,36915,35345,1570,4.3
37029,3/1/19,4732,4536,196,4.1
37031,3/1/19,31524,30052,1472,4.7
37033,3/1/19,9975,9516,459,4.6
37035,3/1/19,79758,76789,2969,3.7
37037,3/1/19,35719,34446,1273,3.6
37039,3/1/19,11409,10878,531,4.7
37041,3/1/19,5539,5267,272,4.9
37043,3/1/19,4113,3922,191,4.6
37045,3/1/19,48692,46745,1947,4
37047,3/1/19,22672,21525,1147,5.1
37049,3/1/19,42118,40311,1807,4.3
37051,3/1/19,129623,122941,6682,5.2
37053,3/1/19,14078,13519,559,4
37055,3/1/19,18172,16966,1206,6.6
37057,3/1/19,81914,78844,3070,3.7
37059,3/1/19,20946,20208,738,3.5
37061,3/1/19,25402,24319,1083,4.3
37063,3/1/19,172441,166311,6130,3.6
37065,3/1/19,21660,20387,1273,5.9
37067,3/1/19,190382,183093,7289,3.8
37069,3/1/19,31488,30170,1318,4.2
37071,3/1/19,111526,107106,4420,4
37073,3/1/19,5357,5130,227,4.2
37075,3/1/19,3264,3074,190,5.8
37077,3/1/19,30594,29530,1064,3.5
37079,3/1/19,9677,9308,369,3.8
37081,3/1/19,266341,255226,11115,4.2
37083,3/1/19,20712,19556,1156,5.6
37085,3/1/19,53651,51074,2577,4.8
37087,3/1/19,30249,29138,1111,3.7
37089,3/1/19,55565,53634,1931,3.5
37091,3/1/19,9347,8855,492,5.3
37093,3/1/19,20402,19384,1018,5
37095,3/1/19,1810,1605,205,11.3
37097,3/1/19,89837,86510,3327,3.7
37099,3/1/19,19598,18686,912,4.7
37101,3/1/19,99661,95903,3758,3.8
37103,3/1/19,4452,4265,187,4.2
37105,3/1/19,26608,25372,1236,4.6
37107,3/1/19,28104,27010,1094,3.9
37109,3/1/19,43582,41978,1604,3.7
37111,3/1/19,21272,20466,806,3.8
37113,3/1/19,15179,14505,674,4.4
37115,3/1/19,10254,9870,384,3.7
37117,3/1/19,9218,8734,484,5.3
37119,3/1/19,623872,600494,23378,3.7
37121,3/1/19,6123,5821,302,4.9
37123,3/1/19,11623,11145,478,4.1
37125,3/1/19,42927,41231,1696,4
37127,3/1/19,43998,41882,2116,4.8
37129,3/1/19,123469,118741,4728,3.8
37131,3/1/19,7877,7469,408,5.2
37133,3/1/19,65764,62592,3172,4.8
37135,3/1/19,79226,76473,2753,3.5
37137,3/1/19,5397,5181,216,4
37139,3/1/19,16991,16197,794,4.7
37141,3/1/19,28785,27587,1198,4.2
37143,3/1/19,5033,4775,258,5.1
37145,3/1/19,18610,17791,819,4.4
37147,3/1/19,91455,87608,3847,4.2
37149,3/1/19,8981,8623,358,4
37151,3/1/19,67256,64646,2610,3.9
37153,3/1/19,16839,15949,890,5.3
37155,3/1/19,50702,47909,2793,5.5
37157,3/1/19,40697,38875,1822,4.5
37159,3/1/19,66398,63673,2725,4.1
37161,3/1/19,25456,24166,1290,5.1
37163,3/1/19,29758,28581,1177,4
37165,3/1/19,11674,10908,766,6.6
37167,3/1/19,30416,29272,1144,3.8
37169,3/1/19,21955,21135,820,3.7
37171,3/1/19,34317,33014,1303,3.8
37173,3/1/19,6903,6575,328,4.8
37175,3/1/19,14381,13794,587,4.1
37177,3/1/19,1372,1269,103,7.5
37179,3/1/19,124258,119736,4522,3.6
37181,3/1/19,17414,16406,1008,5.8
37183,3/1/19,598875,577878,20997,3.5
37185,3/1/19,6524,6151,373,5.7
37187,3/1/19,4459,4177,282,6.3
37189,3/1/19,29065,27924,1141,3.9
37191,3/1/19,53052,50783,2269,4.3
37193,3/1/19,29599,28352,1247,4.2
37195,3/1/19,35166,33199,1967,5.6
37197,3/1/19,17995,17360,635,3.5
37199,3/1/19,8399,8074,325,3.9
38001,3/1/19,1020,994,26,2.5
38003,3/1/19,5146,4982,164,3.2
38005,3/1/19,2310,2188,122,5.3
38007,3/1/19,359,344,15,4.2
38009,3/1/19,2912,2777,135,4.6
38011,3/1/19,1738,1707,31,1.8
38013,3/1/19,1079,1051,28,2.6
38015,3/1/19,48823,47230,1593,3.3
38017,3/1/19,101401,98714,2687,2.6
38019,3/1/19,1859,1791,68,3.7
38021,3/1/19,2268,2215,53,2.3
38023,3/1/19,1417,1398,19,1.3
38025,3/1/19,3102,3040,62,2
38027,3/1/19,1230,1156,74,6
38029,3/1/19,1427,1340,87,6.1
38031,3/1/19,1502,1448,54,3.6
38033,3/1/19,839,818,21,2.5
38035,3/1/19,37227,36300,927,2.5
38037,3/1/19,1174,1136,38,3.2
38039,3/1/19,1012,983,29,2.9
38041,3/1/19,1338,1314,24,1.8
38043,3/1/19,1256,1180,76,6.1
38045,3/1/19,2041,1988,53,2.6
38047,3/1/19,873,842,31,3.6
38049,3/1/19,3072,2908,164,5.3
38051,3/1/19,1098,1056,42,3.8
38053,3/1/19,9836,9667,169,1.7
38055,3/1/19,4545,4346,199,4.4
38057,3/1/19,3560,3373,187,5.3
38059,3/1/19,16131,15470,661,4.1
38061,3/1/19,7033,6919,114,1.6
38063,3/1/19,1359,1297,62,4.6
38065,3/1/19,854,816,38,4.4
38067,3/1/19,3275,3135,140,4.3
38069,3/1/19,1698,1622,76,4.5
38071,3/1/19,5521,5308,213,3.9
38073,3/1/19,2752,2692,60,2.2
38075,3/1/19,1193,1160,33,2.8
38077,3/1/19,8522,8259,263,3.1
38079,3/1/19,4558,4180,378,8.3
38081,3/1/19,2595,2535,60,2.3
38083,3/1/19,659,621,38,5.8
38085,3/1/19,1215,1164,51,4.2
38087,3/1/19,383,374,9,2.3
38089,3/1/19,18228,17785,443,2.4
38091,3/1/19,965,943,22,2.3
38093,3/1/19,10242,9955,287,2.8
38095,3/1/19,1132,1099,33,2.9
38097,3/1/19,4349,4216,133,3.1
38099,3/1/19,5092,4884,208,4.1
38101,3/1/19,31109,30063,1046,3.4
38103,3/1/19,1893,1810,83,4.4
38105,3/1/19,23702,23196,506,2.1
39001,3/1/19,10848,9998,850,7.8
39003,3/1/19,47731,45819,1912,4
39005,3/1/19,27095,25882,1213,4.5
39007,3/1/19,44272,41952,2320,5.2
39009,3/1/19,29086,27617,1469,5.1
39011,3/1/19,25045,24319,726,2.9
39013,3/1/19,29949,28148,1801,6
39015,3/1/19,19574,18535,1039,5.3
39017,3/1/19,193854,186756,7098,3.7
39019,3/1/19,12998,12291,707,5.4
39021,3/1/19,19964,19259,705,3.5
39023,3/1/19,63127,60460,2667,4.2
39025,3/1/19,106262,102256,4006,3.8
39027,3/1/19,17708,16827,881,5
39029,3/1/19,47259,44905,2354,5
39031,3/1/19,14524,13682,842,5.8
39033,3/1/19,18075,17199,876,4.8
39035,3/1/19,610097,583403,26694,4.4
39037,3/1/19,25880,24868,1012,3.9
39039,3/1/19,18024,17273,751,4.2
39041,3/1/19,108844,105604,3240,3
39043,3/1/19,36211,34138,2073,5.7
39045,3/1/19,77312,74363,2949,3.8
39047,3/1/19,13846,13281,565,4.1
39049,3/1/19,688638,664876,23762,3.5
39051,3/1/19,22619,21527,1092,4.8
39053,3/1/19,12499,11792,707,5.7
39055,3/1/19,49055,47156,1899,3.9
39057,3/1/19,82759,79735,3024,3.7
39059,3/1/19,18744,17599,1145,6.1
39061,3/1/19,412861,397891,14970,3.6
39063,3/1/19,41918,40641,1277,3
39065,3/1/19,14280,13729,551,3.9
39067,3/1/19,6838,6483,355,5.2
39069,3/1/19,13377,12610,767,5.7
39071,3/1/19,17228,16310,918,5.3
39073,3/1/19,13018,12325,693,5.3
39075,3/1/19,20752,20139,613,3
39077,3/1/19,28070,26155,1915,6.8
39079,3/1/19,12828,11970,858,6.7
39081,3/1/19,27657,25975,1682,6.1
39083,3/1/19,31866,30554,1312,4.1
39085,3/1/19,126183,121012,5171,4.1
39087,3/1/19,23743,22548,1195,5
39089,3/1/19,89553,86227,3326,3.7
39091,3/1/19,22997,22172,825,3.6
39093,3/1/19,153536,146452,7084,4.6
39095,3/1/19,209092,199308,9784,4.7
39097,3/1/19,20745,19988,757,3.6
39099,3/1/19,103455,97001,6454,6.2
39101,3/1/19,28618,27418,1200,4.2
39103,3/1/19,97273,93778,3495,3.6
39105,3/1/19,9323,8624,699,7.5
39107,3/1/19,23447,22853,594,2.5
39109,3/1/19,53926,51912,2014,3.7
39111,3/1/19,5439,4939,500,9.2
39113,3/1/19,250638,240407,10231,4.1
39115,3/1/19,6829,6320,509,7.5
39117,3/1/19,16702,15957,745,4.5
39119,3/1/19,39364,37211,2153,5.5
39121,3/1/19,4736,4365,371,7.8
39123,3/1/19,20305,18771,1534,7.6
39125,3/1/19,8648,8344,304,3.5
39127,3/1/19,15855,14950,905,5.7
39129,3/1/19,26313,25187,1126,4.3
39131,3/1/19,10951,10203,748,6.8
39133,3/1/19,87095,83221,3874,4.4
39135,3/1/19,21136,20313,823,3.9
39137,3/1/19,18875,18272,603,3.2
39139,3/1/19,52230,49781,2449,4.7
39141,3/1/19,35323,33756,1567,4.4
39143,3/1/19,30594,29182,1412,4.6
39145,3/1/19,28925,27029,1896,6.6
39147,3/1/19,27502,26348,1154,4.2
39149,3/1/19,24240,23395,845,3.5
39151,3/1/19,185502,176499,9003,4.9
39153,3/1/19,271569,259371,12198,4.5
39155,3/1/19,87178,81240,5938,6.8
39157,3/1/19,44391,42337,2054,4.6
39159,3/1/19,28712,27835,877,3.1
39161,3/1/19,15112,14644,468,3.1
39163,3/1/19,5588,5224,364,6.5
39165,3/1/19,118435,114370,4065,3.4
39167,3/1/19,27246,25696,1550,5.7
39169,3/1/19,62047,60028,2019,3.3
39171,3/1/19,18957,18337,620,3.3
39173,3/1/19,70847,68253,2594,3.7
39175,3/1/19,13050,12648,402,3.1
40001,3/1/19,8041,7704,337,4.2
40003,3/1/19,2797,2741,56,2
40005,3/1/19,4935,4728,207,4.2
40007,3/1/19,2802,2739,63,2.2
40009,3/1/19,10817,10534,283,2.6
40011,3/1/19,4706,4613,93,2
40013,3/1/19,20946,20295,651,3.1
40015,3/1/19,11892,11500,392,3.3
40017,3/1/19,73910,71871,2039,2.8
40019,3/1/19,21478,20744,734,3.4
40021,3/1/19,18597,17879,718,3.9
40023,3/1/19,5360,5115,245,4.6
40025,3/1/19,1291,1268,23,1.8
40027,3/1/19,142581,138462,4119,2.9
40029,3/1/19,2577,2492,85,3.3
40031,3/1/19,48186,46446,1740,3.6
40033,3/1/19,2697,2610,87,3.2
40035,3/1/19,5864,5661,203,3.5
40037,3/1/19,31537,30390,1147,3.6
40039,3/1/19,15725,15351,374,2.4
40041,3/1/19,17629,16920,709,4
40043,3/1/19,2807,2754,53,1.9
40045,3/1/19,2138,2087,51,2.4
40047,3/1/19,27032,26200,832,3.1
40049,3/1/19,12833,12444,389,3
40051,3/1/19,26288,25501,787,3
40053,3/1/19,2613,2557,56,2.1
40055,3/1/19,1802,1722,80,4.4
40057,3/1/19,1189,1156,33,2.8
40059,3/1/19,1722,1673,49,2.8
40061,3/1/19,4219,4023,196,4.6
40063,3/1/19,5394,5168,226,4.2
40065,3/1/19,10633,10314,319,3
40067,3/1/19,2515,2435,80,3.2
40069,3/1/19,3833,3681,152,4
40071,3/1/19,18275,17525,750,4.1
40073,3/1/19,9080,8888,192,2.1
40075,3/1/19,3353,3235,118,3.5
40077,3/1/19,3142,2968,174,5.5
40079,3/1/19,18913,18072,841,4.4
40081,3/1/19,15681,15123,558,3.6
40083,3/1/19,22014,21341,673,3.1
40085,3/1/19,6183,6045,138,2.2
40087,3/1/19,19480,18953,527,2.7
40089,3/1/19,14143,13457,686,4.9
40091,3/1/19,6951,6576,375,5.4
40093,3/1/19,3868,3780,88,2.3
40095,3/1/19,6815,6576,239,3.5
40097,3/1/19,19398,18793,605,3.1
40099,3/1/19,6271,6074,197,3.1
40101,3/1/19,29073,28021,1052,3.6
40103,3/1/19,5731,5590,141,2.5
40105,3/1/19,4608,4439,169,3.7
40107,3/1/19,4648,4454,194,4.2
40109,3/1/19,383639,371647,11992,3.1
40111,3/1/19,15609,14885,724,4.6
40113,3/1/19,20640,19855,785,3.8
40115,3/1/19,14148,13654,494,3.5
40117,3/1/19,7318,7037,281,3.8
40119,3/1/19,38493,37366,1127,2.9
40121,3/1/19,17424,16792,632,3.6
40123,3/1/19,18963,18424,539,2.8
40125,3/1/19,32203,31051,1152,3.6
40127,3/1/19,4245,4041,204,4.8
40129,3/1/19,1881,1833,48,2.6
40131,3/1/19,45092,43703,1389,3.1
40133,3/1/19,9498,9077,421,4.4
40135,3/1/19,16078,15440,638,4
40137,3/1/19,18663,17963,700,3.8
40139,3/1/19,11073,10833,240,2.2
40141,3/1/19,3018,2913,105,3.5
40143,3/1/19,323001,312893,10108,3.1
40145,3/1/19,37914,36737,1177,3.1
40147,3/1/19,22503,21715,788,3.5
40149,3/1/19,5154,5001,153,3
40151,3/1/19,4605,4501,104,2.3
40153,3/1/19,8944,8695,249,2.8
41001,3/1/19,7022,6592,430,6.1
41003,3/1/19,48747,47094,1653,3.4
41005,3/1/19,219230,210569,8661,4
41007,3/1/19,19065,18198,867,4.5
41009,3/1/19,24456,23236,1220,5
41011,3/1/19,26310,24777,1533,5.8
41013,3/1/19,9452,8751,701,7.4
41015,3/1/19,8840,8263,577,6.5
41017,3/1/19,94850,89878,4972,5.2
41019,3/1/19,46237,43497,2740,5.9
41021,3/1/19,981,940,41,4.2
41023,3/1/19,3123,2810,313,10
41025,3/1/19,3514,3257,257,7.3
41027,3/1/19,13724,13137,587,4.3
41029,3/1/19,103253,97688,5565,5.4
41031,3/1/19,10064,9330,734,7.3
41033,3/1/19,35615,33444,2171,6.1
41035,3/1/19,29068,26805,2263,7.8
41037,3/1/19,3469,3193,276,8
41039,3/1/19,181248,172514,8734,4.8
41041,3/1/19,20514,19437,1077,5.3
41043,3/1/19,58877,55918,2959,5
41045,3/1/19,12122,11491,631,5.2
41047,3/1/19,160813,153281,7532,4.7
41049,3/1/19,5564,5282,282,5.1
41051,3/1/19,455019,437557,17462,3.8
41053,3/1/19,39626,37744,1882,4.7
41055,3/1/19,898,860,38,4.2
41057,3/1/19,11805,11244,561,4.8
41059,3/1/19,35802,33696,2106,5.9
41061,3/1/19,11989,11220,769,6.4
41063,3/1/19,3344,3021,323,9.7
41065,3/1/19,12396,11705,691,5.6
41067,3/1/19,324427,312757,11670,3.6
41069,3/1/19,729,691,38,5.2
41071,3/1/19,54578,52440,2138,3.9
42001,3/1/19,55159,53465,1694,3.1
42003,3/1/19,644822,618701,26121,4.1
42005,3/1/19,32034,30350,1684,5.3
42007,3/1/19,83437,79749,3688,4.4
42009,3/1/19,23155,21974,1181,5.1
42011,3/1/19,213819,204851,8968,4.2
42013,3/1/19,58803,56280,2523,4.3
42015,3/1/19,28465,27151,1314,4.6
42017,3/1/19,342122,329249,12873,3.8
42019,3/1/19,99132,95241,3891,3.9
42021,3/1/19,57872,54858,3014,5.2
42023,3/1/19,2056,1929,127,6.2
42025,3/1/19,32070,30254,1816,5.7
42027,3/1/19,80926,78474,2452,3
42029,3/1/19,281368,273064,8304,3
42031,3/1/19,17055,16152,903,5.3
42033,3/1/19,35866,33875,1991,5.6
42035,3/1/19,18416,17372,1044,5.7
42037,3/1/19,33564,31954,1610,4.8
42039,3/1/19,38136,36339,1797,4.7
42041,3/1/19,130358,126292,4066,3.1
42043,3/1/19,142562,137219,5343,3.7
42045,3/1/19,297793,286543,11250,3.8
42047,3/1/19,15656,15020,636,4.1
42049,3/1/19,128543,122538,6005,4.7
42051,3/1/19,56888,53390,3498,6.1
42053,3/1/19,1786,1655,131,7.3
42055,3/1/19,76848,74001,2847,3.7
42057,3/1/19,7769,7403,366,4.7
42059,3/1/19,16627,15804,823,4.9
42061,3/1/19,19881,18576,1305,6.6
42063,3/1/19,39065,37156,1909,4.9
42065,3/1/19,20289,19313,976,4.8
42067,3/1/19,12371,11769,602,4.9
42069,3/1/19,104569,99438,5131,4.9
42071,3/1/19,280334,271145,9189,3.3
42073,3/1/19,40568,38232,2336,5.8
42075,3/1/19,71381,68742,2639,3.7
42077,3/1/19,191918,183270,8648,4.5
42079,3/1/19,156827,147784,9043,5.8
42081,3/1/19,56557,53628,2929,5.2
42083,3/1/19,17168,16267,901,5.2
42085,3/1/19,48910,46624,2286,4.7
42087,3/1/19,20771,19755,1016,4.9
42089,3/1/19,82615,78234,4381,5.3
42091,3/1/19,452144,436913,15231,3.4
42093,3/1/19,9117,8794,323,3.5
42095,3/1/19,160557,153470,7087,4.4
42097,3/1/19,42573,40059,2514,5.9
42099,3/1/19,24076,23186,890,3.7
42101,3/1/19,716194,679288,36906,5.2
42103,3/1/19,25085,23631,1454,5.8
42105,3/1/19,7062,6596,466,6.6
42107,3/1/19,65981,62371,3610,5.5
42109,3/1/19,20158,19268,890,4.4
42111,3/1/19,33570,31637,1933,5.8
42113,3/1/19,2594,2456,138,5.3
42115,3/1/19,20279,19251,1028,5.1
42117,3/1/19,18782,17659,1123,6
42119,3/1/19,19773,19026,747,3.8
42121,3/1/19,22204,21118,1086,4.9
42123,3/1/19,18901,17994,907,4.8
42125,3/1/19,106397,101633,4764,4.5
42127,3/1/19,21877,20625,1252,5.7
42129,3/1/19,180111,171904,8207,4.6
42131,3/1/19,13487,12791,696,5.2
42133,3/1/19,233997,225486,8511,3.6
44001,3/1/19,25737,24887,850,3.3
44003,3/1/19,89731,86632,3099,3.5
44005,3/1/19,43988,42326,1662,3.8
44007,3/1/19,322135,308715,13420,4.2
44009,3/1/19,68074,65614,2460,3.6
45001,3/1/19,10140,9757,383,3.8
45003,3/1/19,75334,72710,2624,3.5
45005,3/1/19,2706,2548,158,5.8
45007,3/1/19,91648,88737,2911,3.2
45009,3/1/19,4939,4654,285,5.8
45011,3/1/19,8277,7865,412,5
45013,3/1/19,76733,74282,2451,3.2
45015,3/1/19,104249,101100,3149,3
45017,3/1/19,6557,6289,268,4.1
45019,3/1/19,211865,205982,5883,2.8
45021,3/1/19,25403,24515,888,3.5
45023,3/1/19,13388,12763,625,4.7
45025,3/1/19,22131,21384,747,3.4
45027,3/1/19,12592,12036,556,4.4
45029,3/1/19,16720,16089,631,3.8
45031,3/1/19,30391,29229,1162,3.8
45033,3/1/19,12948,12346,602,4.6
45035,3/1/19,78294,75951,2343,3
45037,3/1/19,10714,10360,354,3.3
45039,3/1/19,9585,9097,488,5.1
45041,3/1/19,67178,64843,2335,3.5
45043,3/1/19,25256,24053,1203,4.8
45045,3/1/19,256213,248753,7460,2.9
45047,3/1/19,31616,30479,1137,3.6
45049,3/1/19,8261,8000,261,3.2
45051,3/1/19,146217,139660,6557,4.5
45053,3/1/19,12496,12113,383,3.1
45055,3/1/19,29117,28137,980,3.4
45057,3/1/19,41240,39604,1636,4
45059,3/1/19,30296,29246,1050,3.5
45061,3/1/19,6529,6259,270,4.1
45063,3/1/19,149624,145423,4201,2.8
45065,3/1/19,3402,3273,129,3.8
45067,3/1/19,13093,12403,690,5.3
45069,3/1/19,9194,8742,452,4.9
45071,3/1/19,19081,18513,568,3
45073,3/1/19,34838,33708,1130,3.2
45075,3/1/19,35078,33301,1777,5.1
45077,3/1/19,57713,55862,1851,3.2
45079,3/1/19,198721,192163,6558,3.3
45081,3/1/19,8748,8457,291,3.3
45083,3/1/19,154059,149536,4523,2.9
45085,3/1/19,43724,42015,1709,3.9
45087,3/1/19,11742,11270,472,4
45089,3/1/19,12140,11510,630,5.2
45091,3/1/19,140154,135598,4556,3.3
46003,3/1/19,1547,1504,43,2.8
46005,3/1/19,9577,9230,347,3.6
46007,3/1/19,1080,1017,63,5.8
46009,3/1/19,2866,2773,93,3.2
46011,3/1/19,19175,18583,592,3.1
46013,3/1/19,20771,20095,676,3.3
46015,3/1/19,2418,2342,76,3.1
46017,3/1/19,681,650,31,4.6
46019,3/1/19,5033,4856,177,3.5
46021,3/1/19,771,742,29,3.8
46023,3/1/19,3757,3614,143,3.8
46025,3/1/19,1907,1811,96,5
46027,3/1/19,7675,7437,238,3.1
46029,3/1/19,15420,14841,579,3.8
46031,3/1/19,1393,1325,68,4.9
46033,3/1/19,3993,3769,224,5.6
46035,3/1/19,11045,10686,359,3.3
46037,3/1/19,2749,2578,171,6.2
46039,3/1/19,2121,1979,142,6.7
46041,3/1/19,2207,2080,127,5.8
46043,3/1/19,1608,1552,56,3.5
46045,3/1/19,2070,2005,65,3.1
46047,3/1/19,2964,2821,143,4.8
46049,3/1/19,1068,1034,34,3.2
46051,3/1/19,4483,4259,224,5
46053,3/1/19,2021,1942,79,3.9
46055,3/1/19,1059,1025,34,3.2
46057,3/1/19,3277,3138,139,4.2
46059,3/1/19,1794,1738,56,3.1
46061,3/1/19,1780,1667,113,6.3
46063,3/1/19,728,708,20,2.7
46065,3/1/19,9892,9580,312,3.2
46067,3/1/19,3601,3470,131,3.6
46069,3/1/19,693,670,23,3.3
46071,3/1/19,1218,1135,83,6.8
46073,3/1/19,1115,1084,31,2.8
46075,3/1/19,519,500,19,3.7
46077,3/1/19,2744,2644,100,3.6
46079,3/1/19,6707,6449,258,3.8
46081,3/1/19,12960,12526,434,3.3
46083,3/1/19,34246,33300,946,2.8
46085,3/1/19,1627,1544,83,5.1
46087,3/1/19,3102,2989,113,3.6
46089,3/1/19,1023,975,48,4.7
46091,3/1/19,2345,2237,108,4.6
46093,3/1/19,13773,13197,576,4.2
46095,3/1/19,759,719,40,5.3
46097,3/1/19,1180,1146,34,2.9
46099,3/1/19,112052,108434,3618,3.2
46101,3/1/19,4032,3898,134,3.3
46102,3/1/19,3472,3157,315,9.1
46103,3/1/19,54962,52910,2052,3.7
46105,3/1/19,1447,1401,46,3.2
46107,3/1/19,1035,1001,34,3.3
46109,3/1/19,4790,4535,255,5.3
46111,3/1/19,1173,1138,35,3
46115,3/1/19,3226,3098,128,4
46117,3/1/19,1852,1784,68,3.7
46119,3/1/19,818,789,29,3.5
46121,3/1/19,3194,3004,190,5.9
46123,3/1/19,3112,3027,85,2.7
46125,3/1/19,4733,4560,173,3.7
46127,3/1/19,8471,8182,289,3.4
46129,3/1/19,2118,1971,147,6.9
46135,3/1/19,11860,11505,355,3
46137,3/1/19,938,899,39,4.2
47001,3/1/19,34940,33656,1284,3.7
47003,3/1/19,21090,20291,799,3.8
47005,3/1/19,7044,6729,315,4.5
47007,3/1/19,4291,4046,245,5.7
47009,3/1/19,64039,61895,2144,3.3
47011,3/1/19,50990,49146,1844,3.6
47013,3/1/19,14974,14249,725,4.8
47015,3/1/19,6613,6407,206,3.1
47017,3/1/19,12263,11678,585,4.8
47019,3/1/19,24524,23477,1047,4.3
47021,3/1/19,22006,21384,622,2.8
47023,3/1/19,8629,8319,310,3.6
47025,3/1/19,13258,12676,582,4.4
47027,3/1/19,2869,2687,182,6.3
47029,3/1/19,15050,14310,740,4.9
47031,3/1/19,25554,24698,856,3.3
47033,3/1/19,7016,6753,263,3.7
47035,3/1/19,23400,22303,1097,4.7
47037,3/1/19,406905,396126,10779,2.6
47039,3/1/19,4607,4350,257,5.6
47041,3/1/19,7792,7447,345,4.4
47043,3/1/19,27188,26341,847,3.1
47045,3/1/19,16715,15948,767,4.6
47047,3/1/19,19226,18516,710,3.7
47049,3/1/19,7520,7210,310,4.1
47051,3/1/19,20354,19660,694,3.4
47053,3/1/19,22097,21145,952,4.3
47055,3/1/19,15169,14609,560,3.7
47057,3/1/19,9566,9164,402,4.2
47059,3/1/19,30138,28693,1445,4.8
47061,3/1/19,5058,4839,219,4.3
47063,3/1/19,28304,27181,1123,4
47065,3/1/19,185356,179282,6074,3.3
47067,3/1/19,2097,1973,124,5.9
47069,3/1/19,9478,9004,474,5
47071,3/1/19,10371,9920,451,4.3
47073,3/1/19,24009,23021,988,4.1
47075,3/1/19,7689,7297,392,5.1
47077,3/1/19,12351,11788,563,4.6
47079,3/1/19,14257,13634,623,4.4
47081,3/1/19,11480,11115,365,3.2
47083,3/1/19,3304,3145,159,4.8
47085,3/1/19,9015,8669,346,3.8
47087,3/1/19,4702,4455,247,5.3
47089,3/1/19,24721,23782,939,3.8
47091,3/1/19,7663,7383,280,3.7
47093,3/1/19,246026,238674,7352,3
47095,3/1/19,1781,1687,94,5.3
47097,3/1/19,9694,9148,546,5.6
47099,3/1/19,19198,18428,770,4
47101,3/1/19,5094,4872,222,4.4
47103,3/1/19,17153,16610,543,3.2
47105,3/1/19,23589,22758,831,3.5
47107,3/1/19,23696,22785,911,3.8
47109,3/1/19,8471,8005,466,5.5
47111,3/1/19,11230,10873,357,3.2
47113,3/1/19,49550,47751,1799,3.6
47115,3/1/19,12615,12046,569,4.5
47117,3/1/19,15892,15358,534,3.4
47119,3/1/19,49569,48114,1455,2.9
47121,3/1/19,5211,4969,242,4.6
47123,3/1/19,20369,19617,752,3.7
47125,3/1/19,85881,82568,3313,3.9
47127,3/1/19,3613,3510,103,2.9
47129,3/1/19,7935,7602,333,4.2
47131,3/1/19,12519,11940,579,4.6
47133,3/1/19,9900,9485,415,4.2
47135,3/1/19,3202,3040,162,5.1
47137,3/1/19,2286,2166,120,5.2
47139,3/1/19,7349,7049,300,4.1
47141,3/1/19,35246,33945,1301,3.7
47143,3/1/19,13286,12466,820,6.2
47145,3/1/19,23588,22602,986,4.2
47147,3/1/19,38124,36991,1133,3
47149,3/1/19,185290,180358,4932,2.7
47151,3/1/19,8474,8082,392,4.6
47153,3/1/19,6225,5969,256,4.1
47155,3/1/19,53693,51670,2023,3.8
47157,3/1/19,449385,431110,18275,4.1
47159,3/1/19,9499,9189,310,3.3
47161,3/1/19,5491,5223,268,4.9
47163,3/1/19,71202,68446,2756,3.9
47165,3/1/19,103006,100121,2885,2.8
47167,3/1/19,28368,27249,1119,3.9
47169,3/1/19,5461,5276,185,3.4
47171,3/1/19,7215,6838,377,5.2
47173,3/1/19,7685,7360,325,4.2
47175,3/1/19,2057,1959,98,4.8
47177,3/1/19,16736,16046,690,4.1
47179,3/1/19,61628,59481,2147,3.5
47181,3/1/19,6267,5987,280,4.5
47183,3/1/19,16374,15749,625,3.8
47185,3/1/19,12386,11917,469,3.8
47187,3/1/19,129149,125847,3302,2.6
47189,3/1/19,77088,74910,2178,2.8
48001,3/1/19,23790,23100,690,2.9
48003,3/1/19,9994,9779,215,2.2
48005,3/1/19,36014,34589,1425,4
48007,3/1/19,9461,9041,420,4.4
48009,3/1/19,4154,4029,125,3
48011,3/1/19,932,906,26,2.8
48013,3/1/19,21607,20834,773,3.6
48015,3/1/19,14084,13606,478,3.4
48017,3/1/19,2554,2452,102,4
48019,3/1/19,10056,9707,349,3.5
48021,3/1/19,42594,41346,1248,2.9
48023,3/1/19,1745,1703,42,2.4
48025,3/1/19,9983,9556,427,4.3
48027,3/1/19,142797,137353,5444,3.8
48029,3/1/19,942350,912924,29426,3.1
48031,3/1/19,6463,6296,167,2.6
48033,3/1/19,385,375,10,2.6
48035,3/1/19,8341,8068,273,3.3
48037,3/1/19,39902,38086,1816,4.6
48039,3/1/19,178341,171394,6947,3.9
48041,3/1/19,121039,117916,3123,2.6
48043,3/1/19,4274,4149,125,2.9
48045,3/1/19,588,565,23,3.9
48047,3/1/19,2637,2494,143,5.4
48049,3/1/19,15962,15383,579,3.6
48051,3/1/19,8525,8263,262,3.1
48053,3/1/19,23590,22938,652,2.8
48055,3/1/19,19543,18886,657,3.4
48057,3/1/19,12163,11799,364,3
48059,3/1/19,6088,5899,189,3.1
48061,3/1/19,166421,157436,8985,5.4
48063,3/1/19,4938,4727,211,4.3
48065,3/1/19,3024,2938,86,2.8
48067,3/1/19,12627,12083,544,4.3
48069,3/1/19,3543,3440,103,2.9
48071,3/1/19,19375,18536,839,4.3
48073,3/1/19,21094,20287,807,3.8
48075,3/1/19,2932,2854,78,2.7
48077,3/1/19,4940,4792,148,3
48079,3/1/19,1179,1137,42,3.6
48081,3/1/19,1419,1370,49,3.5
48083,3/1/19,2895,2780,115,4
48085,3/1/19,557221,539561,17660,3.2
48087,3/1/19,1151,1116,35,3
48089,3/1/19,9806,9500,306,3.1
48091,3/1/19,72974,70718,2256,3.1
48093,3/1/19,5588,5411,177,3.2
48095,3/1/19,1130,1092,38,3.4
48097,3/1/19,19999,19426,573,2.9
48099,3/1/19,23955,23009,946,3.9
48101,3/1/19,557,534,23,4.1
48103,3/1/19,1535,1478,57,3.7
48105,3/1/19,1643,1601,42,2.6
48107,3/1/19,2522,2424,98,3.9
48109,3/1/19,998,967,31,3.1
48111,3/1/19,3983,3909,74,1.9
48113,3/1/19,1348687,1301545,47142,3.5
48115,3/1/19,4728,4557,171,3.6
48117,3/1/19,8473,8238,235,2.8
48119,3/1/19,2454,2371,83,3.4
48121,3/1/19,488960,473930,15030,3.1
48123,3/1/19,9807,9550,257,2.6
48125,3/1/19,671,641,30,4.5
48127,3/1/19,7627,7446,181,2.4
48129,3/1/19,1470,1423,47,3.2
48131,3/1/19,5013,4785,228,4.5
48133,3/1/19,8700,8424,276,3.2
48135,3/1/19,88268,86124,2144,2.4
48137,3/1/19,979,951,28,2.9
48139,3/1/19,91693,88773,2920,3.2
48141,3/1/19,361861,348004,13857,3.8
48143,3/1/19,21556,20936,620,2.9
48145,3/1/19,6570,6347,223,3.4
48147,3/1/19,17198,16703,495,2.9
48149,3/1/19,12579,12230,349,2.8
48151,3/1/19,1649,1601,48,2.9
48153,3/1/19,2628,2500,128,4.9
48155,3/1/19,584,568,16,2.7
48157,3/1/19,391023,377395,13628,3.5
48159,3/1/19,4636,4460,176,3.8
48161,3/1/19,6428,6121,307,4.8
48163,3/1/19,10558,10296,262,2.5
48165,3/1/19,9826,9598,228,2.3
48167,3/1/19,164789,158316,6473,3.9
48169,3/1/19,2183,2121,62,2.8
48171,3/1/19,13521,13171,350,2.6
48173,3/1/19,811,793,18,2.2
48175,3/1/19,3294,3185,109,3.3
48177,3/1/19,9684,9424,260,2.7
48179,3/1/19,8028,7736,292,3.6
48181,3/1/19,64018,62066,1952,3
48183,3/1/19,58277,56091,2186,3.8
48185,3/1/19,11367,10925,442,3.9
48187,3/1/19,80923,78494,2429,3
48189,3/1/19,12403,11805,598,4.8
48191,3/1/19,1099,1052,47,4.3
48193,3/1/19,3687,3572,115,3.1
48195,3/1/19,2845,2775,70,2.5
48197,3/1/19,1712,1654,58,3.4
48199,3/1/19,25436,24287,1149,4.5
48201,3/1/19,2309095,2222013,87082,3.8
48203,3/1/19,29544,28355,1189,4
48205,3/1/19,2835,2790,45,1.6
48207,3/1/19,2296,2217,79,3.4
48209,3/1/19,118951,115708,3243,2.7
48211,3/1/19,1925,1878,47,2.4
48213,3/1/19,36409,35104,1305,3.6
48215,3/1/19,352114,331869,20245,5.7
48217,3/1/19,16359,15807,552,3.4
48219,3/1/19,11395,11040,355,3.1
48221,3/1/19,27436,26495,941,3.4
48223,3/1/19,17571,17005,566,3.2
48225,3/1/19,10197,9880,317,3.1
48227,3/1/19,13984,13537,447,3.2
48229,3/1/19,1837,1761,76,4.1
48231,3/1/19,42938,41404,1534,3.6
48233,3/1/19,8560,8195,365,4.3
48235,3/1/19,773,754,19,2.5
48237,3/1/19,3462,3354,108,3.1
48239,3/1/19,7466,7238,228,3.1
48241,3/1/19,12971,12198,773,6
48243,3/1/19,1087,1056,31,2.9
48245,3/1/19,107191,101296,5895,5.5
48247,3/1/19,1911,1814,97,5.1
48249,3/1/19,17006,16214,792,4.7
48251,3/1/19,81657,78963,2694,3.3
48253,3/1/19,5747,5478,269,4.7
48255,3/1/19,7066,6894,172,2.4
48257,3/1/19,63841,61698,2143,3.4
48259,3/1/19,22082,21467,615,2.8
48261,3/1/19,249,241,8,3.2
48263,3/1/19,458,448,10,2.2
48265,3/1/19,22207,21536,671,3
48267,3/1/19,1852,1795,57,3.1
48269,3/1/19,220,215,5,2.3
48271,3/1/19,1399,1342,57,4.1
48273,3/1/19,13717,13148,569,4.1
48275,3/1/19,1461,1411,50,3.4
48277,3/1/19,24023,23202,821,3.4
48279,3/1/19,5378,5158,220,4.1
48281,3/1/19,9177,8866,311,3.4
48283,3/1/19,4406,4300,106,2.4
48285,3/1/19,8623,8356,267,3.1
48287,3/1/19,10264,9987,277,2.7
48289,3/1/19,6301,6038,263,4.2
48291,3/1/19,32958,31362,1596,4.8
48293,3/1/19,8632,8301,331,3.8
48295,3/1/19,1660,1613,47,2.8
48297,3/1/19,5531,5359,172,3.1
48299,3/1/19,8550,8239,311,3.6
48301,3/1/19,404,400,4,1
48303,3/1/19,157893,153053,4840,3.1
48305,3/1/19,2798,2712,86,3.1
48307,3/1/19,3726,3562,164,4.4
48309,3/1/19,119131,115129,4002,3.4
48311,3/1/19,773,759,14,1.8
48313,3/1/19,4630,4449,181,3.9
48315,3/1/19,4258,4069,189,4.4
48317,3/1/19,2879,2812,67,2.3
48319,3/1/19,1795,1736,59,3.3
48321,3/1/19,16701,15841,860,5.1
48323,3/1/19,24190,22243,1947,8
48325,3/1/19,21733,21043,690,3.2
48327,3/1/19,836,806,30,3.6
48329,3/1/19,106633,104462,2171,2
48331,3/1/19,9854,9328,526,5.3
48333,3/1/19,1919,1847,72,3.8
48335,3/1/19,2312,2231,81,3.5
48337,3/1/19,9201,8929,272,3
48339,3/1/19,283218,273692,9526,3.4
48341,3/1/19,10953,10698,255,2.3
48343,3/1/19,4783,4528,255,5.3
48345,3/1/19,489,470,19,3.9
48347,3/1/19,28548,27545,1003,3.5
48349,3/1/19,23524,22651,873,3.7
48351,3/1/19,5186,4888,298,5.7
48353,3/1/19,6880,6674,206,3
48355,3/1/19,167527,160477,7050,4.2
48357,3/1/19,4374,4258,116,2.7
48359,3/1/19,918,892,26,2.8
48361,3/1/19,36499,34704,1795,4.9
48363,3/1/19,13622,13173,449,3.3
48365,3/1/19,10492,10073,419,4
48367,3/1/19,66942,64965,1977,3
48369,3/1/19,4907,4789,118,2.4
48371,3/1/19,6451,6251,200,3.1
48373,3/1/19,18043,17212,831,4.6
48375,3/1/19,55014,53435,1579,2.9
48377,3/1/19,3062,2897,165,5.4
48379,3/1/19,6077,5887,190,3.1
48381,3/1/19,71794,69982,1812,2.5
48383,3/1/19,1857,1817,40,2.2
48385,3/1/19,1044,1000,44,4.2
48387,3/1/19,5063,4828,235,4.6
48389,3/1/19,11048,10866,182,1.6
48391,3/1/19,3167,3054,113,3.6
48393,3/1/19,414,401,13,3.1
48395,3/1/19,7813,7535,278,3.6
48397,3/1/19,51489,49882,1607,3.1
48399,3/1/19,4569,4437,132,2.9
48401,3/1/19,23034,22251,783,3.4
48403,3/1/19,3732,3492,240,6.4
48405,3/1/19,3461,3310,151,4.4
48407,3/1/19,11728,11220,508,4.3
48409,3/1/19,29907,28277,1630,5.5
48411,3/1/19,2611,2535,76,2.9
48413,3/1/19,1366,1331,35,2.6
48415,3/1/19,6686,6472,214,3.2
48417,3/1/19,1907,1859,48,2.5
48419,3/1/19,11061,10624,437,4
48421,3/1/19,1411,1378,33,2.3
48423,3/1/19,107033,103444,3589,3.4
48425,3/1/19,4337,4181,156,3.6
48427,3/1/19,25574,23338,2236,8.7
48429,3/1/19,4210,4080,130,3.1
48431,3/1/19,589,573,16,2.7
48433,3/1/19,576,558,18,3.1
48435,3/1/19,1517,1467,50,3.3
48437,3/1/19,2673,2569,104,3.9
48439,3/1/19,1074459,1038886,35573,3.3
48441,3/1/19,66480,64532,1948,2.9
48443,3/1/19,379,366,13,3.4
48445,3/1/19,5095,4907,188,3.7
48447,3/1/19,665,641,24,3.6
48449,3/1/19,12878,12309,569,4.4
48451,3/1/19,54906,53254,1652,3
48453,3/1/19,735922,716826,19096,2.6
48455,3/1/19,5323,5078,245,4.6
48457,3/1/19,7192,6801,391,5.4
48459,3/1/19,17910,17251,659,3.7
48461,3/1/19,1639,1586,53,3.2
48463,3/1/19,11514,11075,439,3.8
48465,3/1/19,22752,21983,769,3.4
48467,3/1/19,26027,25157,870,3.3
48469,3/1/19,43069,41597,1472,3.4
48471,3/1/19,24213,23311,902,3.7
48473,3/1/19,23428,22561,867,3.7
48475,3/1/19,7472,7305,167,2.2
48477,3/1/19,15009,14465,544,3.6
48479,3/1/19,118259,113829,4430,3.7
48481,3/1/19,21617,20914,703,3.3
48483,3/1/19,2291,2224,67,2.9
48485,3/1/19,56227,54435,1792,3.2
48487,3/1/19,5005,4817,188,3.8
48489,3/1/19,6624,6085,539,8.1
48491,3/1/19,311456,302653,8803,2.8
48493,3/1/19,24740,24030,710,2.9
48495,3/1/19,4105,3997,108,2.6
48497,3/1/19,31793,30692,1101,3.5
48499,3/1/19,17568,16881,687,3.9
48501,3/1/19,3828,3722,106,2.8
48503,3/1/19,7997,7759,238,3
48505,3/1/19,5275,5023,252,4.8
48507,3/1/19,3369,3093,276,8.2
49001,3/1/19,3045,2949,96,3.2
49003,3/1/19,25734,24930,804,3.1
49005,3/1/19,64853,63203,1650,2.5
49007,3/1/19,8420,8052,368,4.4
49009,3/1/19,361,340,21,5.8
49011,3/1/19,170962,166241,4721,2.8
49013,3/1/19,7692,7344,348,4.5
49015,3/1/19,4447,4237,210,4.7
49017,3/1/19,2521,2284,237,9.4
49019,3/1/19,5944,5682,262,4.4
49021,3/1/19,23949,23138,811,3.4
49023,3/1/19,5711,5525,186,3.3
49025,3/1/19,3647,3505,142,3.9
49027,3/1/19,6154,5958,196,3.2
49029,3/1/19,5486,5333,153,2.8
49031,3/1/19,486,461,25,5.1
49033,3/1/19,977,934,43,4.4
49035,3/1/19,624262,605680,18582,3
49037,3/1/19,5683,5318,365,6.4
49039,3/1/19,12733,12265,468,3.7
49041,3/1/19,9788,9410,378,3.9
49043,3/1/19,26512,25866,646,2.4
49045,3/1/19,33494,32352,1142,3.4
49047,3/1/19,13609,12966,643,4.7
49049,3/1/19,305785,297314,8471,2.8
49051,3/1/19,15772,15288,484,3.1
49053,3/1/19,75225,72777,2448,3.3
49055,3/1/19,1349,1253,96,7.1
49057,3/1/19,125833,121538,4295,3.4
50001,3/1/19,20397,19841,556,2.7
50003,3/1/19,18507,17943,564,3
50005,3/1/19,14430,13910,520,3.6
50007,3/1/19,96044,94263,1781,1.9
50009,3/1/19,2686,2575,111,4.1
50011,3/1/19,27352,26592,760,2.8
50013,3/1/19,4061,3906,155,3.8
50015,3/1/19,14054,13497,557,4
50017,3/1/19,15850,15376,474,3
50019,3/1/19,13599,12877,722,5.3
50021,3/1/19,30428,29552,876,2.9
50023,3/1/19,34654,33716,938,2.7
50025,3/1/19,22378,21814,564,2.5
50027,3/1/19,29240,28609,631,2.2
51001,3/1/19,16224,15582,642,4
51003,3/1/19,57204,55701,1503,2.6
51005,3/1/19,6953,6695,258,3.7
51007,3/1/19,6197,5973,224,3.6
51009,3/1/19,15126,14629,497,3.3
51011,3/1/19,7182,6908,274,3.8
51013,3/1/19,154788,151611,3177,2.1
51015,3/1/19,37397,36392,1005,2.7
51017,3/1/19,2386,2319,67,2.8
51019,3/1/19,38793,37595,1198,3.1
51021,3/1/19,2870,2787,83,2.9
51023,3/1/19,17483,16998,485,2.8
51025,3/1/19,6075,5750,325,5.3
51027,3/1/19,6867,6490,377,5.5
51029,3/1/19,6398,6099,299,4.7
51031,3/1/19,26270,25388,882,3.4
51033,3/1/19,15259,14740,519,3.4
51035,3/1/19,13217,12705,512,3.9
51036,3/1/19,3629,3484,145,4
51037,3/1/19,5190,4996,194,3.7
51041,3/1/19,188252,182818,5434,2.9
51043,3/1/19,7478,7264,214,2.9
51045,3/1/19,2305,2225,80,3.5
51047,3/1/19,24419,23707,712,2.9
51049,3/1/19,4625,4481,144,3.1
51051,3/1/19,4691,4457,234,5
51053,3/1/19,13604,13110,494,3.6
51057,3/1/19,5539,5308,231,4.2
51059,3/1/19,636612,621003,15609,2.5
51061,3/1/19,36775,35776,999,2.7
51063,3/1/19,8124,7896,228,2.8
51065,3/1/19,13978,13631,347,2.5
51067,3/1/19,26377,25522,855,3.2
51069,3/1/19,48058,46749,1309,2.7
51071,3/1/19,8019,7746,273,3.4
51073,3/1/19,19534,18987,547,2.8
51075,3/1/19,11183,10846,337,3
51077,3/1/19,8063,7799,264,3.3
51079,3/1/19,10496,10232,264,2.5
51081,3/1/19,4337,4166,171,3.9
51083,3/1/19,15742,15116,626,4
51085,3/1/19,59305,57773,1532,2.6
51087,3/1/19,183062,177597,5465,3
51089,3/1/19,24003,23133,870,3.6
51091,3/1/19,1149,1110,39,3.4
51093,3/1/19,19359,18782,577,3
51095,3/1/19,36721,35668,1053,2.9
51097,3/1/19,3830,3704,126,3.3
51099,3/1/19,13375,12992,383,2.9
51101,3/1/19,9120,8852,268,2.9
51103,3/1/19,5357,5025,332,6.2
51105,3/1/19,8334,8003,331,4
51107,3/1/19,222801,217294,5507,2.5
51109,3/1/19,20082,19513,569,2.8
51111,3/1/19,5309,5136,173,3.3
51113,3/1/19,7215,7024,191,2.6
51115,3/1/19,4154,4016,138,3.3
51117,3/1/19,12651,12137,514,4.1
51119,3/1/19,5156,5002,154,3
51121,3/1/19,51391,49923,1468,2.9
51125,3/1/19,7337,7115,222,3
51127,3/1/19,12480,12157,323,2.6
51131,3/1/19,5041,4756,285,5.7
51133,3/1/19,5552,5196,356,6.4
51135,3/1/19,7288,7076,212,2.9
51137,3/1/19,17130,16587,543,3.2
51139,3/1/19,11784,11188,596,5.1
51141,3/1/19,7438,7152,286,3.8
51143,3/1/19,30134,29083,1051,3.5
51145,3/1/19,14153,13779,374,2.6
51147,3/1/19,10396,10012,384,3.7
51149,3/1/19,15133,14595,538,3.6
51153,3/1/19,246311,239615,6696,2.7
51155,3/1/19,16464,15899,565,3.4
51157,3/1/19,3621,3513,108,3
51159,3/1/19,4024,3888,136,3.4
51161,3/1/19,49815,48485,1330,2.7
51163,3/1/19,10654,10331,323,3
51165,3/1/19,41791,40672,1119,2.7
51167,3/1/19,11203,10665,538,4.8
51169,3/1/19,9110,8788,322,3.5
51171,3/1/19,22202,21573,629,2.8
51173,3/1/19,13624,13089,535,3.9
51175,3/1/19,8898,8655,243,2.7
51177,3/1/19,67113,65022,2091,3.1
51179,3/1/19,72278,70167,2111,2.9
51181,3/1/19,3624,3505,119,3.3
51183,3/1/19,3633,3454,179,4.9
51185,3/1/19,15939,15207,732,4.6
51187,3/1/19,20407,19771,636,3.1
51191,3/1/19,26752,25788,964,3.6
51193,3/1/19,9211,8818,393,4.3
51195,3/1/19,13649,12998,651,4.8
51197,3/1/19,13563,13057,506,3.7
51199,3/1/19,32977,32027,950,2.9
51510,3/1/19,101593,99285,2308,2.3
51520,3/1/19,7230,6941,289,4
51530,3/1/19,3438,3336,102,3
51540,3/1/19,26598,25938,660,2.5
51550,3/1/19,123371,119611,3760,3
51570,3/1/19,8850,8552,298,3.4
51580,3/1/19,2419,2306,113,4.7
51590,3/1/19,19332,18299,1033,5.3
51595,3/1/19,2315,2185,130,5.6
51600,3/1/19,13497,13171,326,2.4
51610,3/1/19,8614,8430,184,2.1
51620,3/1/19,3582,3434,148,4.1
51630,3/1/19,14227,13715,512,3.6
51640,3/1/19,2923,2825,98,3.4
51650,3/1/19,64835,62214,2621,4
51660,3/1/19,25321,24483,838,3.3
51670,3/1/19,9729,9301,428,4.4
51678,3/1/19,2127,2032,95,4.5
51680,3/1/19,36793,35401,1392,3.8
51683,3/1/19,22147,21527,620,2.8
51685,3/1/19,9397,9143,254,2.7
51690,3/1/19,5518,5287,231,4.2
51700,3/1/19,89485,86194,3291,3.7
51710,3/1/19,112423,108353,4070,3.6
51720,3/1/19,1707,1640,67,3.9
51730,3/1/19,13099,12338,761,5.8
51735,3/1/19,6356,6187,169,2.7
51740,3/1/19,44598,42767,1831,4.1
51750,3/1/19,8882,8577,305,3.4
51760,3/1/19,118866,114765,4101,3.5
51770,3/1/19,49634,48067,1567,3.2
51775,3/1/19,13119,12741,378,2.9
51790,3/1/19,12359,11996,363,2.9
51800,3/1/19,44858,43415,1443,3.2
51810,3/1/19,234394,227641,6753,2.9
51820,3/1/19,10839,10489,350,3.2
51830,3/1/19,6714,6463,251,3.7
51840,3/1/19,14671,14226,445,3
53001,3/1/19,8669,7919,750,8.7
53003,3/1/19,10349,9835,514,5
53005,3/1/19,100731,94258,6473,6.4
53007,3/1/19,42708,40003,2705,6.3
53009,3/1/19,28551,26397,2154,7.5
53011,3/1/19,241607,229142,12465,5.2
53013,3/1/19,1818,1698,120,6.6
53015,3/1/19,48125,45015,3110,6.5
53017,3/1/19,20702,19188,1514,7.3
53019,3/1/19,2533,2163,370,14.6
53021,3/1/19,41324,37697,3627,8.8
53023,3/1/19,881,819,62,7
53025,3/1/19,45298,41092,4206,9.3
53027,3/1/19,29114,26749,2365,8.1
53029,3/1/19,35566,33623,1943,5.5
53031,3/1/19,12519,11700,819,6.5
53033,3/1/19,1289512,1251347,38165,3
53035,3/1/19,127968,121483,6485,5.1
53037,3/1/19,22855,21326,1529,6.7
53039,3/1/19,10027,9302,725,7.2
53041,3/1/19,34866,32441,2425,7
53043,3/1/19,4995,4681,314,6.3
53045,3/1/19,24911,23148,1763,7.1
53047,3/1/19,19358,17540,1818,9.4
53049,3/1/19,8254,7580,674,8.2
53051,3/1/19,5075,4605,470,9.3
53053,3/1/19,440466,415764,24702,5.6
53055,3/1/19,7963,7581,382,4.8
53057,3/1/19,62367,58788,3579,5.7
53059,3/1/19,5551,5214,337,6.1
53061,3/1/19,439194,425049,14145,3.2
53063,3/1/19,254947,238595,16352,6.4
53065,3/1/19,19243,17419,1824,9.5
53067,3/1/19,142696,135164,7532,5.3
53069,3/1/19,1389,1277,112,8.1
53071,3/1/19,29642,27853,1789,6
53073,3/1/19,115563,109583,5980,5.2
53075,3/1/19,24727,23603,1124,4.5
53077,3/1/19,127283,115465,11818,9.3
54001,3/1/19,7226,6783,443,6.1
54003,3/1/19,57065,54873,2192,3.8
54005,3/1/19,7295,6903,392,5.4
54007,3/1/19,5185,4764,421,8.1
54009,3/1/19,9813,9289,524,5.3
54011,3/1/19,40941,39161,1780,4.3
54013,3/1/19,2601,2219,382,14.7
54015,3/1/19,3115,2827,288,9.2
54017,3/1/19,3913,3731,182,4.7
54019,3/1/19,15945,14983,962,6
54021,3/1/19,2357,2182,175,7.4
54023,3/1/19,5884,5538,346,5.9
54025,3/1/19,15590,14742,848,5.4
54027,3/1/19,10653,10202,451,4.2
54029,3/1/19,12818,12149,669,5.2
54031,3/1/19,5807,5458,349,6
54033,3/1/19,34218,32617,1601,4.7
54035,3/1/19,12675,11946,729,5.8
54037,3/1/19,30066,29104,962,3.2
54039,3/1/19,81141,77140,4001,4.9
54041,3/1/19,6734,6334,400,5.9
54043,3/1/19,7099,6628,471,6.6
54045,3/1/19,11002,10344,658,6
54047,3/1/19,4451,4010,441,9.9
54049,3/1/19,25366,23997,1369,5.4
54051,3/1/19,13962,12961,1001,7.2
54053,3/1/19,10197,9578,619,6.1
54055,3/1/19,20810,19587,1223,5.9
54057,3/1/19,12578,11929,649,5.2
54059,3/1/19,6749,6309,440,6.5
54061,3/1/19,54086,52016,2070,3.8
54063,3/1/19,5931,5631,300,5.1
54065,3/1/19,8067,7724,343,4.3
54067,3/1/19,9379,8744,635,6.8
54069,3/1/19,20795,19787,1008,4.8
54071,3/1/19,3640,3485,155,4.3
54073,3/1/19,2899,2680,219,7.6
54075,3/1/19,4090,3865,225,5.5
54077,3/1/19,15493,14721,772,5
54079,3/1/19,26440,25191,1249,4.7
54081,3/1/19,29899,28381,1518,5.1
54083,3/1/19,12124,11353,771,6.4
54085,3/1/19,4335,4056,279,6.4
54087,3/1/19,5175,4567,608,11.7
54089,3/1/19,4223,3948,275,6.5
54091,3/1/19,7758,7356,402,5.2
54093,3/1/19,3325,3133,192,5.8
54095,3/1/19,3142,2885,257,8.2
54097,3/1/19,9607,9038,569,5.9
54099,3/1/19,15643,14717,926,5.9
54101,3/1/19,3283,3076,207,6.3
54103,3/1/19,6616,6098,518,7.8
54105,3/1/19,2251,2075,176,7.8
54107,3/1/19,36015,34027,1988,5.5
54109,3/1/19,6660,6167,493,7.4
55001,3/1/19,7979,7436,543,6.8
55003,3/1/19,7562,7129,433,5.7
55005,3/1/19,24313,23003,1310,5.4
55007,3/1/19,7315,6746,569,7.8
55009,3/1/19,141649,136913,4736,3.3
55011,3/1/19,6368,6026,342,5.4
55013,3/1/19,7078,6549,529,7.5
55015,3/1/19,27351,26544,807,3
55017,3/1/19,33412,31723,1689,5.1
55019,3/1/19,17592,16838,754,4.3
55021,3/1/19,31458,30287,1171,3.7
55023,3/1/19,7569,7121,448,5.9
55025,3/1/19,319756,311377,8379,2.6
55027,3/1/19,47052,45366,1686,3.6
55029,3/1/19,13967,13149,818,5.9
55031,3/1/19,23196,22035,1161,5
55033,3/1/19,24833,23792,1041,4.2
55035,3/1/19,58938,56992,1946,3.3
55037,3/1/19,2200,2078,122,5.5
55039,3/1/19,57225,55362,1863,3.3
55041,3/1/19,3950,3701,249,6.3
55043,3/1/19,28140,27067,1073,3.8
55045,3/1/19,20902,20127,775,3.7
55047,3/1/19,9237,8781,456,4.9
55049,3/1/19,13602,13066,536,3.9
55051,3/1/19,2533,2340,193,7.6
55053,3/1/19,10118,9587,531,5.2
55055,3/1/19,45763,44047,1716,3.7
55057,3/1/19,13282,12720,562,4.2
55059,3/1/19,89209,85294,3915,4.4
55061,3/1/19,10930,10513,417,3.8
55063,3/1/19,66846,64648,2198,3.3
55065,3/1/19,9940,9609,331,3.3
55067,3/1/19,9337,8858,479,5.1
55069,3/1/19,15022,14334,688,4.6
55071,3/1/19,40996,39383,1613,3.9
55073,3/1/19,73431,71007,2424,3.3
55075,3/1/19,19403,18406,997,5.1
55077,3/1/19,7636,7202,434,5.7
55078,3/1/19,1579,1476,103,6.5
55079,3/1/19,467459,448249,19210,4.1
55081,3/1/19,23194,22330,864,3.7
55083,3/1/19,20529,19593,936,4.6
55085,3/1/19,17550,16572,978,5.6
55087,3/1/19,103026,99575,3451,3.3
55089,3/1/19,48871,47377,1494,3.1
55091,3/1/19,4051,3855,196,4.8
55093,3/1/19,25229,24152,1077,4.3
55095,3/1/19,24540,23158,1382,5.6
55097,3/1/19,39011,37472,1539,3.9
55099,3/1/19,6409,6091,318,5
55101,3/1/19,98748,94253,4495,4.6
55103,3/1/19,9168,8791,377,4.1
55105,3/1/19,85227,81703,3524,4.1
55107,3/1/19,6687,6239,448,6.7
55109,3/1/19,50203,48148,2055,4.1
55111,3/1/19,34909,33681,1228,3.5
55113,3/1/19,7599,7117,482,6.3
55115,3/1/19,20740,19935,805,3.9
55117,3/1/19,61845,59994,1851,3
55119,3/1/19,10856,10294,562,5.2
55121,3/1/19,15963,15166,797,5
55123,3/1/19,15201,14539,662,4.4
55125,3/1/19,9518,8957,561,5.9
55127,3/1/19,57469,55282,2187,3.8
55129,3/1/19,7620,7222,398,5.2
55131,3/1/19,77255,74821,2434,3.2
55133,3/1/19,224990,217914,7076,3.1
55135,3/1/19,25944,24952,992,3.8
55137,3/1/19,11534,10935,599,5.2
55139,3/1/19,91766,88893,2873,3.1
55141,3/1/19,34899,33210,1689,4.8
56001,3/1/19,20725,20104,621,3
56003,3/1/19,5005,4766,239,4.8
56005,3/1/19,23170,22333,837,3.6
56007,3/1/19,7547,7262,285,3.8
56009,3/1/19,8407,8173,234,2.8
56011,3/1/19,3510,3359,151,4.3
56013,3/1/19,18626,17728,898,4.8
56015,3/1/19,6476,6237,239,3.7
56017,3/1/19,2195,2112,83,3.8
56019,3/1/19,4032,3843,189,4.7
56021,3/1/19,48713,46918,1795,3.7
56023,3/1/19,8761,8442,319,3.6
56025,3/1/19,39514,37881,1633,4.1
56027,3/1/19,1199,1163,36,3
56029,3/1/19,14359,13630,729,5.1
56031,3/1/19,4752,4588,164,3.5
56033,3/1/19,15563,14929,634,4.1
56035,3/1/19,3935,3743,192,4.9
56037,3/1/19,21629,20751,878,4.1
56039,3/1/19,14898,14539,359,2.4
56041,3/1/19,9099,8733,366,4
56043,3/1/19,3906,3704,202,5.2
56045,3/1/19,3783,3655,128,3.4
72001,3/1/19,4240,3396,844,19.9
72003,3/1/19,11890,10464,1426,12
72005,3/1/19,14359,12758,1601,11.1
72007,3/1/19,6392,5752,640,10
72009,3/1/19,6382,5599,783,12.3
72011,3/1/19,8705,7890,815,9.4
72013,3/1/19,23476,21013,2463,10.5
72015,3/1/19,4704,3982,722,15.3
72017,3/1/19,5816,5091,725,12.5
72019,3/1/19,7170,6498,672,9.4
72021,3/1/19,63541,59292,4249,6.7
72023,3/1/19,13331,12029,1302,9.8
72025,3/1/19,46683,43156,3527,7.6
72027,3/1/19,9302,8447,855,9.2
72029,3/1/19,15633,14511,1122,7.2
72031,3/1/19,59830,56070,3760,6.3
72033,3/1/19,7635,7048,587,7.7
72035,3/1/19,15718,14530,1188,7.6
72037,3/1/19,3676,3234,442,12
72039,3/1/19,3586,3192,394,11
72041,3/1/19,15199,13990,1209,8
72043,3/1/19,9890,8520,1370,13.9
72045,3/1/19,4793,4314,479,10
72047,3/1/19,8755,7879,876,10
72049,3/1/19,900,874,26,2.9
72051,3/1/19,12798,12023,775,6.1
72053,3/1/19,10870,9513,1357,12.5
72054,3/1/19,3280,2867,413,12.6
72055,3/1/19,3885,3266,619,15.9
72057,3/1/19,11001,9570,1431,13
72059,3/1/19,4873,4079,794,16.3
72061,3/1/19,36571,34960,1611,4.4
72063,3/1/19,17592,16499,1093,6.2
72065,3/1/19,13629,11531,2098,15.4
72067,3/1/19,5280,4780,500,9.5
72069,3/1/19,16935,14948,1987,11.7
72071,3/1/19,12156,10936,1220,10
72073,3/1/19,4292,3530,762,17.8
72075,3/1/19,14783,13169,1614,10.9
72077,3/1/19,11968,10883,1085,9.1
72079,3/1/19,5123,4387,736,14.4
72081,3/1/19,6897,5627,1270,18.4
72083,3/1/19,2718,2329,389,14.3
72085,3/1/19,11000,9960,1040,9.5
72087,3/1/19,8166,7531,635,7.8
72089,3/1/19,6079,5441,638,10.5
72091,3/1/19,11301,10327,974,8.6
72093,3/1/19,1927,1607,320,16.6
72095,3/1/19,3016,2431,585,19.4
72097,3/1/19,21533,19022,2511,11.7
72099,3/1/19,10384,9151,1233,11.9
72101,3/1/19,7761,7010,751,9.7
72103,3/1/19,7965,7182,783,9.8
72105,3/1/19,6870,6269,601,8.7
72107,3/1/19,4899,4312,587,12
72109,3/1/19,4495,3601,894,19.9
72111,3/1/19,5825,4939,886,15.2
72113,3/1/19,44991,40112,4879,10.8
72115,3/1/19,6045,5217,828,13.7
72117,3/1/19,4899,4015,884,18
72119,3/1/19,16559,15181,1378,8.3
72121,3/1/19,6096,5210,886,14.5
72123,3/1/19,7049,5985,1064,15.1
72125,3/1/19,9646,8381,1265,13.1
72127,3/1/19,130586,122897,7689,5.9
72129,3/1/19,11444,10327,1117,9.8
72131,3/1/19,10340,8626,1714,16.6
72133,3/1/19,9345,8419,926,9.9
72135,3/1/19,26339,24752,1587,6
72137,3/1/19,28380,26639,1741,6.1
72139,3/1/19,26345,24932,1413,5.4
72141,3/1/19,6578,5758,820,12.5
72143,3/1/19,9458,8643,815,8.6
72145,3/1/19,12943,11610,1333,10.3
72147,3/1/19,2677,2449,228,8.5
72149,3/1/19,7630,6133,1497,19.6
72151,3/1/19,8680,7439,1241,14.3
72153,3/1/19,9837,8152,1685,17.1
1001,4/1/19,26165,25552,613,2.3
1003,4/1/19,97486,95092,2394,2.5
1005,4/1/19,8428,8152,276,3.3
1007,4/1/19,8650,8403,247,2.9
1009,4/1/19,25198,24614,584,2.3
1011,4/1/19,4816,4678,138,2.9
1013,4/1/19,9280,8983,297,3.2
1015,4/1/19,45910,44474,1436,3.1
1017,4/1/19,15675,15267,408,2.6
1019,4/1/19,11585,11297,288,2.5
1021,4/1/19,19715,19249,466,2.4
1023,4/1/19,4774,4587,187,3.9
1025,4/1/19,7564,7207,357,4.7
1027,4/1/19,6070,5912,158,2.6
1029,4/1/19,5783,5611,172,3
1031,4/1/19,21451,20888,563,2.6
1033,4/1/19,23684,22915,769,3.2
1035,4/1/19,4543,4375,168,3.7
1037,4/1/19,4532,4411,121,2.7
1039,4/1/19,15668,15144,524,3.3
1041,4/1/19,6528,6365,163,2.5
1043,4/1/19,38613,37710,903,2.3
1045,4/1/19,20630,20055,575,2.8
1047,4/1/19,14779,14104,675,4.6
1049,4/1/19,31021,30258,763,2.5
1051,4/1/19,37567,36721,846,2.3
1053,4/1/19,14746,14284,462,3.1
1055,4/1/19,42464,41220,1244,2.9
1057,4/1/19,6568,6387,181,2.8
1059,4/1/19,14628,14280,348,2.4
1061,4/1/19,10991,10702,289,2.6
1063,4/1/19,2893,2747,146,5
1065,4/1/19,6112,5904,208,3.4
1067,4/1/19,6907,6683,224,3.2
1069,4/1/19,45955,44735,1220,2.7
1071,4/1/19,23625,22936,689,2.9
1073,4/1/19,317025,309107,7918,2.5
1075,4/1/19,5813,5651,162,2.8
1077,4/1/19,42602,41433,1169,2.7
1079,4/1/19,14262,13872,390,2.7
1081,4/1/19,76111,74342,1769,2.3
1083,4/1/19,43741,42718,1023,2.3
1085,4/1/19,3581,3396,185,5.2
1087,4/1/19,7822,7545,277,3.5
1089,4/1/19,184753,180583,4170,2.3
1091,4/1/19,7703,7478,225,2.9
1093,4/1/19,12977,12573,404,3.1
1095,4/1/19,44001,43046,955,2.2
1097,4/1/19,188444,182200,6244,3.3
1099,4/1/19,7260,6942,318,4.4
1101,4/1/19,105822,102906,2916,2.8
1103,4/1/19,58130,56825,1305,2.2
1105,4/1/19,3427,3281,146,4.3
1107,4/1/19,7917,7681,236,3
1109,4/1/19,15437,15016,421,2.7
1111,4/1/19,9586,9327,259,2.7
1113,4/1/19,23963,23336,627,2.6
1115,4/1/19,40355,39371,984,2.4
1117,4/1/19,115424,113210,2214,1.9
1119,4/1/19,4881,4698,183,3.7
1121,4/1/19,35673,34605,1068,3
1123,4/1/19,18718,18224,494,2.6
1125,4/1/19,104987,102590,2397,2.3
1127,4/1/19,25188,24473,715,2.8
1129,4/1/19,6739,6473,266,3.9
1131,4/1/19,2720,2570,150,5.5
1133,4/1/19,9926,9628,298,3
2013,4/1/19,2283,2218,65,2.8
2016,4/1/19,3894,3778,116,3
2020,4/1/19,146540,139189,7351,5
2050,4/1/19,6870,5938,932,13.6
2060,4/1/19,403,375,28,6.9
2068,4/1/19,668,564,104,15.6
2070,4/1/19,1838,1674,164,8.9
2090,4/1/19,44495,42006,2489,5.6
2100,4/1/19,1006,919,87,8.6
2105,4/1/19,1051,909,142,13.5
2110,4/1/19,16699,15935,764,4.6
2122,4/1/19,25259,23465,1794,7.1
2130,4/1/19,6452,6014,438,6.8
2150,4/1/19,5657,5361,296,5.2
2158,4/1/19,2658,2113,545,20.5
2164,4/1/19,625,548,77,12.3
2170,4/1/19,46945,43613,3332,7.1
2180,4/1/19,3984,3521,463,11.6
2185,4/1/19,3579,3364,215,6
2188,4/1/19,2849,2440,409,14.4
2195,4/1/19,1311,1196,115,8.8
2198,4/1/19,2854,2543,311,10.9
2220,4/1/19,4156,3985,171,4.1
2230,4/1/19,660,583,77,11.7
2240,4/1/19,2733,2469,264,9.7
2261,4/1/19,4407,4036,371,8.4
2275,4/1/19,995,919,76,7.6
2282,4/1/19,248,233,15,6
2290,4/1/19,2497,2102,395,15.8
4001,4/1/19,20328,18506,1822,9
4003,4/1/19,49838,46997,2841,5.7
4005,4/1/19,77030,73162,3868,5
4007,4/1/19,21497,20348,1149,5.3
4009,4/1/19,15463,14763,700,4.5
4011,4/1/19,4465,4295,170,3.8
4012,4/1/19,9002,8449,553,6.1
4013,4/1/19,2278530,2190089,88441,3.9
4015,4/1/19,87171,82385,4786,5.5
4017,4/1/19,40430,37578,2852,7.1
4019,4/1/19,494965,474088,20877,4.2
4021,4/1/19,184305,175593,8712,4.7
4023,4/1/19,19289,17975,1314,6.8
4025,4/1/19,105871,101287,4584,4.3
4027,4/1/19,96456,82008,14448,15
5001,4/1/19,9411,9156,255,2.7
5003,4/1/19,7849,7460,389,5
5005,4/1/19,16242,15685,557,3.4
5007,4/1/19,136235,133186,3049,2.2
5009,4/1/19,16074,15643,431,2.7
5011,4/1/19,4464,4287,177,4
5013,4/1/19,2460,2355,105,4.3
5015,4/1/19,12692,12349,343,2.7
5017,4/1/19,3262,3040,222,6.8
5019,4/1/19,9791,9449,342,3.5
5021,4/1/19,5692,5451,241,4.2
5023,4/1/19,9189,8840,349,3.8
5025,4/1/19,3212,3101,111,3.5
5027,4/1/19,9160,8821,339,3.7
5029,4/1/19,8289,7954,335,4
5031,4/1/19,55205,53901,1304,2.4
5033,4/1/19,26810,26061,749,2.8
5035,4/1/19,21202,20413,789,3.7
5037,4/1/19,7331,7053,278,3.8
5039,4/1/19,2823,2711,112,4
5041,4/1/19,5384,5170,214,4
5043,4/1/19,7883,7504,379,4.8
5045,4/1/19,62433,60841,1592,2.5
5047,4/1/19,7496,7292,204,2.7
5049,4/1/19,4882,4707,175,3.6
5051,4/1/19,41662,40393,1269,3
5053,4/1/19,8392,8173,219,2.6
5055,4/1/19,19996,19438,558,2.8
5057,4/1/19,10045,9686,359,3.6
5059,4/1/19,14030,13599,431,3.1
5061,4/1/19,5665,5511,154,2.7
5063,4/1/19,16724,16189,535,3.2
5065,4/1/19,4945,4699,246,5
5067,4/1/19,5787,5468,319,5.5
5069,4/1/19,27653,26334,1319,4.8
5071,4/1/19,10319,9909,410,4
5073,4/1/19,2488,2391,97,3.9
5075,4/1/19,6894,6659,235,3.4
5077,4/1/19,2805,2707,98,3.5
5079,4/1/19,3940,3786,154,3.9
5081,4/1/19,5475,5277,198,3.6
5083,4/1/19,8498,8203,295,3.5
5085,4/1/19,34381,33502,879,2.6
5087,4/1/19,7362,7205,157,2.1
5089,4/1/19,6668,6433,235,3.5
5091,4/1/19,19637,18926,711,3.6
5093,4/1/19,17344,16642,702,4
5095,4/1/19,2750,2653,97,3.5
5097,4/1/19,2971,2849,122,4.1
5099,4/1/19,3704,3562,142,3.8
5101,4/1/19,3341,3237,104,3.1
5103,4/1/19,9865,9381,484,4.9
5105,4/1/19,4277,4115,162,3.8
5107,4/1/19,6405,6082,323,5
5109,4/1/19,4257,4123,134,3.1
5111,4/1/19,10159,9886,273,2.7
5113,4/1/19,8069,7800,269,3.3
5115,4/1/19,28848,27830,1018,3.5
5117,4/1/19,3576,3446,130,3.6
5119,4/1/19,190303,184689,5614,3
5121,4/1/19,7218,6980,238,3.3
5123,4/1/19,8179,7789,390,4.8
5125,4/1/19,59112,57732,1380,2.3
5127,4/1/19,4310,4192,118,2.7
5129,4/1/19,2884,2772,112,3.9
5131,4/1/19,56458,54916,1542,2.7
5133,4/1/19,5371,5142,229,4.3
5135,4/1/19,5728,5507,221,3.9
5137,4/1/19,4749,4551,198,4.2
5139,4/1/19,15890,15174,716,4.5
5141,4/1/19,5733,5488,245,4.3
5143,4/1/19,124069,121523,2546,2.1
5145,4/1/19,33938,32530,1408,4.1
5147,4/1/19,2760,2622,138,5
5149,4/1/19,8402,8129,273,3.2
6001,4/1/19,836116,813944,22172,2.7
6003,4/1/19,585,562,23,3.9
6005,4/1/19,14788,14237,551,3.7
6007,4/1/19,99475,94459,5016,5
6009,4/1/19,21031,20254,777,3.7
6011,4/1/19,11215,9515,1700,15.2
6013,4/1/19,556190,540519,15671,2.8
6015,4/1/19,9546,9022,524,5.5
6017,4/1/19,91057,87961,3096,3.4
6019,4/1/19,450096,416012,34084,7.6
6021,4/1/19,12917,12090,827,6.4
6023,4/1/19,62367,60181,2186,3.5
6025,4/1/19,69023,58205,10818,15.7
6027,4/1/19,8620,8315,305,3.5
6029,4/1/19,385375,353847,31528,8.2
6031,4/1/19,57420,52653,4767,8.3
6033,4/1/19,29227,27770,1457,5
6035,4/1/19,9598,9113,485,5.1
6037,4/1/19,5077081,4871199,205882,4.1
6039,4/1/19,60745,56244,4501,7.4
6041,4/1/19,137964,135091,2873,2.1
6043,4/1/19,7413,7056,357,4.8
6045,4/1/19,38879,37296,1583,4.1
6047,4/1/19,115884,105832,10052,8.7
6049,4/1/19,3100,2856,244,7.9
6051,4/1/19,8574,8308,266,3.1
6053,4/1/19,223890,208037,15853,7.1
6055,4/1/19,72570,70626,1944,2.7
6057,4/1/19,48395,46833,1562,3.2
6059,4/1/19,1610768,1570230,40538,2.5
6061,4/1/19,185907,180471,5436,2.9
6063,4/1/19,7633,6891,742,9.7
6065,4/1/19,1092375,1051568,40807,3.7
6067,4/1/19,704395,680307,24088,3.4
6069,4/1/19,31245,29635,1610,5.2
6071,4/1/19,958520,925304,33216,3.5
6073,4/1/19,1575313,1529646,45667,2.9
6075,4/1/19,575479,563830,11649,2
6077,4/1/19,322796,303942,18854,5.8
6079,4/1/19,141284,137629,3655,2.6
6081,4/1/19,453760,445392,8368,1.8
6083,4/1/19,218241,210771,7470,3.4
6085,4/1/19,1041330,1017871,23459,2.3
6087,4/1/19,144070,136409,7661,5.3
6089,4/1/19,73500,70034,3466,4.7
6091,4/1/19,1272,1191,81,6.4
6093,4/1/19,16838,15619,1219,7.2
6095,4/1/19,208300,200906,7394,3.5
6097,4/1/19,255223,248770,6453,2.5
6099,4/1/19,241563,226701,14862,6.2
6101,4/1/19,44925,41159,3766,8.4
6103,4/1/19,25244,23806,1438,5.7
6105,4/1/19,4632,4357,275,5.9
6107,4/1/19,204753,184536,20217,9.9
6109,4/1/19,21087,20127,960,4.6
6111,4/1/19,422466,409159,13307,3.1
6113,4/1/19,107518,103319,4199,3.9
6115,4/1/19,29354,27536,1818,6.2
8001,4/1/19,271747,263759,7988,2.9
8003,4/1/19,8633,8324,309,3.6
8005,4/1/19,363724,353930,9794,2.7
8007,4/1/19,6689,6469,220,3.3
8009,4/1/19,2156,2121,35,1.6
8011,4/1/19,1898,1841,57,3
8013,4/1/19,195703,191068,4635,2.4
8014,4/1/19,39978,38993,985,2.5
8015,4/1/19,9518,9283,235,2.5
8017,4/1/19,1144,1125,19,1.7
8019,4/1/19,6016,5885,131,2.2
8021,4/1/19,4114,3961,153,3.7
8023,4/1/19,1827,1746,81,4.4
8025,4/1/19,1500,1436,64,4.3
8027,4/1/19,2033,1975,58,2.9
8029,4/1/19,14156,13659,497,3.5
8031,4/1/19,415838,404639,11199,2.7
8033,4/1/19,1114,1079,35,3.1
8035,4/1/19,193743,189063,4680,2.4
8037,4/1/19,36725,35936,789,2.1
8039,4/1/19,15136,14802,334,2.2
8041,4/1/19,338947,327814,11133,3.3
8043,4/1/19,14998,14317,681,4.5
8045,4/1/19,32613,31750,863,2.6
8047,4/1/19,3776,3686,90,2.4
8049,4/1/19,9514,9304,210,2.2
8051,4/1/19,10969,10702,267,2.4
8053,4/1/19,395,381,14,3.5
8055,4/1/19,2503,2354,149,6
8057,4/1/19,939,918,21,2.2
8059,4/1/19,334456,325894,8562,2.6
8061,4/1/19,940,925,15,1.6
8063,4/1/19,4229,4165,64,1.5
8065,4/1/19,4943,4842,101,2
8067,4/1/19,31651,30815,836,2.6
8069,4/1/19,204209,199365,4844,2.4
8071,4/1/19,6582,6333,249,3.8
8073,4/1/19,2384,2329,55,2.3
8075,4/1/19,11131,10863,268,2.4
8077,4/1/19,76505,73976,2529,3.3
8079,4/1/19,555,538,17,3.1
8081,4/1/19,7352,7056,296,4
8083,4/1/19,12687,12119,568,4.5
8085,4/1/19,21575,20895,680,3.2
8087,4/1/19,16342,15917,425,2.6
8089,4/1/19,8348,8012,336,4
8091,4/1/19,2223,2151,72,3.2
8093,4/1/19,11185,10887,298,2.7
8095,4/1/19,2543,2502,41,1.6
8097,4/1/19,11237,10964,273,2.4
8099,4/1/19,6302,6145,157,2.5
8101,4/1/19,75861,72777,3084,4.1
8103,4/1/19,3000,2885,115,3.8
8105,4/1/19,5283,5079,204,3.9
8107,4/1/19,16036,15673,363,2.3
8109,4/1/19,3514,3387,127,3.6
8111,4/1/19,450,431,19,4.2
8113,4/1/19,5582,5442,140,2.5
8115,4/1/19,1196,1173,23,1.9
8117,4/1/19,23159,22779,380,1.6
8119,4/1/19,12700,12309,391,3.1
8121,4/1/19,3015,2957,58,1.9
8123,4/1/19,167964,163703,4261,2.5
8125,4/1/19,6370,6271,99,1.6
9001,4/1/19,472697,457885,14812,3.1
9003,4/1/19,478319,460950,17369,3.6
9005,4/1/19,103111,99881,3230,3.1
9007,4/1/19,92458,89881,2577,2.8
9009,4/1/19,455579,439833,15746,3.5
9011,4/1/19,135095,130821,4274,3.2
9013,4/1/19,85944,83543,2401,2.8
9015,4/1/19,63239,61014,2225,3.5
10001,4/1/19,79157,76232,2925,3.7
10003,4/1/19,302106,292119,9987,3.3
10005,4/1/19,104849,100878,3971,3.8
11001,4/1/19,409186,388445,20741,5.1
12001,4/1/19,139177,135464,3713,2.7
12003,4/1/19,11585,11248,337,2.9
12005,4/1/19,83485,80299,3186,3.8
12007,4/1/19,10854,10536,318,2.9
12009,4/1/19,279366,270907,8459,3
12011,4/1/19,1026061,996914,29147,2.8
12013,4/1/19,4805,4620,185,3.9
12015,4/1/19,71379,68927,2452,3.4
12017,4/1/19,46966,44851,2115,4.5
12019,4/1/19,105301,102324,2977,2.8
12021,4/1/19,181382,176487,4895,2.7
12023,4/1/19,29227,28345,882,3
12027,4/1/19,14475,14025,450,3.1
12029,4/1/19,5763,5563,200,3.5
12031,4/1/19,480785,466249,14536,3
12033,4/1/19,144438,140183,4255,2.9
12035,4/1/19,46561,44915,1646,3.5
12037,4/1/19,4678,4516,162,3.5
12039,4/1/19,18733,18027,706,3.8
12041,4/1/19,7100,6873,227,3.2
12043,4/1/19,5601,5406,195,3.5
12045,4/1/19,5730,5449,281,4.9
12047,4/1/19,4260,4101,159,3.7
12049,4/1/19,8541,8166,375,4.4
12051,4/1/19,15678,15031,647,4.1
12053,4/1/19,70671,67903,2768,3.9
12055,4/1/19,36077,34583,1494,4.1
12057,4/1/19,738205,716904,21301,2.9
12059,4/1/19,6887,6658,229,3.3
12061,4/1/19,65229,62939,2290,3.5
12063,4/1/19,17154,16565,589,3.4
12065,4/1/19,5615,5436,179,3.2
12067,4/1/19,2857,2778,79,2.8
12069,4/1/19,157046,152328,4718,3
12071,4/1/19,345821,335701,10120,2.9
12073,4/1/19,155019,150735,4284,2.8
12075,4/1/19,16642,16052,590,3.5
12077,4/1/19,2642,2550,92,3.5
12079,4/1/19,7393,7139,254,3.4
12081,4/1/19,178942,173808,5134,2.9
12083,4/1/19,135997,131083,4914,3.6
12085,4/1/19,73573,71430,2143,2.9
12086,4/1/19,1383594,1349404,34190,2.5
12087,4/1/19,46585,45680,905,1.9
12089,4/1/19,40316,39207,1109,2.8
12091,4/1/19,95661,93230,2431,2.5
12093,4/1/19,17727,17157,570,3.2
12095,4/1/19,751828,731497,20331,2.7
12097,4/1/19,181527,176042,5485,3
12099,4/1/19,729531,707987,21544,3
12101,4/1/19,234114,226416,7698,3.3
12103,4/1/19,486421,472664,13757,2.8
12105,4/1/19,301351,291121,10230,3.4
12107,4/1/19,26585,25519,1066,4
12109,4/1/19,129763,126559,3204,2.5
12111,4/1/19,143913,138703,5210,3.6
12113,4/1/19,81953,79710,2243,2.7
12115,4/1/19,188043,182558,5485,2.9
12117,4/1/19,251909,245073,6836,2.7
12119,4/1/19,32397,30958,1439,4.4
12121,4/1/19,17903,17342,561,3.1
12123,4/1/19,8202,7921,281,3.4
12125,4/1/19,4644,4520,124,2.7
12127,4/1/19,252062,243940,8122,3.2
12129,4/1/19,14874,14470,404,2.7
12131,4/1/19,31181,30341,840,2.7
12133,4/1/19,9604,9295,309,3.2
13001,4/1/19,9117,8809,308,3.4
13003,4/1/19,4702,4575,127,2.7
13005,4/1/19,5029,4881,148,2.9
13007,4/1/19,1164,1113,51,4.4
13009,4/1/19,17415,16762,653,3.7
13011,4/1/19,9613,9365,248,2.6
13013,4/1/19,39906,38857,1049,2.6
13015,4/1/19,49873,48409,1464,2.9
13017,4/1/19,5290,5047,243,4.6
13019,4/1/19,7477,7236,241,3.2
13021,4/1/19,67306,64891,2415,3.6
13023,4/1/19,4585,4385,200,4.4
13025,4/1/19,7240,6980,260,3.6
13027,4/1/19,6884,6679,205,3
13029,4/1/19,18216,17732,484,2.7
13031,4/1/19,36686,35495,1191,3.2
13033,4/1/19,9193,8779,414,4.5
13035,4/1/19,10608,10274,334,3.1
13037,4/1/19,2214,2136,78,3.5
13039,4/1/19,20732,20049,683,3.3
13043,4/1/19,5453,5311,142,2.6
13045,4/1/19,54521,52824,1697,3.1
13047,4/1/19,33380,32389,991,3
13049,4/1/19,4741,4576,165,3.5
13051,4/1/19,139101,134970,4131,3
13053,4/1/19,1994,1912,82,4.1
13055,4/1/19,10157,9805,352,3.5
13057,4/1/19,134227,130840,3387,2.5
13059,4/1/19,59148,57260,1888,3.2
13061,4/1/19,875,824,51,5.8
13063,4/1/19,135943,130647,5296,3.9
13065,4/1/19,2822,2735,87,3.1
13067,4/1/19,420074,408547,11527,2.7
13069,4/1/19,18799,18132,667,3.5
13071,4/1/19,21387,20768,619,2.9
13073,4/1/19,75637,73582,2055,2.7
13075,4/1/19,7934,7699,235,3
13077,4/1/19,73702,71694,2008,2.7
13079,4/1/19,5559,5380,179,3.2
13081,4/1/19,9470,9111,359,3.8
13083,4/1/19,8170,7924,246,3
13085,4/1/19,12186,11867,319,2.6
13087,4/1/19,11636,11213,423,3.6
13089,4/1/19,394376,381841,12535,3.2
13091,4/1/19,7049,6702,347,4.9
13093,4/1/19,5036,4864,172,3.4
13095,4/1/19,38038,36423,1615,4.2
13097,4/1/19,72291,69939,2352,3.3
13099,4/1/19,4318,4166,152,3.5
13101,4/1/19,1908,1861,47,2.5
13103,4/1/19,30777,29979,798,2.6
13105,4/1/19,7570,7313,257,3.4
13107,4/1/19,8256,7901,355,4.3
13109,4/1/19,4786,4638,148,3.1
13111,4/1/19,11629,11295,334,2.9
13113,4/1/19,57267,55691,1576,2.8
13115,4/1/19,43598,42182,1416,3.2
13117,4/1/19,120589,117580,3009,2.5
13119,4/1/19,9947,9632,315,3.2
13121,4/1/19,550040,532292,17748,3.2
13123,4/1/19,11895,11527,368,3.1
13125,4/1/19,1278,1235,43,3.4
13127,4/1/19,39193,38034,1159,3
13129,4/1/19,27870,27092,778,2.8
13131,4/1/19,10451,10138,313,3
13133,4/1/19,6965,6728,237,3.4
13135,4/1/19,483745,470287,13458,2.8
13137,4/1/19,19104,18524,580,3
13139,4/1/19,100922,98303,2619,2.6
13141,4/1/19,2452,2330,122,5
13143,4/1/19,12398,12027,371,3
13145,4/1/19,16649,16183,466,2.8
13147,4/1/19,11493,11158,335,2.9
13149,4/1/19,5187,5027,160,3.1
13151,4/1/19,114039,110250,3789,3.3
13153,4/1/19,69819,67657,2162,3.1
13155,4/1/19,3306,3173,133,4
13157,4/1/19,36020,35102,918,2.5
13159,4/1/19,6863,6667,196,2.9
13161,4/1/19,6021,5783,238,4
13163,4/1/19,6472,6211,261,4
13165,4/1/19,3147,3009,138,4.4
13167,4/1/19,4066,3928,138,3.4
13169,4/1/19,13583,13198,385,2.8
13171,4/1/19,8127,7840,287,3.5
13173,4/1/19,3733,3596,137,3.7
13175,4/1/19,19217,18452,765,4
13177,4/1/19,14635,14236,399,2.7
13179,4/1/19,25849,25012,837,3.2
13181,4/1/19,3576,3454,122,3.4
13183,4/1/19,8086,7822,264,3.3
13185,4/1/19,50845,49248,1597,3.1
13187,4/1/19,16566,16103,463,2.8
13189,4/1/19,8853,8485,368,4.2
13191,4/1/19,6158,5956,202,3.3
13193,4/1/19,4706,4510,196,4.2
13195,4/1/19,13300,12941,359,2.7
13197,4/1/19,3301,3175,126,3.8
13199,4/1/19,8809,8438,371,4.2
13201,4/1/19,2756,2675,81,2.9
13205,4/1/19,8298,7976,322,3.9
13207,4/1/19,12906,12519,387,3
13209,4/1/19,3801,3624,177,4.7
13211,4/1/19,9144,8887,257,2.8
13213,4/1/19,15432,14762,670,4.3
13215,4/1/19,77313,74149,3164,4.1
13217,4/1/19,51535,49695,1840,3.6
13219,4/1/19,19565,19107,458,2.3
13221,4/1/19,6945,6742,203,2.9
13223,4/1/19,84833,82565,2268,2.7
13225,4/1/19,11730,11305,425,3.6
13227,4/1/19,15072,14669,403,2.7
13229,4/1/19,8660,8382,278,3.2
13231,4/1/19,8795,8553,242,2.8
13233,4/1/19,18345,17766,579,3.2
13235,4/1/19,4030,3884,146,3.6
13237,4/1/19,8151,7825,326,4
13239,4/1/19,802,762,40,5
13241,4/1/19,7099,6866,233,3.3
13243,4/1/19,2519,2412,107,4.2
13245,4/1/19,85485,82034,3451,4
13247,4/1/19,44195,42635,1560,3.5
13249,4/1/19,2197,2122,75,3.4
13251,4/1/19,5059,4837,222,4.4
13253,4/1/19,3045,2924,121,4
13255,4/1/19,28331,27263,1068,3.8
13257,4/1/19,10648,10280,368,3.5
13259,4/1/19,2380,2290,90,3.8
13261,4/1/19,12653,12116,537,4.2
13263,4/1/19,2813,2693,120,4.3
13265,4/1/19,563,538,25,4.4
13267,4/1/19,9454,9122,332,3.5
13269,4/1/19,2979,2874,105,3.5
13271,4/1/19,4290,3919,371,8.6
13273,4/1/19,3495,3327,168,4.8
13275,4/1/19,16292,15707,585,3.6
13277,4/1/19,19530,18957,573,2.9
13279,4/1/19,11644,11128,516,4.4
13281,4/1/19,3910,3745,165,4.2
13283,4/1/19,2670,2558,112,4.2
13285,4/1/19,36956,35875,1081,2.9
13287,4/1/19,3133,3026,107,3.4
13289,4/1/19,2838,2705,133,4.7
13291,4/1/19,10348,10052,296,2.9
13293,4/1/19,11254,10891,363,3.2
13295,4/1/19,31190,30130,1060,3.4
13297,4/1/19,45448,44159,1289,2.8
13299,4/1/19,15447,14940,507,3.3
13301,4/1/19,2780,2672,108,3.9
13303,4/1/19,7007,6739,268,3.8
13305,4/1/19,11487,11083,404,3.5
13307,4/1/19,1006,960,46,4.6
13309,4/1/19,1628,1528,100,6.1
13311,4/1/19,16075,15678,397,2.5
13313,4/1/19,43500,41730,1770,4.1
13315,4/1/19,2690,2578,112,4.2
13317,4/1/19,3801,3650,151,4
13319,4/1/19,3873,3743,130,3.4
13321,4/1/19,8835,8542,293,3.3
15001,4/1/19,91024,87954,3070,3.4
15003,4/1/19,449581,438526,11055,2.5
15007,4/1/19,36262,35336,926,2.6
15009,4/1/19,86343,84170,2173,2.5
16001,4/1/19,251331,245266,6065,2.4
16003,4/1/19,1668,1494,174,10.4
16005,4/1/19,42992,41828,1164,2.7
16007,4/1/19,2942,2849,93,3.2
16009,4/1/19,4139,3753,386,9.3
16011,4/1/19,23775,23175,600,2.5
16013,4/1/19,11671,11304,367,3.1
16015,4/1/19,3499,3324,175,5
16017,4/1/19,19624,18632,992,5.1
16019,4/1/19,56035,54759,1276,2.3
16021,4/1/19,5441,5132,309,5.7
16023,4/1/19,1377,1343,34,2.5
16025,4/1/19,676,656,20,3
16027,4/1/19,102989,99816,3173,3.1
16029,4/1/19,4112,4004,108,2.6
16031,4/1/19,11957,11663,294,2.5
16033,4/1/19,368,357,11,3
16035,4/1/19,2945,2611,334,11.3
16037,4/1/19,2025,1920,105,5.2
16039,4/1/19,11340,10987,353,3.1
16041,4/1/19,7133,6956,177,2.5
16043,4/1/19,7916,7714,202,2.6
16045,4/1/19,8210,7939,271,3.3
16047,4/1/19,8173,7962,211,2.6
16049,4/1/19,6466,6116,350,5.4
16051,4/1/19,13794,13495,299,2.2
16053,4/1/19,12173,11863,310,2.5
16055,4/1/19,79261,76392,2869,3.6
16057,4/1/19,21144,20488,656,3.1
16059,4/1/19,3421,3227,194,5.7
16061,4/1/19,1654,1542,112,6.8
16063,4/1/19,2608,2499,109,4.2
16065,4/1/19,21911,21521,390,1.8
16067,4/1/19,11304,11020,284,2.5
16069,4/1/19,20990,20393,597,2.8
16071,4/1/19,2324,2258,66,2.8
16073,4/1/19,5393,5214,179,3.3
16075,4/1/19,11548,11158,390,3.4
16077,4/1/19,4131,4015,116,2.8
16079,4/1/19,5133,4774,359,7
16081,4/1/19,5968,5817,151,2.5
16083,4/1/19,40921,39816,1105,2.7
16085,4/1/19,5093,4832,261,5.1
16087,4/1/19,4541,4337,204,4.5
17001,4/1/19,32235,31276,959,3
17003,4/1/19,2035,1932,103,5.1
17005,4/1/19,7779,7518,261,3.4
17007,4/1/19,26036,24917,1119,4.3
17009,4/1/19,2967,2906,61,2.1
17011,4/1/19,17265,16583,682,4
17013,4/1/19,2323,2222,101,4.3
17015,4/1/19,7160,6898,262,3.7
17017,4/1/19,6115,5883,232,3.8
17019,4/1/19,111105,107452,3653,3.3
17021,4/1/19,14661,14058,603,4.1
17023,4/1/19,7652,7360,292,3.8
17025,4/1/19,6451,6194,257,4
17027,4/1/19,20422,19888,534,2.6
17029,4/1/19,24038,23200,838,3.5
17031,4/1/19,2580663,2486263,94400,3.7
17033,4/1/19,8614,8290,324,3.8
17035,4/1/19,6125,5941,184,3
17037,4/1/19,54811,52867,1944,3.5
17039,4/1/19,7586,7296,290,3.8
17041,4/1/19,10171,9870,301,3
17043,4/1/19,505311,490945,14366,2.8
17045,4/1/19,9076,8759,317,3.5
17047,4/1/19,2739,2638,101,3.7
17049,4/1/19,19199,18627,572,3
17051,4/1/19,10006,9624,382,3.8
17053,4/1/19,6556,6316,240,3.7
17055,4/1/19,16553,15769,784,4.7
17057,4/1/19,15166,14445,721,4.8
17059,4/1/19,2388,2283,105,4.4
17061,4/1/19,6015,5790,225,3.7
17063,4/1/19,25271,24196,1075,4.3
17065,4/1/19,4450,4296,154,3.5
17067,4/1/19,8356,8027,329,3.9
17069,4/1/19,1306,1236,70,5.4
17071,4/1/19,3620,3472,148,4.1
17073,4/1/19,24911,23853,1058,4.2
17075,4/1/19,14280,13764,516,3.6
17077,4/1/19,28428,27518,910,3.2
17079,4/1/19,4666,4501,165,3.5
17081,4/1/19,17479,16788,691,4
17083,4/1/19,10979,10552,427,3.9
17085,4/1/19,10654,10252,402,3.8
17087,4/1/19,4224,4011,213,5
17089,4/1/19,271707,261009,10698,3.9
17091,4/1/19,55298,52876,2422,4.4
17093,4/1/19,68249,66061,2188,3.2
17095,4/1/19,21819,20859,960,4.4
17097,4/1/19,373959,360111,13848,3.7
17099,4/1/19,54602,52011,2591,4.7
17101,4/1/19,5893,5641,252,4.3
17103,4/1/19,17566,16958,608,3.5
17105,4/1/19,16566,15962,604,3.6
17107,4/1/19,12946,12480,466,3.6
17109,4/1/19,13767,13278,489,3.6
17111,4/1/19,164764,159394,5370,3.3
17113,4/1/19,89846,86954,2892,3.2
17115,4/1/19,48864,46643,2221,4.5
17117,4/1/19,22963,22115,848,3.7
17119,4/1/19,134263,129758,4505,3.4
17121,4/1/19,17661,16989,672,3.8
17123,4/1/19,5313,5090,223,4.2
17125,4/1/19,6256,5971,285,4.6
17127,4/1/19,5535,5283,252,4.6
17129,4/1/19,6503,6286,217,3.3
17131,4/1/19,8056,7702,354,4.4
17133,4/1/19,18808,18315,493,2.6
17135,4/1/19,11791,11274,517,4.4
17137,4/1/19,16600,16034,566,3.4
17139,4/1/19,7560,7345,215,2.8
17141,4/1/19,25184,24139,1045,4.1
17143,4/1/19,84762,80995,3767,4.4
17145,4/1/19,8451,8074,377,4.5
17147,4/1/19,8767,8486,281,3.2
17149,4/1/19,7039,6771,268,3.8
17151,4/1/19,1703,1622,81,4.8
17153,4/1/19,1936,1821,115,5.9
17155,4/1/19,3052,2916,136,4.5
17157,4/1/19,14342,13909,433,3
17159,4/1/19,7263,6998,265,3.6
17161,4/1/19,71032,68006,3026,4.3
17163,4/1/19,126589,121747,4842,3.8
17165,4/1/19,9767,9320,447,4.6
17167,4/1/19,101104,97522,3582,3.5
17169,4/1/19,3316,3207,109,3.3
17171,4/1/19,2496,2401,95,3.8
17173,4/1/19,10646,10290,356,3.3
17175,4/1/19,2550,2396,154,6
17177,4/1/19,21672,20865,807,3.7
17179,4/1/19,63631,61250,2381,3.7
17181,4/1/19,7490,7128,362,4.8
17183,4/1/19,33138,31698,1440,4.3
17185,4/1/19,5742,5537,205,3.6
17187,4/1/19,8544,8241,303,3.5
17189,4/1/19,10211,9988,223,2.2
17191,4/1/19,6999,6687,312,4.5
17193,4/1/19,6717,6486,231,3.4
17195,4/1/19,28702,27704,998,3.5
17197,4/1/19,355276,342107,13169,3.7
17199,4/1/19,32541,31358,1183,3.6
17201,4/1/19,138790,132511,6279,4.5
17203,4/1/19,18734,18128,606,3.2
18001,4/1/19,16988,16621,367,2.2
18003,4/1/19,185773,181147,4626,2.5
18005,4/1/19,44676,43767,909,2
18007,4/1/19,4489,4371,118,2.6
18009,4/1/19,5018,4844,174,3.5
18011,4/1/19,36116,35366,750,2.1
18013,4/1/19,7674,7479,195,2.5
18015,4/1/19,10201,9916,285,2.8
18017,4/1/19,18201,17491,710,3.9
18019,4/1/19,61549,59759,1790,2.9
18021,4/1/19,12117,11756,361,3
18023,4/1/19,17018,16626,392,2.3
18025,4/1/19,4790,4624,166,3.5
18027,4/1/19,16390,16049,341,2.1
18029,4/1/19,25726,24980,746,2.9
18031,4/1/19,15180,14808,372,2.5
18033,4/1/19,22590,22093,497,2.2
18035,4/1/19,54445,52716,1729,3.2
18037,4/1/19,22805,22351,454,2
18039,4/1/19,113517,110720,2797,2.5
18041,4/1/19,8802,8464,338,3.8
18043,4/1/19,41517,40403,1114,2.7
18045,4/1/19,7922,7682,240,3
18047,4/1/19,11219,10899,320,2.9
18049,4/1/19,9629,9385,244,2.5
18051,4/1/19,19318,18919,399,2.1
18053,4/1/19,32481,31387,1094,3.4
18055,4/1/19,13625,13159,466,3.4
18057,4/1/19,183713,179742,3971,2.2
18059,4/1/19,40149,39176,973,2.4
18061,4/1/19,20253,19669,584,2.9
18063,4/1/19,89920,87884,2036,2.3
18065,4/1/19,21941,21301,640,2.9
18067,4/1/19,37534,35049,2485,6.6
18069,4/1/19,18294,17790,504,2.8
18071,4/1/19,22659,22146,513,2.3
18073,4/1/19,16218,15711,507,3.1
18075,4/1/19,9314,9068,246,2.6
18077,4/1/19,14969,14559,410,2.7
18079,4/1/19,13424,13060,364,2.7
18081,4/1/19,82760,80928,1832,2.2
18083,4/1/19,18228,17769,459,2.5
18085,4/1/19,42154,41230,924,2.2
18087,4/1/19,19750,19292,458,2.3
18089,4/1/19,232365,221866,10499,4.5
18091,4/1/19,47814,46026,1788,3.7
18093,4/1/19,21242,20606,636,3
18095,4/1/19,58948,57063,1885,3.2
18097,4/1/19,490350,476589,13761,2.8
18099,4/1/19,22949,22357,592,2.6
18101,4/1/19,5209,5089,120,2.3
18103,4/1/19,15735,14972,763,4.8
18105,4/1/19,71411,69562,1849,2.6
18107,4/1/19,18634,18166,468,2.5
18109,4/1/19,36228,35273,955,2.6
18111,4/1/19,6911,6673,238,3.4
18113,4/1/19,23525,22938,587,2.5
18115,4/1/19,3188,3093,95,3
18117,4/1/19,8373,8132,241,2.9
18119,4/1/19,9497,9182,315,3.3
18121,4/1/19,6975,6740,235,3.4
18123,4/1/19,9192,8951,241,2.6
18125,4/1/19,6029,5873,156,2.6
18127,4/1/19,87364,84552,2812,3.2
18129,4/1/19,13501,13204,297,2.2
18131,4/1/19,6454,6275,179,2.8
18133,4/1/19,16680,16186,494,3
18135,4/1/19,11181,10835,346,3.1
18137,4/1/19,14234,13857,377,2.6
18139,4/1/19,8838,8630,208,2.4
18141,4/1/19,136630,132583,4047,3
18143,4/1/19,10521,10199,322,3.1
18145,4/1/19,23065,22502,563,2.4
18147,4/1/19,10794,10532,262,2.4
18149,4/1/19,9894,9536,358,3.6
18151,4/1/19,20499,20051,448,2.2
18153,4/1/19,8420,8090,330,3.9
18155,4/1/19,4958,4820,138,2.8
18157,4/1/19,99690,97395,2295,2.3
18159,4/1/19,9404,9030,374,4
18161,4/1/19,3529,3431,98,2.8
18163,4/1/19,94396,92006,2390,2.5
18165,4/1/19,7019,6683,336,4.8
18167,4/1/19,48654,46874,1780,3.7
18169,4/1/19,15048,14651,397,2.6
18171,4/1/19,4169,4066,103,2.5
18173,4/1/19,32970,32197,773,2.3
18175,4/1/19,13494,13122,372,2.8
18177,4/1/19,30902,29965,937,3
18179,4/1/19,14338,14023,315,2.2
18181,4/1/19,13431,13126,305,2.3
18183,4/1/19,17752,17319,433,2.4
19001,4/1/19,4153,4057,96,2.3
19003,4/1/19,2170,2136,34,1.6
19005,4/1/19,7322,7050,272,3.7
19007,4/1/19,6010,5841,169,2.8
19009,4/1/19,3098,3030,68,2.2
19011,4/1/19,13585,13236,349,2.6
19013,4/1/19,70515,68531,1984,2.8
19015,4/1/19,15154,14836,318,2.1
19017,4/1/19,14050,13764,286,2
19019,4/1/19,11347,11064,283,2.5
19021,4/1/19,11672,11449,223,1.9
19023,4/1/19,7870,7620,250,3.2
19025,4/1/19,4231,4126,105,2.5
19027,4/1/19,10824,10641,183,1.7
19029,4/1/19,6953,6756,197,2.8
19031,4/1/19,10962,10744,218,2
19033,4/1/19,23688,23080,608,2.6
19035,4/1/19,6059,5935,124,2
19037,4/1/19,6513,6345,168,2.6
19039,4/1/19,4868,4727,141,2.9
19041,4/1/19,8452,8220,232,2.7
19043,4/1/19,10141,9791,350,3.5
19045,4/1/19,22912,22194,718,3.1
19047,4/1/19,8083,7814,269,3.3
19049,4/1/19,49972,49088,884,1.8
19051,4/1/19,4186,4105,81,1.9
19053,4/1/19,4452,4368,84,1.9
19055,4/1/19,10505,10286,219,2.1
19057,4/1/19,19597,18922,675,3.4
19059,4/1/19,9526,9242,284,3
19061,4/1/19,56738,55415,1323,2.3
19063,4/1/19,5153,5026,127,2.5
19065,4/1/19,10813,10444,369,3.4
19067,4/1/19,8907,8664,243,2.7
19069,4/1/19,5682,5543,139,2.4
19071,4/1/19,3633,3494,139,3.8
19073,4/1/19,5364,5227,137,2.6
19075,4/1/19,6518,6360,158,2.4
19077,4/1/19,5570,5403,167,3
19079,4/1/19,6932,6751,181,2.6
19081,4/1/19,5850,5717,133,2.3
19083,4/1/19,8034,7792,242,3
19085,4/1/19,7319,7147,172,2.4
19087,4/1/19,9981,9771,210,2.1
19089,4/1/19,5118,4960,158,3.1
19091,4/1/19,5065,4931,134,2.6
19093,4/1/19,4068,3993,75,1.8
19095,4/1/19,10462,10246,216,2.1
19097,4/1/19,11049,10710,339,3.1
19099,4/1/19,19881,19336,545,2.7
19101,4/1/19,10245,10038,207,2
19103,4/1/19,87903,86372,1531,1.7
19105,4/1/19,10732,10400,332,3.1
19107,4/1/19,5231,5083,148,2.8
19109,4/1/19,8309,8128,181,2.2
19111,4/1/19,16141,15557,584,3.6
19113,4/1/19,123945,120825,3120,2.5
19115,4/1/19,6007,5863,144,2.4
19117,4/1/19,4655,4578,77,1.7
19119,4/1/19,6942,6828,114,1.6
19121,4/1/19,8633,8313,320,3.7
19123,4/1/19,11897,11640,257,2.2
19125,4/1/19,18499,18137,362,2
19127,4/1/19,18058,17301,757,4.2
19129,4/1/19,7386,7217,169,2.3
19131,4/1/19,6505,6382,123,1.9
19133,4/1/19,4430,4314,116,2.6
19135,4/1/19,3957,3858,99,2.5
19137,4/1/19,5019,4902,117,2.3
19139,4/1/19,21981,21381,600,2.7
19141,4/1/19,8211,8050,161,2
19143,4/1/19,3497,3436,61,1.7
19145,4/1/19,6395,6249,146,2.3
19147,4/1/19,4759,4634,125,2.6
19149,4/1/19,14685,14433,252,1.7
19151,4/1/19,4123,4040,83,2
19153,4/1/19,272248,265026,7222,2.7
19155,4/1/19,48697,47647,1050,2.2
19157,4/1/19,10656,10401,255,2.4
19159,4/1/19,2409,2339,70,2.9
19161,4/1/19,5208,5090,118,2.3
19163,4/1/19,89756,87183,2573,2.9
19165,4/1/19,6631,6494,137,2.1
19167,4/1/19,20981,20593,388,1.8
19169,4/1/19,60566,59662,904,1.5
19171,4/1/19,9462,9213,249,2.6
19173,4/1/19,3177,3126,51,1.6
19175,4/1/19,6291,6109,182,2.9
19177,4/1/19,3665,3580,85,2.3
19179,4/1/19,17885,17330,555,3.1
19181,4/1/19,28581,27927,654,2.3
19183,4/1/19,12075,11809,266,2.2
19185,4/1/19,2794,2734,60,2.1
19187,4/1/19,19358,18782,576,3
19189,4/1/19,5028,4890,138,2.7
19191,4/1/19,12310,11964,346,2.8
19193,4/1/19,56004,54659,1345,2.4
19195,4/1/19,4112,4002,110,2.7
19197,4/1/19,7042,6873,169,2.4
20001,4/1/19,6511,6324,187,2.9
20003,4/1/19,4083,3964,119,2.9
20005,4/1/19,6738,6459,279,4.1
20007,4/1/19,2169,2123,46,2.1
20009,4/1/19,13438,13086,352,2.6
20011,4/1/19,6836,6567,269,3.9
20013,4/1/19,5180,5026,154,3
20015,4/1/19,32289,31370,919,2.8
20017,4/1/19,1472,1432,40,2.7
20019,4/1/19,1384,1332,52,3.8
20021,4/1/19,9997,9710,287,2.9
20023,4/1/19,1183,1153,30,2.5
20025,4/1/19,987,966,21,2.1
20027,4/1/19,3580,3480,100,2.8
20029,4/1/19,3672,3568,104,2.8
20031,4/1/19,3912,3757,155,4
20033,4/1/19,824,806,18,2.2
20035,4/1/19,16252,15771,481,3
20037,4/1/19,18666,18062,604,3.2
20039,4/1/19,1116,1085,31,2.8
20041,4/1/19,8747,8475,272,3.1
20043,4/1/19,4052,3922,130,3.2
20045,4/1/19,66701,65027,1674,2.5
20047,4/1/19,1376,1343,33,2.4
20049,4/1/19,1110,1073,37,3.3
20051,4/1/19,16831,16485,346,2.1
20053,4/1/19,2731,2658,73,2.7
20055,4/1/19,20199,19757,442,2.2
20057,4/1/19,16731,16349,382,2.3
20059,4/1/19,13835,13435,400,2.9
20061,4/1/19,11378,10948,430,3.8
20063,4/1/19,1360,1330,30,2.2
20065,4/1/19,1028,997,31,3
20067,4/1/19,3004,2925,79,2.6
20069,4/1/19,2960,2905,55,1.9
20071,4/1/19,733,718,15,2
20073,4/1/19,3185,3100,85,2.7
20075,4/1/19,1409,1384,25,1.8
20077,4/1/19,2945,2882,63,2.1
20079,4/1/19,16836,16411,425,2.5
20081,4/1/19,2033,1985,48,2.4
20083,4/1/19,875,856,19,2.2
20085,4/1/19,7077,6899,178,2.5
20087,4/1/19,9948,9681,267,2.7
20089,4/1/19,1236,1202,34,2.8
20091,4/1/19,336234,327900,8334,2.5
20093,4/1/19,1917,1874,43,2.2
20095,4/1/19,3298,3195,103,3.1
20097,4/1/19,1236,1209,27,2.2
20099,4/1/19,9943,9533,410,4.1
20101,4/1/19,703,687,16,2.3
20103,4/1/19,36051,34991,1060,2.9
20105,4/1/19,1578,1544,34,2.2
20107,4/1/19,4301,4091,210,4.9
20109,4/1/19,1539,1508,31,2
20111,4/1/19,16617,16136,481,2.9
20113,4/1/19,17448,17127,321,1.8
20115,4/1/19,5791,5628,163,2.8
20117,4/1/19,5292,5129,163,3.1
20119,4/1/19,2002,1956,46,2.3
20121,4/1/19,17264,16782,482,2.8
20123,4/1/19,3281,3211,70,2.1
20125,4/1/19,14700,14203,497,3.4
20127,4/1/19,2862,2795,67,2.3
20129,4/1/19,1076,1046,30,2.8
20131,4/1/19,5114,4995,119,2.3
20133,4/1/19,5959,5720,239,4
20135,4/1/19,1254,1223,31,2.5
20137,4/1/19,2549,2495,54,2.1
20139,4/1/19,7830,7597,233,3
20141,4/1/19,1928,1891,37,1.9
20143,4/1/19,2908,2835,73,2.5
20145,4/1/19,2630,2555,75,2.9
20147,4/1/19,2523,2463,60,2.4
20149,4/1/19,12683,12382,301,2.4
20151,4/1/19,4774,4661,113,2.4
20153,4/1/19,1328,1295,33,2.5
20155,4/1/19,29572,28741,831,2.8
20157,4/1/19,2114,2057,57,2.7
20159,4/1/19,5136,5000,136,2.6
20161,4/1/19,36152,35285,867,2.4
20163,4/1/19,2391,2313,78,3.3
20165,4/1/19,1588,1539,49,3.1
20167,4/1/19,3168,3084,84,2.7
20169,4/1/19,30099,29311,788,2.6
20171,4/1/19,2582,2537,45,1.7
20173,4/1/19,250744,243092,7652,3.1
20175,4/1/19,9322,9071,251,2.7
20177,4/1/19,90026,87438,2588,2.9
20179,4/1/19,1265,1237,28,2.2
20181,4/1/19,2696,2627,69,2.6
20183,4/1/19,1831,1788,43,2.3
20185,4/1/19,1827,1781,46,2.5
20187,4/1/19,869,848,21,2.4
20189,4/1/19,2325,2264,61,2.6
20191,4/1/19,10712,10390,322,3
20193,4/1/19,4111,4026,85,2.1
20195,4/1/19,1345,1302,43,3.2
20197,4/1/19,3505,3411,94,2.7
20199,4/1/19,718,696,22,3.1
20201,4/1/19,2699,2627,72,2.7
20203,4/1/19,1339,1317,22,1.6
20205,4/1/19,3822,3692,130,3.4
20207,4/1/19,1644,1586,58,3.5
20209,4/1/19,76406,73508,2898,3.8
21001,4/1/19,7162,6809,353,4.9
21003,4/1/19,8965,8628,337,3.8
21005,4/1/19,11794,11413,381,3.2
21007,4/1/19,3485,3304,181,5.2
21009,4/1/19,18746,17992,754,4
21011,4/1/19,4570,4316,254,5.6
21013,4/1/19,8403,7987,416,5
21015,4/1/19,71105,68926,2179,3.1
21017,4/1/19,9556,9225,331,3.5
21019,4/1/19,17888,16956,932,5.2
21021,4/1/19,12669,12145,524,4.1
21023,4/1/19,3817,3648,169,4.4
21025,4/1/19,3537,3312,225,6.4
21027,4/1/19,7901,7513,388,4.9
21029,4/1/19,42839,41166,1673,3.9
21031,4/1/19,5143,4927,216,4.2
21033,4/1/19,5410,5168,242,4.5
21035,4/1/19,18895,18226,669,3.5
21037,4/1/19,50924,49352,1572,3.1
21039,4/1/19,2207,2126,81,3.7
21041,4/1/19,5300,5111,189,3.6
21043,4/1/19,9553,8874,679,7.1
21045,4/1/19,6605,6357,248,3.8
21047,4/1/19,24801,23587,1214,4.9
21049,4/1/19,17222,16599,623,3.6
21051,4/1/19,5193,4876,317,6.1
21053,4/1/19,4012,3796,216,5.4
21055,4/1/19,3850,3669,181,4.7
21057,4/1/19,3157,3023,134,4.2
21059,4/1/19,47456,45786,1670,3.5
21061,4/1/19,4827,4621,206,4.3
21063,4/1/19,1976,1850,126,6.4
21065,4/1/19,5377,5142,235,4.4
21067,4/1/19,175451,170166,5285,3
21069,4/1/19,6213,5908,305,4.9
21071,4/1/19,11134,10500,634,5.7
21073,4/1/19,24769,23928,841,3.4
21075,4/1/19,2012,1919,93,4.6
21077,4/1/19,4071,3923,148,3.6
21079,4/1/19,7773,7436,337,4.3
21081,4/1/19,11742,11294,448,3.8
21083,4/1/19,15690,15033,657,4.2
21085,4/1/19,10881,10383,498,4.6
21087,4/1/19,5040,4843,197,3.9
21089,4/1/19,13397,12600,797,5.9
21091,4/1/19,3981,3842,139,3.5
21093,4/1/19,49130,47271,1859,3.8
21095,4/1/19,6780,6352,428,6.3
21097,4/1/19,8754,8391,363,4.1
21099,4/1/19,7988,7677,311,3.9
21101,4/1/19,21970,21199,771,3.5
21103,4/1/19,8177,7895,282,3.4
21105,4/1/19,1765,1693,72,4.1
21107,4/1/19,18480,17671,809,4.4
21109,4/1/19,4141,3903,238,5.7
21111,4/1/19,401062,385678,15384,3.8
21113,4/1/19,26670,25779,891,3.3
21115,4/1/19,6730,6334,396,5.9
21117,4/1/19,87995,85198,2797,3.2
21119,4/1/19,4489,4218,271,6
21121,4/1/19,9974,9421,553,5.5
21123,4/1/19,5985,5743,242,4
21125,4/1/19,24752,23666,1086,4.4
21127,4/1/19,5106,4777,329,6.4
21129,4/1/19,2058,1953,105,5.1
21131,4/1/19,2660,2503,157,5.9
21133,4/1/19,6191,5819,372,6
21135,4/1/19,4665,4266,399,8.6
21137,4/1/19,9395,8968,427,4.5
21139,4/1/19,3633,3440,193,5.3
21141,4/1/19,12570,12122,448,3.6
21143,4/1/19,3062,2942,120,3.9
21145,4/1/19,29078,27788,1290,4.4
21147,4/1/19,4583,4341,242,5.3
21149,4/1/19,4183,4015,168,4
21151,4/1/19,47536,45886,1650,3.5
21153,4/1/19,3081,2798,283,9.2
21155,4/1/19,9710,9357,353,3.6
21157,4/1/19,15026,14389,637,4.2
21159,4/1/19,2743,2574,169,6.2
21161,4/1/19,7153,6783,370,5.2
21163,4/1/19,12253,11743,510,4.2
21165,4/1/19,2321,2163,158,6.8
21167,4/1/19,10132,9721,411,4.1
21169,4/1/19,4041,3886,155,3.8
21171,4/1/19,4622,4456,166,3.6
21173,4/1/19,11665,11094,571,4.9
21175,4/1/19,4593,4386,207,4.5
21177,4/1/19,10862,10286,576,5.3
21179,4/1/19,23263,22207,1056,4.5
21181,4/1/19,3237,3111,126,3.9
21183,4/1/19,9674,9234,440,4.5
21185,4/1/19,33312,32299,1013,3
21187,4/1/19,5107,4883,224,4.4
21189,4/1/19,1119,1046,73,6.5
21191,4/1/19,7004,6757,247,3.5
21193,4/1/19,8289,7876,413,5
21195,4/1/19,19953,18934,1019,5.1
21197,4/1/19,5032,4790,242,4.8
21199,4/1/19,26510,25392,1118,4.2
21201,4/1/19,800,759,41,5.1
21203,4/1/19,6708,6414,294,4.4
21205,4/1/19,10548,10076,472,4.5
21207,4/1/19,6197,5869,328,5.3
21209,4/1/19,29167,28253,914,3.1
21211,4/1/19,25395,24598,797,3.1
21213,4/1/19,8919,8563,356,4
21215,4/1/19,10215,9880,335,3.3
21217,4/1/19,12623,12128,495,3.9
21219,4/1/19,5314,5121,193,3.6
21221,4/1/19,5949,5675,274,4.6
21223,4/1/19,3869,3703,166,4.3
21225,4/1/19,6034,5790,244,4
21227,4/1/19,65362,63153,2209,3.4
21229,4/1/19,6216,5986,230,3.7
21231,4/1/19,7300,6896,404,5.5
21233,4/1/19,5801,5580,221,3.8
21235,4/1/19,13735,13113,622,4.5
21237,4/1/19,1957,1840,117,6
21239,4/1/19,14631,14223,408,2.8
22001,4/1/19,23580,22581,999,4.2
22003,4/1/19,8716,8342,374,4.3
22005,4/1/19,63800,61758,2042,3.2
22007,4/1/19,8744,8304,440,5
22009,4/1/19,15007,14363,644,4.3
22011,4/1/19,14542,13961,581,4
22013,4/1/19,5406,5139,267,4.9
22015,4/1/19,57195,55261,1934,3.4
22017,4/1/19,102500,98135,4365,4.3
22019,4/1/19,106860,103534,3326,3.1
22021,4/1/19,3717,3544,173,4.7
22023,4/1/19,3971,3849,122,3.1
22025,4/1/19,3262,3079,183,5.6
22027,4/1/19,5736,5484,252,4.4
22029,4/1/19,6843,6482,361,5.3
22031,4/1/19,10730,10212,518,4.8
22033,4/1/19,229566,221945,7621,3.3
22035,4/1/19,1841,1675,166,9
22037,4/1/19,7947,7655,292,3.7
22039,4/1/19,11877,11333,544,4.6
22041,4/1/19,7236,6828,408,5.6
22043,4/1/19,8068,7735,333,4.1
22045,4/1/19,27816,26629,1187,4.3
22047,4/1/19,13933,13269,664,4.8
22049,4/1/19,6730,6476,254,3.8
22051,4/1/19,213053,205968,7085,3.3
22053,4/1/19,13088,12605,483,3.7
22055,4/1/19,113046,109211,3835,3.4
22057,4/1/19,41490,40006,1484,3.6
22059,4/1/19,6598,6391,207,3.1
22061,4/1/19,22129,21256,873,3.9
22063,4/1/19,68505,66356,2149,3.1
22065,4/1/19,3415,3196,219,6.4
22067,4/1/19,9938,9279,659,6.6
22069,4/1/19,16117,15425,692,4.3
22071,4/1/19,177892,171143,6749,3.8
22073,4/1/19,69685,66722,2963,4.3
22075,4/1/19,9969,9629,340,3.4
22077,4/1/19,9769,9364,405,4.1
22079,4/1/19,54708,52530,2178,4
22081,4/1/19,3668,3524,144,3.9
22083,4/1/19,8145,7727,418,5.1
22085,4/1/19,9053,8692,361,4
22087,4/1/19,19741,18975,766,3.9
22089,4/1/19,25022,24185,837,3.3
22091,4/1/19,4236,4035,201,4.7
22093,4/1/19,9141,8711,430,4.7
22095,4/1/19,19503,18652,851,4.4
22097,4/1/19,31480,29918,1562,5
22099,4/1/19,22000,21105,895,4.1
22101,4/1/19,19451,18515,936,4.8
22103,4/1/19,118851,115013,3838,3.2
22105,4/1/19,53833,51542,2291,4.3
22107,4/1/19,1340,1245,95,7.1
22109,4/1/19,45630,43952,1678,3.7
22111,4/1/19,9012,8575,437,4.8
22113,4/1/19,23908,22940,968,4
22115,4/1/19,15432,14687,745,4.8
22117,4/1/19,16511,15719,792,4.8
22119,4/1/19,14339,13639,700,4.9
22121,4/1/19,13607,13126,481,3.5
22123,4/1/19,3553,3189,364,10.2
22125,4/1/19,5349,5182,167,3.1
22127,4/1/19,4754,4508,246,5.2
23001,4/1/19,55367,53622,1745,3.2
23003,4/1/19,29952,28286,1666,5.6
23005,4/1/19,162958,158792,4166,2.6
23007,4/1/19,14278,13665,613,4.3
23009,4/1/19,27485,26269,1216,4.4
23011,4/1/19,61775,59852,1923,3.1
23013,4/1/19,19572,18874,698,3.6
23015,4/1/19,16079,15514,565,3.5
23017,4/1/19,25726,24685,1041,4
23019,4/1/19,77310,74566,2744,3.5
23021,4/1/19,7161,6853,308,4.3
23023,4/1/19,19340,18841,499,2.6
23025,4/1/19,22020,20949,1071,4.9
23027,4/1/19,20287,19577,710,3.5
23029,4/1/19,13343,12569,774,5.8
23031,4/1/19,112380,109146,3234,2.9
24001,4/1/19,32377,30955,1422,4.4
24003,4/1/19,314372,305913,8459,2.7
24005,4/1/19,452764,437427,15337,3.4
24009,4/1/19,49925,48546,1379,2.8
24011,4/1/19,18332,17719,613,3.3
24013,4/1/19,95900,93524,2376,2.5
24015,4/1/19,53416,51518,1898,3.6
24017,4/1/19,87118,84358,2760,3.2
24019,4/1/19,15931,15196,735,4.6
24021,4/1/19,134546,130842,3704,2.8
24023,4/1/19,15661,15073,588,3.8
24025,4/1/19,140758,136585,4173,3
24027,4/1/19,187025,182532,4493,2.4
24029,4/1/19,10400,10022,378,3.6
24031,4/1/19,557918,543537,14381,2.6
24033,4/1/19,508585,491296,17289,3.4
24035,4/1/19,28137,27391,746,2.7
24037,4/1/19,56776,55183,1593,2.8
24039,4/1/19,9263,8748,515,5.6
24041,4/1/19,19117,18550,567,3
24043,4/1/19,74379,71748,2631,3.5
24045,4/1/19,50516,48292,2224,4.4
24047,4/1/19,25482,23485,1997,7.8
24510,4/1/19,287396,273845,13551,4.7
25001,4/1/19,110193,105664,4529,4.1
25003,4/1/19,63940,61676,2264,3.5
25005,4/1/19,302134,291682,10452,3.5
25007,4/1/19,8555,8130,425,5
25009,4/1/19,426586,414450,12136,2.8
25011,4/1/19,41138,40015,1123,2.7
25013,4/1/19,230137,221381,8756,3.8
25015,4/1/19,90949,88719,2230,2.5
25017,4/1/19,922329,902342,19987,2.2
25019,4/1/19,6576,6278,298,4.5
25021,4/1/19,392413,383038,9375,2.4
25023,4/1/19,284001,275999,8002,2.8
25025,4/1/19,457092,446257,10835,2.4
25027,4/1/19,448235,434988,13247,3
26001,4/1/19,3747,3516,231,6.2
26003,4/1/19,2966,2688,278,9.4
26005,4/1/19,61672,59874,1798,2.9
26007,4/1/19,13141,12529,612,4.7
26009,4/1/19,9742,9156,586,6
26011,4/1/19,5948,5561,387,6.5
26013,4/1/19,3192,2974,218,6.8
26015,4/1/19,31546,30605,941,3
26017,4/1/19,49743,47580,2163,4.3
26019,4/1/19,8559,8101,458,5.4
26021,4/1/19,73127,70490,2637,3.6
26023,4/1/19,19240,18604,636,3.3
26025,4/1/19,62268,59903,2365,3.8
26027,4/1/19,24495,23564,931,3.8
26029,4/1/19,12186,11548,638,5.2
26031,4/1/19,9960,8801,1159,11.6
26033,4/1/19,15815,14731,1084,6.9
26035,4/1/19,11678,10976,702,6
26037,4/1/19,41475,40382,1093,2.6
26039,4/1/19,5513,5194,319,5.8
26041,4/1/19,16958,16064,894,5.3
26043,4/1/19,12040,11561,479,4
26045,4/1/19,57735,56063,1672,2.9
26047,4/1/19,16762,15623,1139,6.8
26049,4/1/19,181839,173864,7975,4.4
26051,4/1/19,9806,9291,515,5.3
26053,4/1/19,5951,5624,327,5.5
26055,4/1/19,47909,46228,1681,3.5
26057,4/1/19,18053,17328,725,4
26059,4/1/19,20269,19531,738,3.6
26061,4/1/19,16361,15543,818,5
26063,4/1/19,14998,14299,699,4.7
26065,4/1/19,152656,148013,4643,3
26067,4/1/19,30072,29188,884,2.9
26069,4/1/19,9860,9256,604,6.1
26071,4/1/19,5011,4701,310,6.2
26073,4/1/19,34720,33512,1208,3.5
26075,4/1/19,74315,71799,2516,3.4
26077,4/1/19,133506,129624,3882,2.9
26079,4/1/19,7658,7197,461,6
26081,4/1/19,358971,349868,9103,2.5
26083,4/1/19,903,828,75,8.3
26085,4/1/19,3591,3360,231,6.4
26087,4/1/19,40795,38795,2000,4.9
26089,4/1/19,10133,9732,401,4
26091,4/1/19,46510,44952,1558,3.3
26093,4/1/19,102603,99594,3009,2.9
26095,4/1/19,2228,2061,167,7.5
26097,4/1/19,4429,3791,638,14.4
26099,4/1/19,443763,427465,16298,3.7
26101,4/1/19,10155,9606,549,5.4
26103,4/1/19,32722,31043,1679,5.1
26105,4/1/19,13431,12831,600,4.5
26107,4/1/19,18529,17758,771,4.2
26109,4/1/19,11001,10573,428,3.9
26111,4/1/19,40406,39008,1398,3.5
26113,4/1/19,6836,6492,344,5
26115,4/1/19,75588,72844,2744,3.6
26117,4/1/19,28256,27172,1084,3.8
26119,4/1/19,2928,2694,234,8
26121,4/1/19,76134,73211,2923,3.8
26123,4/1/19,23310,22409,901,3.9
26125,4/1/19,669585,649730,19855,3
26127,4/1/19,11693,10961,732,6.3
26129,4/1/19,7867,7331,536,6.8
26131,4/1/19,2019,1836,183,9.1
26133,4/1/19,11059,10611,448,4.1
26135,4/1/19,2871,2683,188,6.5
26137,4/1/19,11411,10805,606,5.3
26139,4/1/19,160611,156682,3929,2.4
26141,4/1/19,4868,4487,381,7.8
26143,4/1/19,7484,6887,597,8
26145,4/1/19,86097,82369,3728,4.3
26147,4/1/19,75024,71700,3324,4.4
26149,4/1/19,27936,26896,1040,3.7
26151,4/1/19,19181,18242,939,4.9
26153,4/1/19,3307,3048,259,7.8
26155,4/1/19,33533,32185,1348,4
26157,4/1/19,23767,22593,1174,4.9
26159,4/1/19,34939,33518,1421,4.1
26161,4/1/19,198131,193056,5075,2.6
26163,4/1/19,793142,758747,34395,4.3
26165,4/1/19,14593,13955,638,4.4
27001,4/1/19,7165,6669,496,6.9
27003,4/1/19,197812,192170,5642,2.9
27005,4/1/19,18703,17915,788,4.2
27007,4/1/19,24158,23129,1029,4.3
27009,4/1/19,22175,21320,855,3.9
27011,4/1/19,2438,2327,111,4.6
27013,4/1/19,40994,39932,1062,2.6
27015,4/1/19,14446,13932,514,3.6
27017,4/1/19,18025,17216,809,4.5
27019,4/1/19,58592,57111,1481,2.5
27021,4/1/19,13789,12984,805,5.8
27023,4/1/19,6995,6695,300,4.3
27025,4/1/19,30004,28890,1114,3.7
27027,4/1/19,36191,35077,1114,3.1
27029,4/1/19,4433,3994,439,9.9
27031,4/1/19,2950,2798,152,5.2
27033,4/1/19,5916,5724,192,3.2
27035,4/1/19,31601,30278,1323,4.2
27037,4/1/19,241786,235436,6350,2.6
27039,4/1/19,11890,11488,402,3.4
27041,4/1/19,20836,20146,690,3.3
27043,4/1/19,6958,6650,308,4.4
27045,4/1/19,11557,11190,367,3.2
27047,4/1/19,16161,15631,530,3.3
27049,4/1/19,26909,26110,799,3
27051,4/1/19,3350,3198,152,4.5
27053,4/1/19,705175,687962,17213,2.4
27055,4/1/19,10509,10188,321,3.1
27057,4/1/19,9690,9165,525,5.4
27059,4/1/19,21388,20507,881,4.1
27061,4/1/19,21579,20222,1357,6.3
27063,4/1/19,5738,5563,175,3
27065,4/1/19,9057,8455,602,6.6
27067,4/1/19,24120,23213,907,3.8
27069,4/1/19,2357,2273,84,3.6
27071,4/1/19,5947,5495,452,7.6
27073,4/1/19,3608,3457,151,4.2
27075,4/1/19,5362,5167,195,3.6
27077,4/1/19,2365,2254,111,4.7
27079,4/1/19,16314,15470,844,5.2
27081,4/1/19,3265,3132,133,4.1
27083,4/1/19,14710,14224,486,3.3
27085,4/1/19,19327,18615,712,3.7
27087,4/1/19,2312,2205,107,4.6
27089,4/1/19,5476,5096,380,6.9
27091,4/1/19,10071,9734,337,3.3
27093,4/1/19,13365,12829,536,4
27095,4/1/19,13023,12262,761,5.8
27097,4/1/19,17655,16788,867,4.9
27099,4/1/19,20423,19845,578,2.8
27101,4/1/19,4898,4688,210,4.3
27103,4/1/19,21117,20624,493,2.3
27105,4/1/19,11232,10935,297,2.6
27107,4/1/19,3293,3125,168,5.1
27109,4/1/19,88328,86201,2127,2.4
27111,4/1/19,31145,29851,1294,4.2
27113,4/1/19,8838,8305,533,6
27115,4/1/19,15085,14171,914,6.1
27117,4/1/19,4898,4702,196,4
27119,4/1/19,16648,15971,677,4.1
27121,4/1/19,6532,6334,198,3
27123,4/1/19,289255,281558,7697,2.7
27125,4/1/19,2238,2105,133,5.9
27127,4/1/19,7624,7342,282,3.7
27129,4/1/19,8626,8160,466,5.4
27131,4/1/19,37197,36127,1070,2.9
27133,4/1/19,5690,5573,117,2.1
27135,4/1/19,7791,7531,260,3.3
27137,4/1/19,102878,98916,3962,3.9
27139,4/1/19,83547,81476,2071,2.5
27141,4/1/19,52617,50780,1837,3.5
27143,4/1/19,8629,8295,334,3.9
27145,4/1/19,91319,88500,2819,3.1
27147,4/1/19,20924,20303,621,3
27149,4/1/19,5523,5385,138,2.5
27151,4/1/19,4893,4687,206,4.2
27153,4/1/19,13515,12911,604,4.5
27155,4/1/19,1803,1731,72,4
27157,4/1/19,12295,11913,382,3.1
27159,4/1/19,5954,5585,369,6.2
27161,4/1/19,8966,8644,322,3.6
27163,4/1/19,143478,139792,3686,2.6
27165,4/1/19,6603,6332,271,4.1
27167,4/1/19,3497,3384,113,3.2
27169,4/1/19,28955,28222,733,2.5
27171,4/1/19,75832,73378,2454,3.2
27173,4/1/19,5367,5138,229,4.3
28001,4/1/19,11029,10358,671,6.1
28003,4/1/19,16164,15502,662,4.1
28005,4/1/19,4453,4203,250,5.6
28007,4/1/19,7050,6654,396,5.6
28009,4/1/19,3008,2853,155,5.2
28011,4/1/19,12396,11694,702,5.7
28013,4/1/19,5731,5468,263,4.6
28015,4/1/19,3469,3279,190,5.5
28017,4/1/19,6896,6563,333,4.8
28019,4/1/19,3747,3569,178,4.8
28021,4/1/19,2973,2714,259,8.7
28023,4/1/19,5897,5561,336,5.7
28025,4/1/19,7797,7320,477,6.1
28027,4/1/19,8356,7838,518,6.2
28029,4/1/19,11162,10510,652,5.8
28031,4/1/19,8063,7717,346,4.3
28033,4/1/19,90326,86762,3564,3.9
28035,4/1/19,33029,31507,1522,4.6
28037,4/1/19,2819,2669,150,5.3
28039,4/1/19,8843,8320,523,5.9
28041,4/1/19,4358,4083,275,6.3
28043,4/1/19,9451,9043,408,4.3
28045,4/1/19,18491,17558,933,5
28047,4/1/19,85290,81385,3905,4.6
28049,4/1/19,106070,101079,4991,4.7
28051,4/1/19,5653,5155,498,8.8
28053,4/1/19,2285,2104,181,7.9
28055,4/1/19,382,345,37,9.7
28057,4/1/19,10428,10000,428,4.1
28059,4/1/19,57772,54656,3116,5.4
28061,4/1/19,6212,5845,367,5.9
28063,4/1/19,1954,1733,221,11.3
28065,4/1/19,4107,3877,230,5.6
28067,4/1/19,26346,25086,1260,4.8
28069,4/1/19,3556,3312,244,6.9
28071,4/1/19,28396,27270,1126,4
28073,4/1/19,30493,29340,1153,3.8
28075,4/1/19,30259,28806,1453,4.8
28077,4/1/19,4580,4334,246,5.4
28079,4/1/19,8006,7623,383,4.8
28081,4/1/19,40657,39088,1569,3.9
28083,4/1/19,9964,9316,648,6.5
28085,4/1/19,14518,13803,715,4.9
28087,4/1/19,25352,24164,1188,4.7
28089,4/1/19,52884,50767,2117,4
28091,4/1/19,9864,9399,465,4.7
28093,4/1/19,14287,13592,695,4.9
28095,4/1/19,15258,14541,717,4.7
28097,4/1/19,3995,3783,212,5.3
28099,4/1/19,10156,9616,540,5.3
28101,4/1/19,8849,8407,442,5
28103,4/1/19,3813,3583,230,6
28105,4/1/19,22630,21522,1108,4.9
28107,4/1/19,12496,11756,740,5.9
28109,4/1/19,23807,22719,1088,4.6
28111,4/1/19,4253,4009,244,5.7
28113,4/1/19,14562,13751,811,5.6
28115,4/1/19,14598,14036,562,3.8
28117,4/1/19,11282,10795,487,4.3
28119,4/1/19,2412,2252,160,6.6
28121,4/1/19,75604,72919,2685,3.6
28123,4/1/19,12737,12239,498,3.9
28125,4/1/19,1607,1498,109,6.8
28127,4/1/19,10709,10217,492,4.6
28129,4/1/19,6849,6537,312,4.6
28131,4/1/19,6904,6510,394,5.7
28133,4/1/19,7823,7272,551,7
28135,4/1/19,5338,5085,253,4.7
28137,4/1/19,12282,11677,605,4.9
28139,4/1/19,9470,9043,427,4.5
28141,4/1/19,8746,8387,359,4.1
28143,4/1/19,4435,4213,222,5
28145,4/1/19,14036,13525,511,3.6
28147,4/1/19,4921,4624,297,6
28149,4/1/19,20168,19114,1054,5.2
28151,4/1/19,16850,15780,1070,6.4
28153,4/1/19,7484,7101,383,5.1
28155,4/1/19,4031,3825,206,5.1
28157,4/1/19,2756,2535,221,8
28159,4/1/19,7396,6988,408,5.5
28161,4/1/19,4932,4677,255,5.2
28163,4/1/19,9423,8889,534,5.7
29001,4/1/19,10523,10215,308,2.9
29003,4/1/19,9753,9512,241,2.5
29005,4/1/19,2836,2727,109,3.8
29007,4/1/19,10811,10535,276,2.6
29009,4/1/19,15798,15366,432,2.7
29011,4/1/19,5297,5156,141,2.7
29013,4/1/19,7918,7653,265,3.3
29015,4/1/19,7294,7015,279,3.8
29017,4/1/19,5493,5324,169,3.1
29019,4/1/19,98838,96946,1892,1.9
29021,4/1/19,44419,43229,1190,2.7
29023,4/1/19,18029,17095,934,5.2
29025,4/1/19,4389,4279,110,2.5
29027,4/1/19,21314,20839,475,2.2
29029,4/1/19,18216,17562,654,3.6
29031,4/1/19,40558,39623,935,2.3
29033,4/1/19,4875,4755,120,2.5
29035,4/1/19,2548,2418,130,5.1
29037,4/1/19,54247,52913,1334,2.5
29039,4/1/19,5855,5684,171,2.9
29041,4/1/19,3802,3720,82,2.2
29043,4/1/19,44438,43475,963,2.2
29045,4/1/19,3266,3164,102,3.1
29047,4/1/19,134800,131710,3090,2.3
29049,4/1/19,10700,10441,259,2.4
29051,4/1/19,38815,38019,796,2.1
29053,4/1/19,7486,7280,206,2.8
29055,4/1/19,10893,10564,329,3
29057,4/1/19,3671,3575,96,2.6
29059,4/1/19,7061,6823,238,3.4
29061,4/1/19,4278,4164,114,2.7
29063,4/1/19,4903,4769,134,2.7
29065,4/1/19,6277,6104,173,2.8
29067,4/1/19,5123,4982,141,2.8
29069,4/1/19,11922,11348,574,4.8
29071,4/1/19,52659,51244,1415,2.7
29073,4/1/19,7763,7553,210,2.7
29075,4/1/19,3682,3601,81,2.2
29077,4/1/19,150048,146800,3248,2.2
29079,4/1/19,4567,4435,132,2.9
29081,4/1/19,3951,3869,82,2.1
29083,4/1/19,9792,9516,276,2.8
29085,4/1/19,3830,3706,124,3.2
29087,4/1/19,2693,2623,70,2.6
29089,4/1/19,4976,4864,112,2.3
29091,4/1/19,16320,15847,473,2.9
29093,4/1/19,3537,3410,127,3.6
29095,4/1/19,357955,346695,11260,3.1
29097,4/1/19,56486,55120,1366,2.4
29099,4/1/19,116451,113414,3037,2.6
29101,4/1/19,23127,22433,694,3
29103,4/1/19,1833,1784,49,2.7
29105,4/1/19,17196,16470,726,4.2
29107,4/1/19,16842,16411,431,2.6
29109,4/1/19,18110,17619,491,2.7
29111,4/1/19,5107,4962,145,2.8
29113,4/1/19,28222,27430,792,2.8
29115,4/1/19,5126,4957,169,3.3
29117,4/1/19,7488,7343,145,1.9
29119,4/1/19,10573,10290,283,2.7
29121,4/1/19,7641,7439,202,2.6
29123,4/1/19,5497,5339,158,2.9
29125,4/1/19,3963,3838,125,3.2
29127,4/1/19,14546,14165,381,2.6
29129,4/1/19,2022,1969,53,2.6
29131,4/1/19,12303,11960,343,2.8
29133,4/1/19,5878,5702,176,3
29135,4/1/19,7425,7251,174,2.3
29137,4/1/19,3917,3786,131,3.3
29139,4/1/19,5837,5688,149,2.6
29141,4/1/19,8009,7747,262,3.3
29143,4/1/19,8393,8100,293,3.5
29145,4/1/19,27157,26417,740,2.7
29147,4/1/19,11045,10798,247,2.2
29149,4/1/19,4046,3925,121,3
29151,4/1/19,7149,7019,130,1.8
29153,4/1/19,3497,3346,151,4.3
29155,4/1/19,6428,6176,252,3.9
29157,4/1/19,10156,9936,220,2.2
29159,4/1/19,20804,20255,549,2.6
29161,4/1/19,19812,19277,535,2.7
29163,4/1/19,7599,7377,222,2.9
29165,4/1/19,58116,56856,1260,2.2
29167,4/1/19,14490,14080,410,2.8
29169,4/1/19,14583,14119,464,3.2
29171,4/1/19,2391,2325,66,2.8
29173,4/1/19,5698,5543,155,2.7
29175,4/1/19,10344,10042,302,2.9
29177,4/1/19,10904,10595,309,2.8
29179,4/1/19,3021,2921,100,3.3
29181,4/1/19,5159,4844,315,6.1
29183,4/1/19,224952,220168,4784,2.1
29185,4/1/19,3796,3672,124,3.3
29186,4/1/19,9212,9022,190,2.1
29187,4/1/19,26457,25695,762,2.9
29189,4/1/19,526302,512584,13718,2.6
29195,4/1/19,10842,10567,275,2.5
29197,4/1/19,2011,1951,60,3
29199,4/1/19,2451,2390,61,2.5
29201,4/1/19,20177,19631,546,2.7
29203,4/1/19,3250,3102,148,4.6
29205,4/1/19,3139,3072,67,2.1
29207,4/1/19,13264,12722,542,4.1
29209,4/1/19,13426,12917,509,3.8
29211,4/1/19,2792,2717,75,2.7
29213,4/1/19,26236,25276,960,3.7
29215,4/1/19,9204,8879,325,3.5
29217,4/1/19,9733,9451,282,2.9
29219,4/1/19,17821,17386,435,2.4
29221,4/1/19,10202,9817,385,3.8
29223,4/1/19,5282,5042,240,4.5
29225,4/1/19,17228,16765,463,2.7
29227,4/1/19,1239,1213,26,2.1
29229,4/1/19,7684,7409,275,3.6
29510,4/1/19,151014,145993,5021,3.3
30001,4/1/19,5038,4894,144,2.9
30003,4/1/19,4890,4517,373,7.6
30005,4/1/19,2495,2415,80,3.2
30007,4/1/19,2538,2442,96,3.8
30009,4/1/19,5471,5291,180,3.3
30011,4/1/19,629,611,18,2.9
30013,4/1/19,37969,36794,1175,3.1
30015,4/1/19,2418,2359,59,2.4
30017,4/1/19,6009,5851,158,2.6
30019,4/1/19,882,870,12,1.4
30021,4/1/19,4619,4522,97,2.1
30023,4/1/19,5029,4867,162,3.2
30025,4/1/19,1687,1661,26,1.5
30027,4/1/19,6079,5910,169,2.8
30029,4/1/19,46972,44622,2350,5
30031,4/1/19,66990,65587,1403,2.1
30033,4/1/19,736,724,12,1.6
30035,4/1/19,5455,5042,413,7.6
30037,4/1/19,367,352,15,4.1
30039,4/1/19,1697,1589,108,6.4
30041,4/1/19,7561,7308,253,3.3
30043,4/1/19,5641,5468,173,3.1
30045,4/1/19,918,892,26,2.8
30047,4/1/19,13014,12489,525,4
30049,4/1/19,35453,34505,948,2.7
30051,4/1/19,968,949,19,2
30053,4/1/19,7963,7351,612,7.7
30055,4/1/19,943,928,15,1.6
30057,4/1/19,5084,4957,127,2.5
30059,4/1/19,950,918,32,3.4
30061,4/1/19,1741,1644,97,5.6
30063,4/1/19,63578,61632,1946,3.1
30065,4/1/19,2266,2182,84,3.7
30067,4/1/19,8629,8332,297,3.4
30069,4/1/19,278,270,8,2.9
30071,4/1/19,1886,1813,73,3.9
30073,4/1/19,2662,2563,99,3.7
30075,4/1/19,938,922,16,1.7
30077,4/1/19,2914,2794,120,4.1
30079,4/1/19,470,454,16,3.4
30081,4/1/19,20103,19312,791,3.9
30083,4/1/19,5797,5646,151,2.6
30085,4/1/19,4533,4322,211,4.7
30087,4/1/19,3781,3605,176,4.7
30089,4/1/19,4807,4502,305,6.3
30091,4/1/19,1752,1720,32,1.8
30093,4/1/19,17086,16451,635,3.7
30095,4/1/19,5115,4962,153,3
30097,4/1/19,1763,1713,50,2.8
30099,4/1/19,2739,2654,85,3.1
30101,4/1/19,2091,2053,38,1.8
30103,4/1/19,334,325,9,2.7
30105,4/1/19,4023,3910,113,2.8
30107,4/1/19,774,751,23,3
30109,4/1/19,450,436,14,3.1
30111,4/1/19,81651,79269,2382,2.9
31001,4/1/19,16699,16207,492,2.9
31003,4/1/19,3524,3434,90,2.6
31005,4/1/19,223,211,12,5.4
31007,4/1/19,383,368,15,3.9
31009,4/1/19,263,251,12,4.6
31011,4/1/19,2951,2878,73,2.5
31013,4/1/19,5454,5275,179,3.3
31015,4/1/19,1080,1037,43,4
31017,4/1/19,1391,1343,48,3.5
31019,4/1/19,27879,27186,693,2.5
31021,4/1/19,3553,3450,103,2.9
31023,4/1/19,4619,4499,120,2.6
31025,4/1/19,13504,13051,453,3.4
31027,4/1/19,4500,4384,116,2.6
31029,4/1/19,2277,2226,51,2.2
31031,4/1/19,3376,3300,76,2.3
31033,4/1/19,4429,4275,154,3.5
31035,4/1/19,3299,3196,103,3.1
31037,4/1/19,5560,5416,144,2.6
31039,4/1/19,4708,4590,118,2.5
31041,4/1/19,6471,6308,163,2.5
31043,4/1/19,10740,10365,375,3.5
31045,4/1/19,5070,4932,138,2.7
31047,4/1/19,13033,12659,374,2.9
31049,4/1/19,945,918,27,2.9
31051,4/1/19,3048,2948,100,3.3
31053,4/1/19,19400,18852,548,2.8
31055,4/1/19,297705,288217,9488,3.2
31057,4/1/19,1182,1152,30,2.5
31059,4/1/19,3205,3115,90,2.8
31061,4/1/19,1485,1438,47,3.2
31063,4/1/19,1643,1596,47,2.9
31065,4/1/19,2611,2543,68,2.6
31067,4/1/19,10991,10644,347,3.2
31069,4/1/19,1094,1062,32,2.9
31071,4/1/19,1154,1124,30,2.6
31073,4/1/19,1094,1064,30,2.7
31075,4/1/19,428,418,10,2.3
31077,4/1/19,1242,1204,38,3.1
31079,4/1/19,31875,30900,975,3.1
31081,4/1/19,4775,4645,130,2.7
31083,4/1/19,1792,1745,47,2.6
31085,4/1/19,617,600,17,2.8
31087,4/1/19,1267,1224,43,3.4
31089,4/1/19,5780,5634,146,2.5
31091,4/1/19,371,358,13,3.5
31093,4/1/19,3359,3264,95,2.8
31095,4/1/19,4115,4012,103,2.5
31097,4/1/19,2091,2025,66,3.2
31099,4/1/19,3791,3706,85,2.2
31101,4/1/19,4547,4416,131,2.9
31103,4/1/19,589,574,15,2.5
31105,4/1/19,2050,1984,66,3.2
31107,4/1/19,4590,4452,138,3
31109,4/1/19,176835,172090,4745,2.7
31111,4/1/19,18221,17633,588,3.2
31113,4/1/19,480,467,13,2.7
31115,4/1/19,400,388,12,3
31117,4/1/19,446,434,12,2.7
31119,4/1/19,19720,19179,541,2.7
31121,4/1/19,4015,3904,111,2.8
31123,4/1/19,2576,2505,71,2.8
31125,4/1/19,1985,1927,58,2.9
31127,4/1/19,3637,3509,128,3.5
31129,4/1/19,2332,2274,58,2.5
31131,4/1/19,8419,8137,282,3.3
31133,4/1/19,1493,1451,42,2.8
31135,4/1/19,1838,1796,42,2.3
31137,4/1/19,4956,4831,125,2.5
31139,4/1/19,4084,3986,98,2.4
31141,4/1/19,17507,17010,497,2.8
31143,4/1/19,2935,2862,73,2.5
31145,4/1/19,5819,5663,156,2.7
31147,4/1/19,4242,4107,135,3.2
31149,4/1/19,863,836,27,3.1
31151,4/1/19,7424,7201,223,3
31153,4/1/19,96031,93304,2727,2.8
31155,4/1/19,11110,10796,314,2.8
31157,4/1/19,18231,17548,683,3.7
31159,4/1/19,8918,8667,251,2.8
31161,4/1/19,2681,2603,78,2.9
31163,4/1/19,1703,1653,50,2.9
31165,4/1/19,740,718,22,3
31167,4/1/19,3412,3322,90,2.6
31169,4/1/19,2828,2753,75,2.7
31171,4/1/19,418,405,13,3.1
31173,4/1/19,3029,2888,141,4.7
31175,4/1/19,2114,2046,68,3.2
31177,4/1/19,11213,10904,309,2.8
31179,4/1/19,5842,5704,138,2.4
31181,4/1/19,1681,1628,53,3.2
31183,4/1/19,599,582,17,2.8
31185,4/1/19,7283,7092,191,2.6
32001,4/1/19,10934,10527,407,3.7
32003,4/1/19,1124041,1078572,45469,4
32005,4/1/19,22825,21857,968,4.2
32007,4/1/19,27536,26702,834,3
32009,4/1/19,413,401,12,2.9
32011,4/1/19,1089,1062,27,2.5
32013,4/1/19,8217,7987,230,2.8
32015,4/1/19,3209,3108,101,3.1
32017,4/1/19,2076,1988,88,4.2
32019,4/1/19,23461,22338,1123,4.8
32021,4/1/19,2033,1950,83,4.1
32023,4/1/19,17095,16190,905,5.3
32027,4/1/19,2548,2439,109,4.3
32029,4/1/19,2018,1938,80,4
32031,4/1/19,253514,245173,8341,3.3
32033,4/1/19,4592,4451,141,3.1
32510,4/1/19,26084,25028,1056,4
33001,4/1/19,30490,29695,795,2.6
33003,4/1/19,22441,21779,662,2.9
33005,4/1/19,41033,40006,1027,2.5
33007,4/1/19,14235,13698,537,3.8
33009,4/1/19,48905,47820,1085,2.2
33011,4/1/19,241634,235496,6138,2.5
33013,4/1/19,83268,81455,1813,2.2
33015,4/1/19,186420,181443,4977,2.7
33017,4/1/19,74556,72868,1688,2.3
33019,4/1/19,22998,22474,524,2.3
34001,4/1/19,118301,113381,4920,4.2
34003,4/1/19,475513,464806,10707,2.3
34005,4/1/19,228031,222237,5794,2.5
34007,4/1/19,249834,241837,7997,3.2
34009,4/1/19,41418,38367,3051,7.4
34011,4/1/19,64732,61851,2881,4.5
34013,4/1/19,363255,350320,12935,3.6
34015,4/1/19,147854,143691,4163,2.8
34017,4/1/19,356236,347066,9170,2.6
34019,4/1/19,63792,62457,1335,2.1
34021,4/1/19,198761,193914,4847,2.4
34023,4/1/19,431162,420656,10506,2.4
34025,4/1/19,322775,314565,8210,2.5
34027,4/1/19,253668,248061,5607,2.2
34029,4/1/19,269673,261761,7912,2.9
34031,4/1/19,238587,230307,8280,3.5
34033,4/1/19,28971,27875,1096,3.8
34035,4/1/19,169259,165335,3924,2.3
34037,4/1/19,73024,71062,1962,2.7
34039,4/1/19,272771,264718,8053,3
34041,4/1/19,55324,53871,1453,2.6
35001,4/1/19,331488,318289,13199,4
35003,4/1/19,1096,1032,64,5.8
35005,4/1/19,27015,25881,1134,4.2
35006,4/1/19,8850,8350,500,5.6
35007,4/1/19,4999,4744,255,5.1
35009,4/1/19,21772,20984,788,3.6
35011,4/1/19,774,745,29,3.7
35013,4/1/19,96675,91348,5327,5.5
35015,4/1/19,33571,32662,909,2.7
35017,4/1/19,12206,11677,529,4.3
35019,4/1/19,1533,1453,80,5.2
35021,4/1/19,257,244,13,5.1
35023,4/1/19,2087,2013,74,3.5
35025,4/1/19,30736,29703,1033,3.4
35027,4/1/19,8797,8422,375,4.3
35028,4/1/19,9311,9043,268,2.9
35029,4/1/19,10032,8594,1438,14.3
35031,4/1/19,24070,22600,1470,6.1
35033,4/1/19,2174,2053,121,5.6
35035,4/1/19,24563,23484,1079,4.4
35037,4/1/19,3282,3119,163,5
35039,4/1/19,16724,15921,803,4.8
35041,4/1/19,7903,7602,301,3.8
35043,4/1/19,65929,63088,2841,4.3
35045,4/1/19,51885,49334,2551,4.9
35047,4/1/19,10883,10313,570,5.2
35049,4/1/19,73569,70846,2723,3.7
35051,4/1/19,3737,3448,289,7.7
35053,4/1/19,6410,6093,317,4.9
35055,4/1/19,14806,13936,870,5.9
35057,4/1/19,5558,5217,341,6.1
35059,4/1/19,1841,1787,54,2.9
35061,4/1/19,30429,28977,1452,4.8
36001,4/1/19,156127,151009,5118,3.3
36003,4/1/19,19262,18271,991,5.1
36005,4/1/19,595453,565719,29734,5
36007,4/1/19,83137,79590,3547,4.3
36009,4/1/19,33010,31440,1570,4.8
36011,4/1/19,35251,33860,1391,3.9
36013,4/1/19,53593,51234,2359,4.4
36015,4/1/19,34754,33421,1333,3.8
36017,4/1/19,21516,20635,881,4.1
36019,4/1/19,35827,34315,1512,4.2
36021,4/1/19,30581,29666,915,3
36023,4/1/19,22760,21707,1053,4.6
36025,4/1/19,18681,17855,826,4.4
36027,4/1/19,142832,138226,4606,3.2
36029,4/1/19,436664,420168,16496,3.8
36031,4/1/19,15767,14911,856,5.4
36033,4/1/19,19034,18071,963,5.1
36035,4/1/19,22306,21255,1051,4.7
36037,4/1/19,29075,27998,1077,3.7
36039,4/1/19,19546,18681,865,4.4
36041,4/1/19,2024,1857,167,8.3
36043,4/1/19,27643,26396,1247,4.5
36045,4/1/19,43014,40690,2324,5.4
36047,4/1/19,1196624,1150800,45824,3.8
36049,4/1/19,11316,10635,681,6
36051,4/1/19,30438,29206,1232,4
36053,4/1/19,32166,30872,1294,4
36055,4/1/19,359498,346164,13334,3.7
36057,4/1/19,21930,20876,1054,4.8
36059,4/1/19,700948,679915,21033,3
36061,4/1/19,911126,880891,30235,3.3
36063,4/1/19,97632,93242,4390,4.5
36065,4/1/19,100391,96447,3944,3.9
36067,4/1/19,217915,210186,7729,3.5
36069,4/1/19,55038,53046,1992,3.6
36071,4/1/19,183113,176976,6137,3.4
36073,4/1/19,17258,16538,720,4.2
36075,4/1/19,52238,49622,2616,5
36077,4/1/19,27719,26672,1047,3.8
36079,4/1/19,50858,49194,1664,3.3
36081,4/1/19,1137831,1100884,36947,3.2
36083,4/1/19,80376,77663,2713,3.4
36085,4/1/19,221683,213682,8001,3.6
36087,4/1/19,154212,149408,4804,3.1
36089,4/1/19,42856,40557,2299,5.4
36091,4/1/19,118046,114366,3680,3.1
36093,4/1/19,75407,72781,2626,3.5
36095,4/1/19,14405,13798,607,4.2
36097,4/1/19,7955,7596,359,4.5
36099,4/1/19,15714,15183,531,3.4
36101,4/1/19,41928,40118,1810,4.3
36103,4/1/19,768876,744398,24478,3.2
36105,4/1/19,35525,34243,1282,3.6
36107,4/1/19,22566,21719,847,3.8
36109,4/1/19,49954,48371,1583,3.2
36111,4/1/19,86796,83912,2884,3.3
36113,4/1/19,30443,28995,1448,4.8
36115,4/1/19,26814,25750,1064,4
36117,4/1/19,43323,41724,1599,3.7
36119,4/1/19,481366,465600,15766,3.3
36121,4/1/19,17670,16959,711,4
36123,4/1/19,11607,11208,399,3.4
37001,4/1/19,81976,79147,2829,3.5
37003,4/1/19,18143,17589,554,3.1
37005,4/1/19,4361,4160,201,4.6
37007,4/1/19,10737,10335,402,3.7
37009,4/1/19,12773,12322,451,3.5
37011,4/1/19,7112,6852,260,3.7
37013,4/1/19,19552,18707,845,4.3
37015,4/1/19,7811,7450,361,4.6
37017,4/1/19,14502,13861,641,4.4
37019,4/1/19,54187,51664,2523,4.7
37021,4/1/19,141169,137358,3811,2.7
37023,4/1/19,41176,39798,1378,3.3
37025,4/1/19,108881,105345,3536,3.2
37027,4/1/19,36743,35374,1369,3.7
37029,4/1/19,4668,4505,163,3.5
37031,4/1/19,31867,30547,1320,4.1
37033,4/1/19,9930,9508,422,4.2
37035,4/1/19,79333,76761,2572,3.2
37037,4/1/19,35674,34569,1105,3.1
37039,4/1/19,11255,10804,451,4
37041,4/1/19,5534,5282,252,4.6
37043,4/1/19,4151,3989,162,3.9
37045,4/1/19,48671,46937,1734,3.6
37047,4/1/19,22610,21603,1007,4.5
37049,4/1/19,41816,40244,1572,3.8
37051,4/1/19,129023,123078,5945,4.6
37053,4/1/19,14014,13548,466,3.3
37055,4/1/19,19505,18618,887,4.5
37057,4/1/19,81570,78844,2726,3.3
37059,4/1/19,20829,20201,628,3
37061,4/1/19,25277,24334,943,3.7
37063,4/1/19,171727,166256,5471,3.2
37065,4/1/19,21296,20087,1209,5.7
37067,4/1/19,189341,182987,6354,3.4
37069,4/1/19,31279,30124,1155,3.7
37071,4/1/19,110866,106937,3929,3.5
37073,4/1/19,5335,5134,201,3.8
37075,4/1/19,3231,3072,159,4.9
37077,4/1/19,30324,29370,954,3.1
37079,4/1/19,9611,9273,338,3.5
37081,4/1/19,265038,255292,9746,3.7
37083,4/1/19,20498,19460,1038,5.1
37085,4/1/19,53539,51274,2265,4.2
37087,4/1/19,30141,29195,946,3.1
37089,4/1/19,55446,53760,1686,3
37091,4/1/19,9207,8774,433,4.7
37093,4/1/19,20312,19421,891,4.4
37095,4/1/19,1957,1798,159,8.1
37097,4/1/19,89306,86405,2901,3.2
37099,4/1/19,19637,18885,752,3.8
37101,4/1/19,99064,95786,3278,3.3
37103,4/1/19,4422,4262,160,3.6
37105,4/1/19,26184,25089,1095,4.2
37107,4/1/19,28166,27181,985,3.5
37109,4/1/19,43372,41978,1394,3.2
37111,4/1/19,20980,20276,704,3.4
37113,4/1/19,15382,14800,582,3.8
37115,4/1/19,10224,9891,333,3.3
37117,4/1/19,9145,8699,446,4.9
37119,4/1/19,620869,599812,21057,3.4
37121,4/1/19,6065,5804,261,4.3
37123,4/1/19,11600,11198,402,3.5
37125,4/1/19,42911,41424,1487,3.5
37127,4/1/19,43232,41279,1953,4.5
37129,4/1/19,124098,119999,4099,3.3
37131,4/1/19,7800,7439,361,4.6
37133,4/1/19,65523,62732,2791,4.3
37135,4/1/19,78891,76580,2311,2.9
37137,4/1/19,5363,5172,191,3.6
37139,4/1/19,16759,16081,678,4
37141,4/1/19,28922,27878,1044,3.6
37143,4/1/19,4989,4757,232,4.7
37145,4/1/19,18512,17783,729,3.9
37147,4/1/19,90534,87190,3344,3.7
37149,4/1/19,8985,8675,310,3.5
37151,4/1/19,66963,64677,2286,3.4
37153,4/1/19,16676,15880,796,4.8
37155,4/1/19,50069,47601,2468,4.9
37157,4/1/19,40528,38909,1619,4
37159,4/1/19,66001,63641,2360,3.6
37161,4/1/19,25402,24273,1129,4.4
37163,4/1/19,29475,28447,1028,3.5
37165,4/1/19,11580,10895,685,5.9
37167,4/1/19,30280,29282,998,3.3
37169,4/1/19,21869,21158,711,3.3
37171,4/1/19,34296,33167,1129,3.3
37173,4/1/19,6929,6651,278,4
37175,4/1/19,14481,13979,502,3.5
37177,4/1/19,1467,1375,92,6.3
37179,4/1/19,123579,119699,3880,3.1
37181,4/1/19,17456,16541,915,5.2
37183,4/1/19,595332,576965,18367,3.1
37185,4/1/19,6555,6205,350,5.3
37187,4/1/19,4446,4196,250,5.6
37189,4/1/19,29041,28136,905,3.1
37191,4/1/19,52676,50659,2017,3.8
37193,4/1/19,29247,28167,1080,3.7
37195,4/1/19,34874,32972,1902,5.5
37197,4/1/19,17908,17354,554,3.1
37199,4/1/19,8426,8145,281,3.3
38001,4/1/19,1029,1008,21,2
38003,4/1/19,5177,5038,139,2.7
38005,4/1/19,2277,2164,113,5
38007,4/1/19,378,369,9,2.4
38009,4/1/19,2895,2782,113,3.9
38011,4/1/19,1727,1699,28,1.6
38013,4/1/19,1104,1077,27,2.4
38015,4/1/19,48892,47680,1212,2.5
38017,4/1/19,101652,99441,2211,2.2
38019,4/1/19,1885,1823,62,3.3
38021,4/1/19,2272,2230,42,1.8
38023,4/1/19,1454,1436,18,1.2
38025,4/1/19,3126,3070,56,1.8
38027,4/1/19,1233,1165,68,5.5
38029,4/1/19,1458,1388,70,4.8
38031,4/1/19,1512,1467,45,3
38033,4/1/19,842,825,17,2
38035,4/1/19,36896,36087,809,2.2
38037,4/1/19,1201,1171,30,2.5
38039,4/1/19,1022,996,26,2.5
38041,4/1/19,1369,1346,23,1.7
38043,4/1/19,1255,1199,56,4.5
38045,4/1/19,2071,2028,43,2.1
38047,4/1/19,876,856,20,2.3
38049,4/1/19,3077,2952,125,4.1
38051,4/1/19,1098,1064,34,3.1
38053,4/1/19,10228,10089,139,1.4
38055,4/1/19,4805,4658,147,3.1
38057,4/1/19,3593,3458,135,3.8
38059,4/1/19,16115,15631,484,3
38061,4/1/19,7110,7016,94,1.3
38063,4/1/19,1364,1320,44,3.2
38065,4/1/19,856,826,30,3.5
38067,4/1/19,3267,3158,109,3.3
38069,4/1/19,1738,1675,63,3.6
38071,4/1/19,5540,5348,192,3.5
38073,4/1/19,2790,2735,55,2
38075,4/1/19,1195,1161,34,2.8
38077,4/1/19,8496,8293,203,2.4
38079,4/1/19,4544,4197,347,7.6
38081,4/1/19,2607,2557,50,1.9
38083,4/1/19,686,654,32,4.7
38085,4/1/19,1220,1178,42,3.4
38087,4/1/19,389,382,7,1.8
38089,4/1/19,18419,18045,374,2
38091,4/1/19,967,948,19,2
38093,4/1/19,10233,9989,244,2.4
38095,4/1/19,1145,1114,31,2.7
38097,4/1/19,4344,4231,113,2.6
38099,4/1/19,5150,4977,173,3.4
38101,4/1/19,31199,30318,881,2.8
38103,4/1/19,1922,1857,65,3.4
38105,4/1/19,23750,23307,443,1.9
39001,4/1/19,10654,10027,627,5.9
39003,4/1/19,47530,45975,1555,3.3
39005,4/1/19,26826,25910,916,3.4
39007,4/1/19,43923,42087,1836,4.2
39009,4/1/19,29092,27972,1120,3.8
39011,4/1/19,24857,24238,619,2.5
39013,4/1/19,29738,28297,1441,4.8
39015,4/1/19,19300,18507,793,4.1
39017,4/1/19,192326,186460,5866,3.1
39019,4/1/19,12889,12343,546,4.2
39021,4/1/19,20011,19418,593,3
39023,4/1/19,62885,60697,2188,3.5
39025,4/1/19,105360,102088,3272,3.1
39027,4/1/19,17406,16718,688,4
39029,4/1/19,46900,44956,1944,4.1
39031,4/1/19,14324,13646,678,4.7
39033,4/1/19,18084,17399,685,3.8
39035,4/1/19,613669,590505,23164,3.8
39037,4/1/19,25733,24941,792,3.1
39039,4/1/19,17930,17301,629,3.5
39041,4/1/19,108421,105650,2771,2.6
39043,4/1/19,36400,34687,1713,4.7
39045,4/1/19,76816,74410,2406,3.1
39047,4/1/19,13748,13324,424,3.1
39049,4/1/19,685734,665178,20556,3
39051,4/1/19,22453,21681,772,3.4
39053,4/1/19,12303,11782,521,4.2
39055,4/1/19,49247,47722,1525,3.1
39057,4/1/19,82222,79687,2535,3.1
39059,4/1/19,18578,17695,883,4.8
39061,4/1/19,410087,397223,12864,3.1
39063,4/1/19,41972,40896,1076,2.6
39065,4/1/19,14111,13654,457,3.2
39067,4/1/19,6806,6520,286,4.2
39069,4/1/19,13180,12629,551,4.2
39071,4/1/19,16927,16218,709,4.2
39073,4/1/19,12842,12330,512,4
39075,4/1/19,20801,20318,483,2.3
39077,4/1/19,27881,26589,1292,4.6
39079,4/1/19,12648,11985,663,5.2
39081,4/1/19,27461,26114,1347,4.9
39083,4/1/19,31714,30686,1028,3.2
39085,4/1/19,126610,122492,4118,3.3
39087,4/1/19,23462,22447,1015,4.3
39089,4/1/19,88998,86274,2724,3.1
39091,4/1/19,22831,22161,670,2.9
39093,4/1/19,154030,148254,5776,3.7
39095,4/1/19,208926,200699,8227,3.9
39097,4/1/19,20617,20008,609,3
39099,4/1/19,102496,97074,5422,5.3
39101,4/1/19,28420,27445,975,3.4
39103,4/1/19,97846,94927,2919,3
39105,4/1/19,9146,8600,546,6
39107,4/1/19,23429,22948,481,2.1
39109,4/1/19,53547,51885,1662,3.1
39111,4/1/19,5302,4901,401,7.6
39113,4/1/19,249018,240238,8780,3.5
39115,4/1/19,6667,6298,369,5.5
39117,4/1/19,16524,15966,558,3.4
39119,4/1/19,39202,37471,1731,4.4
39121,4/1/19,4687,4413,274,5.8
39123,4/1/19,20465,19385,1080,5.3
39125,4/1/19,8650,8393,257,3
39127,4/1/19,15660,14962,698,4.5
39129,4/1/19,26097,25205,892,3.4
39131,4/1/19,10765,10204,561,5.2
39133,4/1/19,86615,83553,3062,3.5
39135,4/1/19,20908,20260,648,3.1
39137,4/1/19,18823,18326,497,2.6
39139,4/1/19,51707,49734,1973,3.8
39141,4/1/19,35205,33967,1238,3.5
39143,4/1/19,30454,29283,1171,3.8
39145,4/1/19,28481,26981,1500,5.3
39147,4/1/19,27318,26397,921,3.4
39149,4/1/19,24071,23361,710,2.9
39151,4/1/19,184530,177248,7282,3.9
39153,4/1/19,270416,260412,10004,3.7
39155,4/1/19,86251,81296,4955,5.7
39157,4/1/19,44484,42868,1616,3.6
39159,4/1/19,28575,27857,718,2.5
39161,4/1/19,14925,14531,394,2.6
39163,4/1/19,5527,5258,269,4.9
39165,4/1/19,117625,114185,3440,2.9
39167,4/1/19,27092,25841,1251,4.6
39169,4/1/19,62134,60503,1631,2.6
39171,4/1/19,18769,18254,515,2.7
39173,4/1/19,70904,68734,2170,3.1
39175,4/1/19,12960,12649,311,2.4
40001,4/1/19,7981,7689,292,3.7
40003,4/1/19,2799,2756,43,1.5
40005,4/1/19,4902,4721,181,3.7
40007,4/1/19,2806,2754,52,1.9
40009,4/1/19,10691,10431,260,2.4
40011,4/1/19,4764,4684,80,1.7
40013,4/1/19,20906,20361,545,2.6
40015,4/1/19,11680,11350,330,2.8
40017,4/1/19,73619,71865,1754,2.4
40019,4/1/19,21774,21139,635,2.9
40021,4/1/19,18572,17978,594,3.2
40023,4/1/19,5368,5159,209,3.9
40025,4/1/19,1278,1260,18,1.4
40027,4/1/19,141954,138495,3459,2.4
40029,4/1/19,2590,2521,69,2.7
40031,4/1/19,48054,46594,1460,3
40033,4/1/19,2690,2618,72,2.7
40035,4/1/19,5858,5686,172,2.9
40037,4/1/19,31329,30361,968,3.1
40039,4/1/19,15756,15447,309,2
40041,4/1/19,17774,17176,598,3.4
40043,4/1/19,2938,2894,44,1.5
40045,4/1/19,2150,2106,44,2
40047,4/1/19,26948,26258,690,2.6
40049,4/1/19,12702,12369,333,2.6
40051,4/1/19,26155,25508,647,2.5
40053,4/1/19,2568,2518,50,1.9
40055,4/1/19,1792,1725,67,3.7
40057,4/1/19,1185,1152,33,2.8
40059,4/1/19,1719,1673,46,2.7
40061,4/1/19,4226,4064,162,3.8
40063,4/1/19,5336,5122,214,4
40065,4/1/19,10548,10285,263,2.5
40067,4/1/19,2489,2422,67,2.7
40069,4/1/19,3694,3565,129,3.5
40071,4/1/19,18253,17560,693,3.8
40073,4/1/19,9057,8909,148,1.6
40075,4/1/19,3436,3331,105,3.1
40077,4/1/19,3082,2938,144,4.7
40079,4/1/19,18830,18083,747,4
40081,4/1/19,15599,15137,462,3
40083,4/1/19,21885,21345,540,2.5
40085,4/1/19,6145,6028,117,1.9
40087,4/1/19,19389,18962,427,2.2
40089,4/1/19,13822,13224,598,4.3
40091,4/1/19,6971,6649,322,4.6
40093,4/1/19,3881,3810,71,1.8
40095,4/1/19,6830,6628,202,3
40097,4/1/19,19322,18793,529,2.7
40099,4/1/19,6312,6154,158,2.5
40101,4/1/19,29140,28237,903,3.1
40103,4/1/19,5648,5536,112,2
40105,4/1/19,4586,4445,141,3.1
40107,4/1/19,4631,4458,173,3.7
40109,4/1/19,382238,371798,10440,2.7
40111,4/1/19,15513,14865,648,4.2
40113,4/1/19,20495,19822,673,3.3
40115,4/1/19,14042,13631,411,2.9
40117,4/1/19,7278,7032,246,3.4
40119,4/1/19,38207,37295,912,2.4
40121,4/1/19,17200,16649,551,3.2
40123,4/1/19,18781,18336,445,2.4
40125,4/1/19,32261,31247,1014,3.1
40127,4/1/19,4215,4037,178,4.2
40129,4/1/19,1870,1830,40,2.1
40131,4/1/19,44819,43625,1194,2.7
40133,4/1/19,9359,9006,353,3.8
40135,4/1/19,15992,15456,536,3.4
40137,4/1/19,18508,17888,620,3.3
40139,4/1/19,10904,10712,192,1.8
40141,4/1/19,2954,2863,91,3.1
40143,4/1/19,321335,312587,8748,2.7
40145,4/1/19,37670,36691,979,2.6
40147,4/1/19,22168,21512,656,3
40149,4/1/19,5143,5010,133,2.6
40151,4/1/19,4576,4496,80,1.7
40153,4/1/19,8998,8800,198,2.2
41001,4/1/19,7039,6689,350,5
41003,4/1/19,48457,47087,1370,2.8
41005,4/1/19,218551,211039,7512,3.4
41007,4/1/19,19217,18494,723,3.8
41009,4/1/19,24379,23274,1105,4.5
41011,4/1/19,25966,24648,1318,5.1
41013,4/1/19,9466,8964,502,5.3
41015,4/1/19,8669,8186,483,5.6
41017,4/1/19,95049,91298,3751,3.9
41019,4/1/19,45817,43424,2393,5.2
41021,4/1/19,999,971,28,2.8
41023,4/1/19,3116,2817,299,9.6
41025,4/1/19,3548,3337,211,5.9
41027,4/1/19,14010,13567,443,3.2
41029,4/1/19,102912,98110,4802,4.7
41031,4/1/19,10177,9641,536,5.3
41033,4/1/19,35518,33694,1824,5.1
41035,4/1/19,29281,27468,1813,6.2
41037,4/1/19,3542,3316,226,6.4
41039,4/1/19,180683,173107,7576,4.2
41041,4/1/19,20720,19806,914,4.4
41043,4/1/19,58968,56364,2604,4.4
41045,4/1/19,12334,11820,514,4.2
41047,4/1/19,160261,153699,6562,4.1
41049,4/1/19,5696,5483,213,3.7
41051,4/1/19,453268,438218,15050,3.3
41053,4/1/19,39403,37775,1628,4.1
41055,4/1/19,906,874,32,3.5
41057,4/1/19,11838,11395,443,3.7
41059,4/1/19,36373,34755,1618,4.4
41061,4/1/19,11955,11364,591,4.9
41063,4/1/19,3347,3079,268,8
41065,4/1/19,12504,11955,549,4.4
41067,4/1/19,323441,313372,10069,3.1
41069,4/1/19,720,690,30,4.2
41071,4/1/19,54557,52674,1883,3.5
42001,4/1/19,54909,53534,1375,2.5
42003,4/1/19,642463,620691,21772,3.4
42005,4/1/19,31697,30450,1247,3.9
42007,4/1/19,82931,80013,2918,3.5
42009,4/1/19,23128,22282,846,3.7
42011,4/1/19,213185,205607,7578,3.6
42013,4/1/19,58712,56686,2026,3.5
42015,4/1/19,28269,27277,992,3.5
42017,4/1/19,340874,330115,10759,3.2
42019,4/1/19,98521,95547,2974,3
42021,4/1/19,57387,55047,2340,4.1
42023,4/1/19,2042,1953,89,4.4
42025,4/1/19,31725,30256,1469,4.6
42027,4/1/19,80820,78737,2083,2.6
42029,4/1/19,281207,273988,7219,2.6
42031,4/1/19,17058,16415,643,3.8
42033,4/1/19,35373,33940,1433,4.1
42035,4/1/19,18109,17353,756,4.2
42037,4/1/19,33231,31969,1262,3.8
42039,4/1/19,38204,36746,1458,3.8
42041,4/1/19,130317,126833,3484,2.7
42043,4/1/19,142440,137819,4621,3.2
42045,4/1/19,296829,286903,9926,3.3
42047,4/1/19,15422,14909,513,3.3
42049,4/1/19,127485,122720,4765,3.7
42051,4/1/19,56265,53561,2704,4.8
42053,4/1/19,1769,1672,97,5.5
42055,4/1/19,75919,73574,2345,3.1
42057,4/1/19,7684,7429,255,3.3
42059,4/1/19,16484,15792,692,4.2
42061,4/1/19,19728,18848,880,4.5
42063,4/1/19,38662,37222,1440,3.7
42065,4/1/19,20146,19432,714,3.5
42067,4/1/19,12229,11814,415,3.4
42069,4/1/19,104217,100030,4187,4
42071,4/1/19,279779,272105,7674,2.7
42073,4/1/19,40202,38519,1683,4.2
42075,4/1/19,71019,68834,2185,3.1
42077,4/1/19,190545,183236,7309,3.8
42079,4/1/19,156005,148657,7348,4.7
42081,4/1/19,56272,54071,2201,3.9
42083,4/1/19,17038,16314,724,4.2
42085,4/1/19,48543,46692,1851,3.8
42087,4/1/19,20680,19920,760,3.7
42089,4/1/19,81768,78048,3720,4.5
42091,4/1/19,451085,438106,12979,2.9
42093,4/1/19,9067,8799,268,3
42095,4/1/19,159379,153447,5932,3.7
42097,4/1/19,42124,40139,1985,4.7
42099,4/1/19,23961,23290,671,2.8
42101,4/1/19,714395,681917,32478,4.5
42103,4/1/19,24806,23647,1159,4.7
42105,4/1/19,7022,6672,350,5
42107,4/1/19,65186,62239,2947,4.5
42109,4/1/19,19936,19304,632,3.2
42111,4/1/19,32631,31289,1342,4.1
42113,4/1/19,2579,2475,104,4
42115,4/1/19,20021,19276,745,3.7
42117,4/1/19,18661,17858,803,4.3
42119,4/1/19,19393,18812,581,3
42121,4/1/19,22166,21341,825,3.7
42123,4/1/19,18656,17966,690,3.7
42125,4/1/19,105719,101955,3764,3.6
42127,4/1/19,21681,20792,889,4.1
42129,4/1/19,178778,172420,6358,3.6
42131,4/1/19,13394,12865,529,3.9
42133,4/1/19,232701,225598,7103,3.1
44001,4/1/19,25707,25008,699,2.7
44003,4/1/19,89602,87053,2549,2.8
44005,4/1/19,43828,42533,1295,3
44007,4/1/19,321446,310215,11231,3.5
44009,4/1/19,67832,65976,1856,2.7
45001,4/1/19,10013,9733,280,2.8
45003,4/1/19,75655,73627,2028,2.7
45005,4/1/19,2677,2546,131,4.9
45007,4/1/19,90929,88764,2165,2.4
45009,4/1/19,4990,4770,220,4.4
45011,4/1/19,8322,7998,324,3.9
45013,4/1/19,77218,75365,1853,2.4
45015,4/1/19,103849,101456,2393,2.3
45017,4/1/19,6542,6335,207,3.2
45019,4/1/19,211127,206705,4422,2.1
45021,4/1/19,25153,24487,666,2.6
45023,4/1/19,13307,12801,506,3.8
45025,4/1/19,22046,21480,566,2.6
45027,4/1/19,12723,12296,427,3.4
45029,4/1/19,16774,16291,483,2.9
45031,4/1/19,30296,29372,924,3
45033,4/1/19,12925,12456,469,3.6
45035,4/1/19,77988,76236,1752,2.2
45037,4/1/19,10806,10532,274,2.5
45039,4/1/19,9525,9150,375,3.9
45041,4/1/19,66724,64951,1773,2.7
45043,4/1/19,25711,24808,903,3.5
45045,4/1/19,254309,248739,5570,2.2
45047,4/1/19,31338,30458,880,2.8
45049,4/1/19,8373,8172,201,2.4
45051,4/1/19,148542,143713,4829,3.3
45053,4/1/19,12577,12283,294,2.3
45055,4/1/19,29034,28294,740,2.5
45057,4/1/19,40945,39684,1261,3.1
45059,4/1/19,30087,29286,801,2.7
45061,4/1/19,6519,6303,216,3.3
45063,4/1/19,149204,146027,3177,2.1
45065,4/1/19,3411,3319,92,2.7
45067,4/1/19,13085,12562,523,4
45069,4/1/19,9142,8787,355,3.9
45071,4/1/19,19185,18753,432,2.3
45073,4/1/19,34785,33915,870,2.5
45075,4/1/19,34910,33554,1356,3.9
45077,4/1/19,57225,55849,1376,2.4
45079,4/1/19,197612,192657,4955,2.5
45081,4/1/19,8834,8619,215,2.4
45083,4/1/19,152648,149195,3453,2.3
45085,4/1/19,43664,42352,1312,3
45087,4/1/19,11612,11245,367,3.2
45089,4/1/19,12102,11631,471,3.9
45091,4/1/19,139190,135694,3496,2.5
46003,4/1/19,1509,1463,46,3
46005,4/1/19,9577,9256,321,3.4
46007,4/1/19,1075,1018,57,5.3
46009,4/1/19,2806,2714,92,3.3
46011,4/1/19,19152,18541,611,3.2
46013,4/1/19,20795,20133,662,3.2
46015,4/1/19,2427,2349,78,3.2
46017,4/1/19,665,629,36,5.4
46019,4/1/19,4999,4825,174,3.5
46021,4/1/19,759,729,30,4
46023,4/1/19,3671,3536,135,3.7
46025,4/1/19,1852,1769,83,4.5
46027,4/1/19,7776,7530,246,3.2
46029,4/1/19,15434,14920,514,3.3
46031,4/1/19,1339,1269,70,5.2
46033,4/1/19,3961,3774,187,4.7
46035,4/1/19,10998,10662,336,3.1
46037,4/1/19,2678,2536,142,5.3
46039,4/1/19,2149,2030,119,5.5
46041,4/1/19,2154,2038,116,5.4
46043,4/1/19,1548,1500,48,3.1
46045,4/1/19,2029,1965,64,3.2
46047,4/1/19,2955,2829,126,4.3
46049,4/1/19,1023,989,34,3.3
46051,4/1/19,4413,4235,178,4
46053,4/1/19,2021,1942,79,3.9
46055,4/1/19,1031,1000,31,3
46057,4/1/19,3223,3101,122,3.8
46059,4/1/19,1735,1686,49,2.8
46061,4/1/19,1707,1632,75,4.4
46063,4/1/19,697,678,19,2.7
46065,4/1/19,9869,9594,275,2.8
46067,4/1/19,3554,3435,119,3.3
46069,4/1/19,673,647,26,3.9
46071,4/1/19,1235,1157,78,6.3
46073,4/1/19,1098,1065,33,3
46075,4/1/19,518,500,18,3.5
46077,4/1/19,2672,2584,88,3.3
46079,4/1/19,6767,6529,238,3.5
46081,4/1/19,13132,12684,448,3.4
46083,4/1/19,34472,33566,906,2.6
46085,4/1/19,1624,1545,79,4.9
46087,4/1/19,3065,2968,97,3.2
46089,4/1/19,977,937,40,4.1
46091,4/1/19,2283,2179,104,4.6
46093,4/1/19,13948,13446,502,3.6
46095,4/1/19,730,689,41,5.6
46097,4/1/19,1144,1108,36,3.1
46099,4/1/19,112624,109404,3220,2.9
46101,4/1/19,3919,3799,120,3.1
46102,4/1/19,3497,3214,283,8.1
46103,4/1/19,55873,53979,1894,3.4
46105,4/1/19,1401,1356,45,3.2
46107,4/1/19,1008,977,31,3.1
46109,4/1/19,4727,4499,228,4.8
46111,4/1/19,1124,1091,33,2.9
46115,4/1/19,3132,3014,118,3.8
46117,4/1/19,1809,1754,55,3
46119,4/1/19,778,755,23,3
46121,4/1/19,3170,2985,185,5.8
46123,4/1/19,2987,2901,86,2.9
46125,4/1/19,4684,4545,139,3
46127,4/1/19,8471,8206,265,3.1
46129,4/1/19,2075,1944,131,6.3
46135,4/1/19,11986,11624,362,3
46137,4/1/19,912,870,42,4.6
47001,4/1/19,34801,33746,1055,3
47003,4/1/19,21285,20613,672,3.2
47005,4/1/19,6978,6716,262,3.8
47007,4/1/19,4235,4050,185,4.4
47009,4/1/19,63725,62070,1655,2.6
47011,4/1/19,51180,49667,1513,3
47013,4/1/19,14885,14288,597,4
47015,4/1/19,6606,6439,167,2.5
47017,4/1/19,12205,11698,507,4.2
47019,4/1/19,24315,23433,882,3.6
47021,4/1/19,21981,21480,501,2.3
47023,4/1/19,8593,8332,261,3
47025,4/1/19,13179,12697,482,3.7
47027,4/1/19,2723,2561,162,5.9
47029,4/1/19,15077,14495,582,3.9
47031,4/1/19,25567,24857,710,2.8
47033,4/1/19,6978,6768,210,3
47035,4/1/19,23369,22532,837,3.6
47037,4/1/19,406749,397921,8828,2.2
47039,4/1/19,4548,4343,205,4.5
47041,4/1/19,7841,7557,284,3.6
47043,4/1/19,27149,26464,685,2.5
47045,4/1/19,16545,15842,703,4.2
47047,4/1/19,19141,18537,604,3.2
47049,4/1/19,7456,7217,239,3.2
47051,4/1/19,20252,19700,552,2.7
47053,4/1/19,22066,21247,819,3.7
47055,4/1/19,15110,14639,471,3.1
47057,4/1/19,9530,9192,338,3.5
47059,4/1/19,29975,28785,1190,4
47061,4/1/19,5025,4856,169,3.4
47063,4/1/19,28435,27463,972,3.4
47065,4/1/19,184496,179439,5057,2.7
47067,4/1/19,2119,2011,108,5.1
47069,4/1/19,9500,9081,419,4.4
47071,4/1/19,10364,9994,370,3.6
47073,4/1/19,23956,23162,794,3.3
47075,4/1/19,7667,7327,340,4.4
47077,4/1/19,12263,11823,440,3.6
47079,4/1/19,14210,13691,519,3.7
47081,4/1/19,11453,11165,288,2.5
47083,4/1/19,3247,3128,119,3.7
47085,4/1/19,8998,8707,291,3.2
47087,4/1/19,4675,4495,180,3.9
47089,4/1/19,24808,24028,780,3.1
47091,4/1/19,7655,7418,237,3.1
47093,4/1/19,245392,239336,6056,2.5
47095,4/1/19,1762,1676,86,4.9
47097,4/1/19,9681,9212,469,4.8
47099,4/1/19,19297,18566,731,3.8
47101,4/1/19,5140,4948,192,3.7
47103,4/1/19,16822,16378,444,2.6
47105,4/1/19,23511,22830,681,2.9
47107,4/1/19,23592,22830,762,3.2
47109,4/1/19,8410,8029,381,4.5
47111,4/1/19,11221,10932,289,2.6
47113,4/1/19,49355,47802,1553,3.1
47115,4/1/19,12512,12056,456,3.6
47117,4/1/19,15839,15386,453,2.9
47119,4/1/19,49785,48337,1448,2.9
47121,4/1/19,5190,4991,199,3.8
47123,4/1/19,20240,19620,620,3.1
47125,4/1/19,85636,82833,2803,3.3
47127,4/1/19,3641,3558,83,2.3
47129,4/1/19,7903,7626,277,3.5
47131,4/1/19,12563,12078,485,3.9
47133,4/1/19,9803,9487,316,3.2
47135,4/1/19,3193,3055,138,4.3
47137,4/1/19,2370,2273,97,4.1
47139,4/1/19,7361,7124,237,3.2
47141,4/1/19,35102,34090,1012,2.9
47143,4/1/19,13240,12532,708,5.3
47145,4/1/19,23470,22669,801,3.4
47147,4/1/19,38157,37174,983,2.6
47149,4/1/19,185236,181195,4041,2.2
47151,4/1/19,8398,8096,302,3.6
47153,4/1/19,6183,5975,208,3.4
47155,4/1/19,54532,53073,1459,2.7
47157,4/1/19,447453,431345,16108,3.6
47159,4/1/19,9468,9234,234,2.5
47161,4/1/19,5539,5331,208,3.8
47163,4/1/19,71103,68853,2250,3.2
47165,4/1/19,102959,100573,2386,2.3
47167,4/1/19,28218,27269,949,3.4
47169,4/1/19,5452,5301,151,2.8
47171,4/1/19,7158,6831,327,4.6
47173,4/1/19,7641,7380,261,3.4
47175,4/1/19,2079,2002,77,3.7
47177,4/1/19,16760,16198,562,3.4
47179,4/1/19,61169,59370,1799,2.9
47181,4/1/19,6295,6052,243,3.9
47183,4/1/19,16433,15898,535,3.3
47185,4/1/19,12301,11924,377,3.1
47187,4/1/19,129069,126411,2658,2.1
47189,4/1/19,77014,75262,1752,2.3
48001,4/1/19,23689,23107,582,2.5
48003,4/1/19,9863,9695,168,1.7
48005,4/1/19,35582,34370,1212,3.4
48007,4/1/19,9410,9060,350,3.7
48009,4/1/19,4118,4018,100,2.4
48011,4/1/19,926,905,21,2.3
48013,4/1/19,21491,20834,657,3.1
48015,4/1/19,13965,13566,399,2.9
48017,4/1/19,2510,2429,81,3.2
48019,4/1/19,9977,9700,277,2.8
48021,4/1/19,42476,41437,1039,2.4
48023,4/1/19,1722,1689,33,1.9
48025,4/1/19,9826,9462,364,3.7
48027,4/1/19,142943,138318,4625,3.2
48029,4/1/19,940307,915453,24854,2.6
48031,4/1/19,6438,6305,133,2.1
48033,4/1/19,394,386,8,2
48035,4/1/19,8296,8059,237,2.9
48037,4/1/19,39760,38238,1522,3.8
48039,4/1/19,177500,171377,6123,3.4
48041,4/1/19,119124,116563,2561,2.1
48043,4/1/19,4253,4146,107,2.5
48045,4/1/19,591,573,18,3
48047,4/1/19,2585,2480,105,4.1
48049,4/1/19,15650,15187,463,3
48051,4/1/19,8370,8151,219,2.6
48053,4/1/19,23410,22877,533,2.3
48055,4/1/19,19489,18932,557,2.9
48057,4/1/19,12195,11884,311,2.6
48059,4/1/19,6059,5909,150,2.5
48061,4/1/19,165479,157712,7767,4.7
48063,4/1/19,4928,4754,174,3.5
48065,4/1/19,3008,2939,69,2.3
48067,4/1/19,12409,11949,460,3.7
48069,4/1/19,3448,3356,92,2.7
48071,4/1/19,19271,18536,735,3.8
48073,4/1/19,20983,20310,673,3.2
48075,4/1/19,2943,2880,63,2.1
48077,4/1/19,4902,4777,125,2.5
48079,4/1/19,1117,1086,31,2.8
48081,4/1/19,1447,1408,39,2.7
48083,4/1/19,2870,2773,97,3.4
48085,4/1/19,556814,541714,15100,2.7
48087,4/1/19,1140,1112,28,2.5
48089,4/1/19,9721,9454,267,2.7
48091,4/1/19,72649,70825,1824,2.5
48093,4/1/19,5536,5394,142,2.6
48095,4/1/19,1098,1062,36,3.3
48097,4/1/19,19925,19470,455,2.3
48099,4/1/19,23962,23165,797,3.3
48101,4/1/19,553,535,18,3.3
48103,4/1/19,1531,1485,46,3
48105,4/1/19,1654,1620,34,2.1
48107,4/1/19,2488,2408,80,3.2
48109,4/1/19,1025,974,51,5
48111,4/1/19,3903,3842,61,1.6
48113,4/1/19,1347592,1306468,41124,3.1
48115,4/1/19,4597,4445,152,3.3
48117,4/1/19,8418,8220,198,2.4
48119,4/1/19,2431,2360,71,2.9
48121,4/1/19,488569,475935,12634,2.6
48123,4/1/19,9732,9509,223,2.3
48125,4/1/19,684,659,25,3.7
48127,4/1/19,7595,7440,155,2
48129,4/1/19,1475,1439,36,2.4
48131,4/1/19,4957,4775,182,3.7
48133,4/1/19,8424,8182,242,2.9
48135,4/1/19,88227,86437,1790,2
48137,4/1/19,978,958,20,2
48139,4/1/19,91516,89074,2442,2.7
48141,4/1/19,360189,348323,11866,3.3
48143,4/1/19,20576,20065,511,2.5
48145,4/1/19,6525,6343,182,2.8
48147,4/1/19,17170,16768,402,2.3
48149,4/1/19,12426,12144,282,2.3
48151,4/1/19,1624,1586,38,2.3
48153,4/1/19,2570,2467,103,4
48155,4/1/19,581,567,14,2.4
48157,4/1/19,388975,377271,11704,3
48159,4/1/19,4644,4499,145,3.1
48161,4/1/19,6314,6056,258,4.1
48163,4/1/19,10499,10273,226,2.2
48165,4/1/19,9765,9573,192,2
48167,4/1/19,163840,158229,5611,3.4
48169,4/1/19,2184,2131,53,2.4
48171,4/1/19,13454,13167,287,2.1
48173,4/1/19,789,775,14,1.8
48175,4/1/19,3245,3151,94,2.9
48177,4/1/19,9515,9302,213,2.2
48179,4/1/19,8013,7762,251,3.1
48181,4/1/19,63843,62210,1633,2.6
48183,4/1/19,58317,56414,1903,3.3
48185,4/1/19,11260,10888,372,3.3
48187,4/1/19,80728,78715,2013,2.5
48189,4/1/19,12341,11880,461,3.7
48191,4/1/19,1083,1045,38,3.5
48193,4/1/19,3632,3543,89,2.5
48195,4/1/19,2761,2705,56,2
48197,4/1/19,1715,1671,44,2.6
48199,4/1/19,25209,24258,951,3.8
48201,4/1/19,2296434,2220622,75812,3.3
48203,4/1/19,29392,28406,986,3.4
48205,4/1/19,2786,2750,36,1.3
48207,4/1/19,2268,2195,73,3.2
48209,4/1/19,118789,116086,2703,2.3
48211,4/1/19,1951,1902,49,2.5
48213,4/1/19,36428,35334,1094,3
48215,4/1/19,349258,331640,17618,5
48217,4/1/19,16234,15788,446,2.7
48219,4/1/19,11358,11077,281,2.5
48221,4/1/19,27231,26446,785,2.9
48223,4/1/19,17404,16940,464,2.7
48225,4/1/19,10063,9807,256,2.5
48227,4/1/19,13873,13515,358,2.6
48229,4/1/19,1811,1746,65,3.6
48231,4/1/19,42828,41524,1304,3
48233,4/1/19,8622,8309,313,3.6
48235,4/1/19,760,745,15,2
48237,4/1/19,3463,3373,90,2.6
48239,4/1/19,7500,7302,198,2.6
48241,4/1/19,12796,12132,664,5.2
48243,4/1/19,1057,1033,24,2.3
48245,4/1/19,106273,101151,5122,4.8
48247,4/1/19,1911,1831,80,4.2
48249,4/1/19,16993,16327,666,3.9
48251,4/1/19,81143,78969,2174,2.7
48253,4/1/19,5677,5479,198,3.5
48255,4/1/19,7101,6948,153,2.2
48257,4/1/19,63728,61956,1772,2.8
48259,4/1/19,21943,21439,504,2.3
48261,4/1/19,242,236,6,2.5
48263,4/1/19,484,475,9,1.9
48265,4/1/19,22032,21489,543,2.5
48267,4/1/19,1857,1811,46,2.5
48269,4/1/19,236,231,5,2.1
48271,4/1/19,1372,1326,46,3.4
48273,4/1/19,13473,12988,485,3.6
48275,4/1/19,1444,1403,41,2.8
48277,4/1/19,23910,23194,716,3
48279,4/1/19,5293,5115,178,3.4
48281,4/1/19,9158,8906,252,2.8
48283,4/1/19,4351,4268,83,1.9
48285,4/1/19,8604,8380,224,2.6
48287,4/1/19,10413,10195,218,2.1
48289,4/1/19,6239,6026,213,3.4
48291,4/1/19,32676,31318,1358,4.2
48293,4/1/19,8480,8197,283,3.3
48295,4/1/19,1700,1664,36,2.1
48297,4/1/19,5433,5285,148,2.7
48299,4/1/19,8501,8245,256,3
48301,4/1/19,502,498,4,0.8
48303,4/1/19,157842,154221,3621,2.3
48305,4/1/19,2773,2700,73,2.6
48307,4/1/19,3552,3359,193,5.4
48309,4/1/19,118680,115415,3265,2.8
48311,4/1/19,772,761,11,1.4
48313,4/1/19,4565,4411,154,3.4
48315,4/1/19,4246,4092,154,3.6
48317,4/1/19,2871,2818,53,1.8
48319,4/1/19,1768,1719,49,2.8
48321,4/1/19,16642,15867,775,4.7
48323,4/1/19,24085,22358,1727,7.2
48325,4/1/19,21627,21047,580,2.7
48327,4/1/19,851,825,26,3.1
48329,4/1/19,107251,105471,1780,1.7
48331,4/1/19,9735,9298,437,4.5
48333,4/1/19,1861,1807,54,2.9
48335,4/1/19,2313,2245,68,2.9
48337,4/1/19,9222,8991,231,2.5
48339,4/1/19,281540,273430,8110,2.9
48341,4/1/19,10931,10725,206,1.9
48343,4/1/19,4781,4562,219,4.6
48345,4/1/19,483,469,14,2.9
48347,4/1/19,28065,27233,832,3
48349,4/1/19,23559,22839,720,3.1
48351,4/1/19,5140,4878,262,5.1
48353,4/1/19,6883,6716,167,2.4
48355,4/1/19,167053,161286,5767,3.5
48357,4/1/19,4311,4217,94,2.2
48359,4/1/19,914,891,23,2.5
48361,4/1/19,36223,34660,1563,4.3
48363,4/1/19,13529,13169,360,2.7
48365,4/1/19,10236,9904,332,3.2
48367,4/1/19,66556,64918,1638,2.5
48369,4/1/19,4873,4780,93,1.9
48371,4/1/19,6381,6202,179,2.8
48373,4/1/19,17811,17122,689,3.9
48375,4/1/19,55008,53788,1220,2.2
48377,4/1/19,3060,2905,155,5.1
48379,4/1/19,6167,6012,155,2.5
48381,4/1/19,71934,70480,1454,2
48383,4/1/19,1940,1904,36,1.9
48385,4/1/19,1059,1024,35,3.3
48387,4/1/19,5097,4895,202,4
48389,4/1/19,10936,10774,162,1.5
48391,4/1/19,3154,3057,97,3.1
48393,4/1/19,405,392,13,3.2
48395,4/1/19,7660,7428,232,3
48397,4/1/19,51427,50061,1366,2.7
48399,4/1/19,4585,4480,105,2.3
48401,4/1/19,23005,22341,664,2.9
48403,4/1/19,3723,3527,196,5.3
48405,4/1/19,3395,3270,125,3.7
48407,4/1/19,11665,11229,436,3.7
48409,4/1/19,29736,28411,1325,4.5
48411,4/1/19,2569,2504,65,2.5
48413,4/1/19,1316,1288,28,2.1
48415,4/1/19,6677,6499,178,2.7
48417,4/1/19,1906,1873,33,1.7
48419,4/1/19,11006,10650,356,3.2
48421,4/1/19,1370,1344,26,1.9
48423,4/1/19,107114,104063,3051,2.8
48425,4/1/19,4307,4179,128,3
48427,4/1/19,25222,23262,1960,7.8
48429,4/1/19,4167,4059,108,2.6
48431,4/1/19,578,560,18,3.1
48433,4/1/19,581,566,15,2.6
48435,4/1/19,1507,1462,45,3
48437,4/1/19,2627,2544,83,3.2
48439,4/1/19,1069781,1039477,30304,2.8
48441,4/1/19,66431,64819,1612,2.4
48443,4/1/19,376,366,10,2.7
48445,4/1/19,5032,4867,165,3.3
48447,4/1/19,649,630,19,2.9
48449,4/1/19,12887,12426,461,3.6
48451,4/1/19,54546,53170,1376,2.5
48453,4/1/19,735216,719042,16174,2.2
48455,4/1/19,5243,5037,206,3.9
48457,4/1/19,7072,6741,331,4.7
48459,4/1/19,17875,17321,554,3.1
48461,4/1/19,1683,1638,45,2.7
48463,4/1/19,11506,11129,377,3.3
48465,4/1/19,22882,22238,644,2.8
48467,4/1/19,25937,25219,718,2.8
48469,4/1/19,42486,41241,1245,2.9
48471,4/1/19,24005,23264,741,3.1
48473,4/1/19,23218,22516,702,3
48475,4/1/19,7453,7314,139,1.9
48477,4/1/19,15030,14619,411,2.7
48479,4/1/19,117804,114000,3804,3.2
48481,4/1/19,21529,20920,609,2.8
48483,4/1/19,2240,2181,59,2.6
48485,4/1/19,55964,54464,1500,2.7
48487,4/1/19,4964,4821,143,2.9
48489,4/1/19,6558,6042,516,7.9
48491,4/1/19,311346,303834,7512,2.4
48493,4/1/19,24658,24063,595,2.4
48495,4/1/19,3918,3830,88,2.2
48497,4/1/19,31488,30651,837,2.7
48499,4/1/19,17504,16915,589,3.4
48501,4/1/19,3756,3670,86,2.3
48503,4/1/19,8034,7837,197,2.5
48505,4/1/19,5265,5046,219,4.2
48507,4/1/19,3267,3034,233,7.1
49001,4/1/19,3006,2917,89,3
49003,4/1/19,25806,25145,661,2.6
49005,4/1/19,64806,63394,1412,2.2
49007,4/1/19,8437,8117,320,3.8
49009,4/1/19,407,391,16,3.9
49011,4/1/19,171824,167620,4204,2.4
49013,4/1/19,7709,7391,318,4.1
49015,4/1/19,4310,4139,171,4
49017,4/1/19,2828,2679,149,5.3
49019,4/1/19,6239,6059,180,2.9
49021,4/1/19,24049,23341,708,2.9
49023,4/1/19,5671,5537,134,2.4
49025,4/1/19,3758,3646,112,3
49027,4/1/19,6176,6003,173,2.8
49029,4/1/19,5518,5378,140,2.5
49031,4/1/19,484,463,21,4.3
49033,4/1/19,1062,1025,37,3.5
49035,4/1/19,626003,609598,16405,2.6
49037,4/1/19,5696,5431,265,4.7
49039,4/1/19,12673,12285,388,3.1
49041,4/1/19,9729,9425,304,3.1
49043,4/1/19,23492,22794,698,3
49045,4/1/19,33512,32558,954,2.8
49047,4/1/19,13587,13041,546,4
49049,4/1/19,305180,297907,7273,2.4
49051,4/1/19,15395,14944,451,2.9
49053,4/1/19,75564,73339,2225,2.9
49055,4/1/19,1460,1395,65,4.5
49057,4/1/19,126223,122540,3683,2.9
50001,4/1/19,20438,19982,456,2.2
50003,4/1/19,17995,17451,544,3
50005,4/1/19,14383,13893,490,3.4
50007,4/1/19,96144,94627,1517,1.6
50009,4/1/19,2669,2567,102,3.8
50011,4/1/19,27405,26735,670,2.4
50013,4/1/19,4047,3921,126,3.1
50015,4/1/19,13774,13204,570,4.1
50017,4/1/19,15826,15384,442,2.8
50019,4/1/19,13411,12682,729,5.4
50021,4/1/19,30148,29235,913,3
50023,4/1/19,34134,33295,839,2.5
50025,4/1/19,21808,21205,603,2.8
50027,4/1/19,28443,27792,651,2.3
51001,4/1/19,16491,15962,529,3.2
51003,4/1/19,57982,56782,1200,2.1
51005,4/1/19,6854,6661,193,2.8
51007,4/1/19,6235,6055,180,2.9
51009,4/1/19,15086,14690,396,2.6
51011,4/1/19,7162,6963,199,2.8
51013,4/1/19,154287,151709,2578,1.7
51015,4/1/19,37491,36711,780,2.1
51017,4/1/19,2409,2360,49,2
51019,4/1/19,38628,37701,927,2.4
51021,4/1/19,2862,2799,63,2.2
51023,4/1/19,17432,17059,373,2.1
51025,4/1/19,6041,5790,251,4.2
51027,4/1/19,6744,6442,302,4.5
51029,4/1/19,6477,6248,229,3.5
51031,4/1/19,26148,25438,710,2.7
51033,4/1/19,15211,14791,420,2.8
51035,4/1/19,13230,12839,391,3
51036,4/1/19,3642,3530,112,3.1
51037,4/1/19,5255,5100,155,2.9
51041,4/1/19,187487,182994,4493,2.4
51043,4/1/19,7536,7369,167,2.2
51045,4/1/19,2296,2236,60,2.6
51047,4/1/19,24441,23893,548,2.2
51049,4/1/19,4648,4533,115,2.5
51051,4/1/19,4658,4463,195,4.2
51053,4/1/19,13605,13206,399,2.9
51057,4/1/19,5495,5324,171,3.1
51059,4/1/19,634283,621587,12696,2
51061,4/1/19,36970,36193,777,2.1
51063,4/1/19,8271,8100,171,2.1
51065,4/1/19,14133,13852,281,2
51067,4/1/19,26369,25696,673,2.6
51069,4/1/19,47918,46888,1030,2.1
51071,4/1/19,8042,7828,214,2.7
51073,4/1/19,19529,19086,443,2.3
51075,4/1/19,11176,10905,271,2.4
51077,4/1/19,8082,7890,192,2.4
51079,4/1/19,10635,10425,210,2
51081,4/1/19,4285,4152,133,3.1
51083,4/1/19,15830,15297,533,3.4
51085,4/1/19,59199,57946,1253,2.1
51087,4/1/19,182106,177650,4456,2.4
51089,4/1/19,23925,23222,703,2.9
51091,4/1/19,1206,1177,29,2.4
51093,4/1/19,19388,18894,494,2.5
51095,4/1/19,36555,35713,842,2.3
51097,4/1/19,3855,3758,97,2.5
51099,4/1/19,13271,12961,310,2.3
51101,4/1/19,9109,8903,206,2.3
51103,4/1/19,5431,5179,252,4.6
51105,4/1/19,8292,8036,256,3.1
51107,4/1/19,222259,217737,4522,2
51109,4/1/19,19994,19539,455,2.3
51111,4/1/19,5359,5205,154,2.9
51113,4/1/19,7320,7172,148,2
51115,4/1/19,4134,4026,108,2.6
51117,4/1/19,12612,12182,430,3.4
51119,4/1/19,5230,5113,117,2.2
51121,4/1/19,51350,50187,1163,2.3
51125,4/1/19,7498,7313,185,2.5
51127,4/1/19,12459,12201,258,2.1
51131,4/1/19,5302,5063,239,4.5
51133,4/1/19,5640,5374,266,4.7
51135,4/1/19,7278,7101,177,2.4
51137,4/1/19,17254,16806,448,2.6
51139,4/1/19,11959,11559,400,3.3
51141,4/1/19,7433,7205,228,3.1
51143,4/1/19,30070,29164,906,3
51145,4/1/19,14107,13811,296,2.1
51147,4/1/19,10480,10184,296,2.8
51149,4/1/19,15065,14625,440,2.9
51153,4/1/19,245221,239832,5389,2.2
51155,4/1/19,16424,15981,443,2.7
51157,4/1/19,3654,3570,84,2.3
51159,4/1/19,4057,3949,108,2.7
51161,4/1/19,49534,48466,1068,2.2
51163,4/1/19,10738,10495,243,2.3
51165,4/1/19,42021,41139,882,2.1
51167,4/1/19,11156,10768,388,3.5
51169,4/1/19,9135,8876,259,2.8
51171,4/1/19,22143,21662,481,2.2
51173,4/1/19,13677,13259,418,3.1
51175,4/1/19,9044,8842,202,2.2
51177,4/1/19,66864,65174,1690,2.5
51179,4/1/19,71955,70232,1723,2.4
51181,4/1/19,3615,3514,101,2.8
51183,4/1/19,3738,3584,154,4.1
51185,4/1/19,15981,15396,585,3.7
51187,4/1/19,20362,19846,516,2.5
51191,4/1/19,26741,25990,751,2.8
51193,4/1/19,9412,9113,299,3.2
51195,4/1/19,13341,12806,535,4
51197,4/1/19,13672,13276,396,2.9
51199,4/1/19,32763,32019,744,2.3
51510,4/1/19,101273,99365,1908,1.9
51520,4/1/19,7197,6968,229,3.2
51530,4/1/19,3407,3332,75,2.2
51540,4/1/19,26866,26342,524,2
51550,4/1/19,122732,119624,3108,2.5
51570,4/1/19,8797,8554,243,2.8
51580,4/1/19,2367,2287,80,3.4
51590,4/1/19,19129,18178,951,5
51595,4/1/19,2297,2183,114,5
51600,4/1/19,13443,13180,263,2
51610,4/1/19,8586,8435,151,1.8
51620,4/1/19,3566,3444,122,3.4
51630,4/1/19,14123,13714,409,2.9
51640,4/1/19,2924,2843,81,2.8
51650,4/1/19,64340,62193,2147,3.3
51660,4/1/19,25156,24492,664,2.6
51670,4/1/19,9662,9306,356,3.7
51678,4/1/19,2100,2023,77,3.7
51680,4/1/19,36495,35413,1082,3
51683,4/1/19,22020,21539,481,2.2
51685,4/1/19,9360,9154,206,2.2
51690,4/1/19,5474,5281,193,3.5
51700,4/1/19,88840,86119,2721,3.1
51710,4/1/19,111681,108251,3430,3.1
51720,4/1/19,1663,1616,47,2.8
51730,4/1/19,12988,12346,642,4.9
51735,4/1/19,6367,6231,136,2.1
51740,4/1/19,44271,42730,1541,3.5
51750,4/1/19,8850,8609,241,2.7
51760,4/1/19,118232,114840,3392,2.9
51770,4/1/19,49324,48027,1297,2.6
51775,4/1/19,13027,12721,306,2.3
51790,4/1/19,12288,12006,282,2.3
51800,4/1/19,44621,43441,1180,2.6
51810,4/1/19,233140,227587,5553,2.4
51820,4/1/19,10750,10479,271,2.5
51830,4/1/19,6663,6457,206,3.1
51840,4/1/19,14693,14328,365,2.5
53001,4/1/19,9760,9213,547,5.6
53003,4/1/19,10320,9876,444,4.3
53005,4/1/19,101508,96145,5363,5.3
53007,4/1/19,43038,40824,2214,5.1
53009,4/1/19,28501,26560,1941,6.8
53011,4/1/19,239613,227833,11780,4.9
53013,4/1/19,1836,1738,98,5.3
53015,4/1/19,47578,44621,2957,6.2
53017,4/1/19,21479,20207,1272,5.9
53019,4/1/19,2525,2200,325,12.9
53021,4/1/19,42696,39974,2722,6.4
53023,4/1/19,890,843,47,5.3
53025,4/1/19,45981,42767,3214,7
53027,4/1/19,28686,26575,2111,7.4
53029,4/1/19,35525,33676,1849,5.2
53031,4/1/19,12687,11926,761,6
53033,4/1/19,1280932,1250940,29992,2.3
53035,4/1/19,127232,121159,6073,4.8
53037,4/1/19,23479,22194,1285,5.5
53039,4/1/19,10096,9461,635,6.3
53041,4/1/19,34649,32464,2185,6.3
53043,4/1/19,4962,4689,273,5.5
53045,4/1/19,24661,23037,1624,6.6
53047,4/1/19,19676,18193,1483,7.5
53049,4/1/19,8412,7775,637,7.6
53051,4/1/19,5027,4627,400,8
53053,4/1/19,437615,414451,23164,5.3
53055,4/1/19,8181,7837,344,4.2
53057,4/1/19,62577,59226,3351,5.4
53059,4/1/19,5488,5195,293,5.3
53061,4/1/19,435804,424878,10926,2.5
53063,4/1/19,253017,239380,13637,5.4
53065,4/1/19,19080,17567,1513,7.9
53067,4/1/19,141797,134643,7154,5
53069,4/1/19,1353,1257,96,7.1
53071,4/1/19,29890,28428,1462,4.9
53073,4/1/19,115201,109512,5689,4.9
53075,4/1/19,24692,23671,1021,4.1
53077,4/1/19,129058,119608,9450,7.3
54001,4/1/19,7187,6825,362,5
54003,4/1/19,57642,55752,1890,3.3
54005,4/1/19,7319,6979,340,4.6
54007,4/1/19,5176,4806,370,7.1
54009,4/1/19,9916,9476,440,4.4
54011,4/1/19,41201,39645,1556,3.8
54013,4/1/19,2563,2236,327,12.8
54015,4/1/19,3081,2850,231,7.5
54017,4/1/19,3998,3840,158,4
54019,4/1/19,16024,15238,786,4.9
54021,4/1/19,2413,2252,161,6.7
54023,4/1/19,5896,5624,272,4.6
54025,4/1/19,15609,14957,652,4.2
54027,4/1/19,10568,10212,356,3.4
54029,4/1/19,13027,12418,609,4.7
54031,4/1/19,5703,5438,265,4.6
54033,4/1/19,34642,33247,1395,4
54035,4/1/19,12999,12372,627,4.8
54037,4/1/19,30419,29627,792,2.6
54039,4/1/19,81543,78025,3518,4.3
54041,4/1/19,6720,6340,380,5.7
54043,4/1/19,7111,6719,392,5.5
54045,4/1/19,11026,10420,606,5.5
54047,4/1/19,4398,3981,417,9.5
54049,4/1/19,25792,24595,1197,4.6
54051,4/1/19,14161,13249,912,6.4
54053,4/1/19,10264,9753,511,5
54055,4/1/19,21035,20000,1035,4.9
54057,4/1/19,12537,11983,554,4.4
54059,4/1/19,6804,6414,390,5.7
54061,4/1/19,54644,52863,1781,3.3
54063,4/1/19,5921,5689,232,3.9
54065,4/1/19,8076,7782,294,3.6
54067,4/1/19,9422,8885,537,5.7
54069,4/1/19,21137,20231,906,4.3
54071,4/1/19,3646,3506,140,3.8
54073,4/1/19,2902,2708,194,6.7
54075,4/1/19,3746,3419,327,8.7
54077,4/1/19,15528,14879,649,4.2
54079,4/1/19,26564,25455,1109,4.2
54081,4/1/19,30172,28859,1313,4.4
54083,4/1/19,12367,11598,769,6.2
54085,4/1/19,4351,4134,217,5
54087,4/1/19,5141,4628,513,10
54089,4/1/19,4286,4069,217,5.1
54091,4/1/19,7920,7576,344,4.3
54093,4/1/19,3229,3058,171,5.3
54095,4/1/19,3132,2904,228,7.3
54097,4/1/19,9683,9180,503,5.2
54099,4/1/19,15693,14890,803,5.1
54101,4/1/19,3244,3074,170,5.2
54103,4/1/19,6616,6150,466,7
54105,4/1/19,2269,2114,155,6.8
54107,4/1/19,36656,34993,1663,4.5
54109,4/1/19,6676,6234,442,6.6
55001,4/1/19,8049,7656,393,4.9
55003,4/1/19,7660,7246,414,5.4
55005,4/1/19,24365,23288,1077,4.4
55007,4/1/19,7377,6867,510,6.9
55009,4/1/19,140921,136875,4046,2.9
55011,4/1/19,6461,6184,277,4.3
55013,4/1/19,7029,6619,410,5.8
55015,4/1/19,27319,26617,702,2.6
55017,4/1/19,33334,32027,1307,3.9
55019,4/1/19,17659,17073,586,3.3
55021,4/1/19,31366,30423,943,3
55023,4/1/19,7563,7218,345,4.6
55025,4/1/19,319123,311900,7223,2.3
55027,4/1/19,46959,45684,1275,2.7
55029,4/1/19,14075,13457,618,4.4
55031,4/1/19,23099,22104,995,4.3
55033,4/1/19,24775,23891,884,3.6
55035,4/1/19,59087,57373,1714,2.9
55037,4/1/19,2173,2067,106,4.9
55039,4/1/19,56928,55486,1442,2.5
55041,4/1/19,4005,3759,246,6.1
55043,4/1/19,28439,27593,846,3
55045,4/1/19,20841,20285,556,2.7
55047,4/1/19,9346,9020,326,3.5
55049,4/1/19,13594,13211,383,2.8
55051,4/1/19,2458,2288,170,6.9
55053,4/1/19,10258,9857,401,3.9
55055,4/1/19,45435,44147,1288,2.8
55057,4/1/19,13429,12989,440,3.3
55059,4/1/19,88560,85290,3270,3.7
55061,4/1/19,10924,10609,315,2.9
55063,4/1/19,66607,64828,1779,2.7
55065,4/1/19,10113,9867,246,2.4
55067,4/1/19,9356,8984,372,4
55069,4/1/19,14902,14313,589,4
55071,4/1/19,40837,39568,1269,3.1
55073,4/1/19,72817,70759,2058,2.8
55075,4/1/19,19361,18550,811,4.2
55077,4/1/19,7637,7352,285,3.7
55078,4/1/19,1627,1494,133,8.2
55079,4/1/19,462608,445937,16671,3.6
55081,4/1/19,23173,22539,634,2.7
55083,4/1/19,20422,19676,746,3.7
55085,4/1/19,17360,16495,865,5
55087,4/1/19,102513,99509,3004,2.9
55089,4/1/19,48497,47222,1275,2.6
55091,4/1/19,4129,3964,165,4
55093,4/1/19,25133,24258,875,3.5
55095,4/1/19,24347,23271,1076,4.4
55097,4/1/19,38892,37696,1196,3.1
55099,4/1/19,6381,6110,271,4.2
55101,4/1/19,98147,94459,3688,3.8
55103,4/1/19,9203,8940,263,2.9
55105,4/1/19,84888,82052,2836,3.3
55107,4/1/19,6811,6421,390,5.7
55109,4/1/19,49985,48260,1725,3.5
55111,4/1/19,34852,33824,1028,2.9
55113,4/1/19,7607,7154,453,6
55115,4/1/19,20838,20173,665,3.2
55117,4/1/19,61526,59991,1535,2.5
55119,4/1/19,10903,10463,440,4
55121,4/1/19,15940,15338,602,3.8
55123,4/1/19,15261,14768,493,3.2
55125,4/1/19,9480,8952,528,5.6
55127,4/1/19,57586,55870,1716,3
55129,4/1/19,7635,7304,331,4.3
55131,4/1/19,76559,74536,2023,2.6
55133,4/1/19,222865,216833,6032,2.7
55135,4/1/19,25849,25009,840,3.2
55137,4/1/19,11253,10851,402,3.6
55139,4/1/19,91093,88560,2533,2.8
55141,4/1/19,34809,33534,1275,3.7
56001,4/1/19,20830,20259,571,2.7
56003,4/1/19,5162,4922,240,4.6
56005,4/1/19,23133,22410,723,3.1
56007,4/1/19,7537,7283,254,3.4
56009,4/1/19,8404,8185,219,2.6
56011,4/1/19,3547,3435,112,3.2
56013,4/1/19,18419,17679,740,4
56015,4/1/19,6518,6291,227,3.5
56017,4/1/19,2146,2079,67,3.1
56019,4/1/19,4054,3902,152,3.7
56021,4/1/19,48719,47143,1576,3.2
56023,4/1/19,8580,8302,278,3.2
56025,4/1/19,39423,38000,1423,3.6
56027,4/1/19,1205,1176,29,2.4
56029,4/1/19,14544,13964,580,4
56031,4/1/19,4824,4680,144,3
56033,4/1/19,15546,15031,515,3.3
56035,4/1/19,3923,3766,157,4
56037,4/1/19,21472,20684,788,3.7
56039,4/1/19,13995,13434,561,4
56041,4/1/19,9030,8672,358,4
56043,4/1/19,3894,3745,149,3.8
56045,4/1/19,3819,3701,118,3.1
72001,4/1/19,4131,3490,641,15.5
72003,4/1/19,11904,10756,1148,9.6
72005,4/1/19,14459,13107,1352,9.4
72007,4/1/19,6440,5894,546,8.5
72009,4/1/19,6379,5718,661,10.4
72011,4/1/19,8801,8113,688,7.8
72013,4/1/19,23665,21588,2077,8.8
72015,4/1/19,4674,4090,584,12.5
72017,4/1/19,5850,5215,635,10.9
72019,4/1/19,7238,6641,597,8.2
72021,4/1/19,64513,60764,3749,5.8
72023,4/1/19,13439,12337,1102,8.2
72025,4/1/19,47177,44220,2957,6.3
72027,4/1/19,9387,8661,726,7.7
72029,4/1/19,15828,14879,949,6
72031,4/1/19,60694,57458,3236,5.3
72033,4/1/19,7740,7225,515,6.7
72035,4/1/19,15912,14894,1018,6.4
72037,4/1/19,3698,3318,380,10.3
72039,4/1/19,3621,3265,356,9.8
72041,4/1/19,15336,14334,1002,6.5
72043,4/1/19,9836,8703,1133,11.5
72045,4/1/19,4814,4418,396,8.2
72047,4/1/19,8782,8028,754,8.6
72049,4/1/19,888,864,24,2.7
72051,4/1/19,13002,12318,684,5.3
72053,4/1/19,10882,9747,1135,10.4
72054,4/1/19,3302,2937,365,11.1
72055,4/1/19,3888,3362,526,13.5
72057,4/1/19,11098,9844,1254,11.3
72059,4/1/19,5179,4507,672,13
72061,4/1/19,37248,35835,1413,3.8
72063,4/1/19,17862,16906,956,5.4
72065,4/1/19,13503,11866,1637,12.1
72067,4/1/19,5356,4920,436,8.1
72069,4/1/19,17001,15331,1670,9.8
72071,4/1/19,12243,11199,1044,8.5
72073,4/1/19,4240,3641,599,14.1
72075,4/1/19,14871,13466,1405,9.4
72077,4/1/19,12079,11148,931,7.7
72079,4/1/19,5105,4494,611,12
72081,4/1/19,6795,5793,1002,14.7
72083,4/1/19,2657,2358,299,11.3
72085,4/1/19,11121,10196,925,8.3
72087,4/1/19,8270,7717,553,6.7
72089,4/1/19,6106,5575,531,8.7
72091,4/1/19,11305,10449,856,7.6
72093,4/1/19,1906,1647,259,13.6
72095,4/1/19,2958,2489,469,15.9
72097,4/1/19,21746,19578,2168,10
72099,4/1/19,10418,9403,1015,9.7
72101,4/1/19,7848,7173,675,8.6
72103,4/1/19,8016,7357,659,8.2
72105,4/1/19,6947,6412,535,7.7
72107,4/1/19,4874,4407,467,9.6
72109,4/1/19,4380,3690,690,15.8
72111,4/1/19,5857,5050,807,13.8
72113,4/1/19,45231,41070,4161,9.2
72115,4/1/19,6025,5359,666,11.1
72117,4/1/19,4828,4127,701,14.5
72119,4/1/19,16713,15549,1164,7
72121,4/1/19,6023,5271,752,12.5
72123,4/1/19,7045,6109,936,13.3
72125,4/1/19,9659,8606,1053,10.9
72127,4/1/19,132727,125971,6756,5.1
72129,4/1/19,11523,10576,947,8.2
72131,4/1/19,10202,8824,1378,13.5
72133,4/1/19,8495,7732,763,9
72135,4/1/19,26793,25360,1433,5.3
72137,4/1/19,28840,27292,1548,5.4
72139,4/1/19,26761,25549,1212,4.5
72141,4/1/19,6610,5898,712,10.8
72143,4/1/19,9563,8853,710,7.4
72145,4/1/19,13053,11878,1175,9
72147,4/1/19,2690,2506,184,6.8
72149,4/1/19,7492,6278,1214,16.2
72151,4/1/19,8679,7622,1057,12.2
72153,4/1/19,9706,8323,1383,14.2
1001,5/1/19,26271,25680,591,2.2
1003,5/1/19,98311,96129,2182,2.2
1005,5/1/19,8416,8152,264,3.1
1007,5/1/19,8605,8391,214,2.5
1009,5/1/19,25136,24589,547,2.2
1011,5/1/19,4748,4622,126,2.7
1013,5/1/19,9403,9143,260,2.8
1015,5/1/19,46092,44729,1363,3
1017,5/1/19,15612,15243,369,2.4
1019,5/1/19,11644,11363,281,2.4
1021,5/1/19,19603,19175,428,2.2
1023,5/1/19,4589,4420,169,3.7
1025,5/1/19,7544,7205,339,4.5
1027,5/1/19,6019,5869,150,2.5
1029,5/1/19,5757,5608,149,2.6
1031,5/1/19,21433,20923,510,2.4
1033,5/1/19,23572,22847,725,3.1
1035,5/1/19,4501,4361,140,3.1
1037,5/1/19,4543,4435,108,2.4
1039,5/1/19,15522,15100,422,2.7
1041,5/1/19,6492,6358,134,2.1
1043,5/1/19,38507,37672,835,2.2
1045,5/1/19,20687,20158,529,2.6
1047,5/1/19,14564,13919,645,4.4
1049,5/1/19,30909,30194,715,2.3
1051,5/1/19,37733,36939,794,2.1
1053,5/1/19,14653,14232,421,2.9
1055,5/1/19,42724,41553,1171,2.7
1057,5/1/19,6575,6403,172,2.6
1059,5/1/19,14645,14315,330,2.3
1061,5/1/19,10930,10668,262,2.4
1063,5/1/19,2885,2743,142,4.9
1065,5/1/19,5972,5777,195,3.3
1067,5/1/19,6907,6698,209,3
1069,5/1/19,45999,44834,1165,2.5
1071,5/1/19,23583,22952,631,2.7
1073,5/1/19,316624,309094,7530,2.4
1075,5/1/19,5826,5683,143,2.5
1077,5/1/19,42572,41400,1172,2.8
1079,5/1/19,14224,13858,366,2.6
1081,5/1/19,75563,73850,1713,2.3
1083,5/1/19,43647,42690,957,2.2
1085,5/1/19,3566,3393,173,4.9
1087,5/1/19,7781,7494,287,3.7
1089,5/1/19,184561,180683,3878,2.1
1091,5/1/19,7713,7497,216,2.8
1093,5/1/19,12965,12589,376,2.9
1095,5/1/19,44139,43254,885,2
1097,5/1/19,187604,181808,5796,3.1
1099,5/1/19,7282,6992,290,4
1101,5/1/19,106041,103365,2676,2.5
1103,5/1/19,58008,56803,1205,2.1
1105,5/1/19,3360,3217,143,4.3
1107,5/1/19,7796,7567,229,2.9
1109,5/1/19,15167,14754,413,2.7
1111,5/1/19,9574,9334,240,2.5
1113,5/1/19,23877,23314,563,2.4
1115,5/1/19,40277,39380,897,2.2
1117,5/1/19,115296,113240,2056,1.8
1119,5/1/19,4832,4648,184,3.8
1121,5/1/19,35577,34554,1023,2.9
1123,5/1/19,18886,18451,435,2.3
1125,5/1/19,103958,101499,2459,2.4
1127,5/1/19,25173,24512,661,2.6
1129,5/1/19,6733,6476,257,3.8
1131,5/1/19,2664,2510,154,5.8
1133,5/1/19,9942,9667,275,2.8
2013,5/1/19,1380,1299,81,5.9
2016,5/1/19,2659,2503,156,5.9
2020,5/1/19,147570,140048,7522,5.1
2050,5/1/19,6836,5944,892,13
2060,5/1/19,427,407,20,4.7
2068,5/1/19,1385,1317,68,4.9
2070,5/1/19,1842,1676,166,9
2090,5/1/19,44943,42565,2378,5.3
2100,5/1/19,1193,1113,80,6.7
2105,5/1/19,1309,1209,100,7.6
2110,5/1/19,17692,16941,751,4.2
2122,5/1/19,26697,25053,1644,6.2
2130,5/1/19,7095,6687,408,5.8
2150,5/1/19,5726,5417,309,5.4
2158,5/1/19,2703,2160,543,20.1
2164,5/1/19,708,640,68,9.6
2170,5/1/19,47059,43893,3166,6.7
2180,5/1/19,3991,3543,448,11.2
2185,5/1/19,3394,3171,223,6.6
2188,5/1/19,2865,2452,413,14.4
2195,5/1/19,1343,1234,109,8.1
2198,5/1/19,2870,2610,260,9.1
2220,5/1/19,4507,4327,180,4
2230,5/1/19,1018,981,37,3.6
2240,5/1/19,2836,2603,233,8.2
2261,5/1/19,4797,4465,332,6.9
2275,5/1/19,1042,972,70,6.7
2282,5/1/19,260,244,16,6.2
2290,5/1/19,2470,2114,356,14.4
4001,5/1/19,20053,18237,1816,9.1
4003,5/1/19,50168,47420,2748,5.5
4005,5/1/19,76964,73090,3874,5
4007,5/1/19,21743,20613,1130,5.2
4009,5/1/19,15427,14709,718,4.7
4011,5/1/19,4440,4263,177,4
4012,5/1/19,8854,8336,518,5.9
4013,5/1/19,2284186,2193969,90217,3.9
4015,5/1/19,87815,83022,4793,5.5
4017,5/1/19,40953,38198,2755,6.7
4019,5/1/19,497207,475787,21420,4.3
4021,5/1/19,183927,175153,8774,4.8
4023,5/1/19,19495,18221,1274,6.5
4025,5/1/19,106679,102109,4570,4.3
4027,5/1/19,96746,80115,16631,17.2
5001,5/1/19,9449,9179,270,2.9
5003,5/1/19,7887,7508,379,4.8
5005,5/1/19,16433,15815,618,3.8
5007,5/1/19,136599,133276,3323,2.4
5009,5/1/19,16176,15700,476,2.9
5011,5/1/19,4473,4298,175,3.9
5013,5/1/19,2462,2358,104,4.2
5015,5/1/19,12861,12513,348,2.7
5017,5/1/19,3277,3052,225,6.9
5019,5/1/19,9659,9301,358,3.7
5021,5/1/19,5714,5453,261,4.6
5023,5/1/19,9348,8954,394,4.2
5025,5/1/19,3219,3093,126,3.9
5027,5/1/19,9164,8735,429,4.7
5029,5/1/19,8275,7906,369,4.5
5031,5/1/19,55421,53894,1527,2.8
5033,5/1/19,27017,26180,837,3.1
5035,5/1/19,21344,20445,899,4.2
5037,5/1/19,7365,7064,301,4.1
5039,5/1/19,2826,2698,128,4.5
5041,5/1/19,5362,5129,233,4.3
5043,5/1/19,7875,7483,392,5
5045,5/1/19,62530,60711,1819,2.9
5047,5/1/19,7542,7313,229,3
5049,5/1/19,5060,4856,204,4
5051,5/1/19,41357,39946,1411,3.4
5053,5/1/19,8392,8139,253,3
5055,5/1/19,20152,19501,651,3.2
5057,5/1/19,9963,9603,360,3.6
5059,5/1/19,13956,13488,468,3.4
5061,5/1/19,5643,5468,175,3.1
5063,5/1/19,16656,16017,639,3.8
5065,5/1/19,5010,4741,269,5.4
5067,5/1/19,5832,5459,373,6.4
5069,5/1/19,27732,26218,1514,5.5
5071,5/1/19,10384,9920,464,4.5
5073,5/1/19,2521,2409,112,4.4
5075,5/1/19,6921,6654,267,3.9
5077,5/1/19,2794,2687,107,3.8
5079,5/1/19,3948,3781,167,4.2
5081,5/1/19,5517,5304,213,3.9
5083,5/1/19,8549,8208,341,4
5085,5/1/19,34408,33411,997,2.9
5087,5/1/19,7383,7216,167,2.3
5089,5/1/19,6763,6519,244,3.6
5091,5/1/19,19783,19065,718,3.6
5093,5/1/19,17335,16538,797,4.6
5095,5/1/19,2743,2636,107,3.9
5097,5/1/19,3035,2913,122,4
5099,5/1/19,3676,3534,142,3.9
5101,5/1/19,3365,3256,109,3.2
5103,5/1/19,9898,9399,499,5
5105,5/1/19,4293,4114,179,4.2
5107,5/1/19,6415,6068,347,5.4
5109,5/1/19,4297,4147,150,3.5
5111,5/1/19,10207,9881,326,3.2
5113,5/1/19,8100,7797,303,3.7
5115,5/1/19,28977,27701,1276,4.4
5117,5/1/19,3605,3460,145,4
5119,5/1/19,190237,184194,6043,3.2
5121,5/1/19,7296,7023,273,3.7
5123,5/1/19,8219,7802,417,5.1
5125,5/1/19,59089,57591,1498,2.5
5127,5/1/19,4305,4179,126,2.9
5129,5/1/19,3058,2939,119,3.9
5131,5/1/19,56895,55190,1705,3
5133,5/1/19,5491,5216,275,5
5135,5/1/19,5866,5612,254,4.3
5137,5/1/19,4771,4549,222,4.7
5139,5/1/19,15868,15079,789,5
5141,5/1/19,5842,5572,270,4.6
5143,5/1/19,124555,121665,2890,2.3
5145,5/1/19,34029,32527,1502,4.4
5147,5/1/19,2767,2630,137,5
5149,5/1/19,8438,8091,347,4.1
6001,5/1/19,837300,815557,21743,2.6
6003,5/1/19,472,444,28,5.9
6005,5/1/19,14891,14399,492,3.3
6007,5/1/19,99095,94664,4431,4.5
6009,5/1/19,21147,20446,701,3.3
6011,5/1/19,11238,10073,1165,10.4
6013,5/1/19,556642,541593,15049,2.7
6015,5/1/19,9585,9108,477,5
6017,5/1/19,91073,88239,2834,3.1
6019,5/1/19,452032,422750,29282,6.5
6021,5/1/19,12841,12109,732,5.7
6023,5/1/19,62535,60614,1921,3.1
6025,5/1/19,70532,58834,11698,16.6
6027,5/1/19,8673,8414,259,3
6029,5/1/19,386497,358248,28249,7.3
6031,5/1/19,57968,53989,3979,6.9
6033,5/1/19,29222,27981,1241,4.2
6035,5/1/19,9650,9254,396,4.1
6037,5/1/19,5074586,4866672,207914,4.1
6039,5/1/19,62272,58400,3872,6.2
6041,5/1/19,138325,135596,2729,2
6043,5/1/19,7713,7425,288,3.7
6045,5/1/19,38878,37600,1278,3.3
6047,5/1/19,117247,108752,8495,7.2
6049,5/1/19,3222,3042,180,5.6
6051,5/1/19,7970,7694,276,3.5
6053,5/1/19,229342,218256,11086,4.8
6055,5/1/19,74257,72527,1730,2.3
6057,5/1/19,47800,46369,1431,3
6059,5/1/19,1611417,1572297,39120,2.4
6061,5/1/19,186176,181039,5137,2.8
6063,5/1/19,8015,7508,507,6.3
6065,5/1/19,1089545,1050068,39477,3.6
6067,5/1/19,705580,682600,22980,3.3
6069,5/1/19,31120,29720,1400,4.5
6071,5/1/19,955749,923281,32468,3.4
6073,5/1/19,1576186,1532045,44141,2.8
6075,5/1/19,575524,564369,11155,1.9
6077,5/1/19,327709,310812,16897,5.2
6079,5/1/19,141818,138368,3450,2.4
6081,5/1/19,453903,445781,8122,1.8
6083,5/1/19,219150,212709,6441,2.9
6085,5/1/19,1043374,1020669,22705,2.2
6087,5/1/19,142122,136390,5732,4
6089,5/1/19,73885,70901,2984,4
6091,5/1/19,1337,1272,65,4.9
6093,5/1/19,17011,16082,929,5.5
6095,5/1/19,208198,201310,6888,3.3
6097,5/1/19,256524,250476,6048,2.4
6099,5/1/19,242732,229126,13606,5.6
6101,5/1/19,45347,42264,3083,6.8
6103,5/1/19,25362,24084,1278,5
6105,5/1/19,4780,4564,216,4.5
6107,5/1/19,205833,188501,17332,8.4
6109,5/1/19,21078,20245,833,4
6111,5/1/19,422230,409498,12732,3
6113,5/1/19,107660,103986,3674,3.4
6115,5/1/19,29415,27822,1593,5.4
8001,5/1/19,273338,265933,7405,2.7
8003,5/1/19,8780,8505,275,3.1
8005,5/1/19,365831,356530,9301,2.5
8007,5/1/19,6906,6710,196,2.8
8009,5/1/19,2180,2147,33,1.5
8011,5/1/19,1927,1873,54,2.8
8013,5/1/19,197793,193618,4175,2.1
8014,5/1/19,40255,39324,931,2.3
8015,5/1/19,9697,9491,206,2.1
8017,5/1/19,1161,1145,16,1.4
8019,5/1/19,6066,5924,142,2.3
8021,5/1/19,4183,4048,135,3.2
8023,5/1/19,1854,1781,73,3.9
8025,5/1/19,1510,1443,67,4.4
8027,5/1/19,2074,2011,63,3
8029,5/1/19,14319,13870,449,3.1
8031,5/1/19,418255,407655,10600,2.5
8033,5/1/19,1147,1114,33,2.9
8035,5/1/19,194805,190524,4281,2.2
8037,5/1/19,33503,32402,1101,3.3
8039,5/1/19,15222,14914,308,2
8041,5/1/19,341844,331428,10416,3
8043,5/1/19,15367,14731,636,4.1
8045,5/1/19,30614,29793,821,2.7
8047,5/1/19,3793,3708,85,2.2
8049,5/1/19,8761,8566,195,2.2
8051,5/1/19,10838,10573,265,2.4
8053,5/1/19,424,409,15,3.5
8055,5/1/19,2530,2409,121,4.8
8057,5/1/19,990,963,27,2.7
8059,5/1/19,336141,328190,7951,2.4
8061,5/1/19,957,942,15,1.6
8063,5/1/19,4388,4325,63,1.4
8065,5/1/19,4605,4457,148,3.2
8067,5/1/19,31956,31242,714,2.2
8069,5/1/19,206087,201769,4318,2.1
8071,5/1/19,6634,6402,232,3.5
8073,5/1/19,2437,2385,52,2.1
8075,5/1/19,11170,10934,236,2.1
8077,5/1/19,76735,74449,2286,3
8079,5/1/19,433,420,13,3
8081,5/1/19,7325,7099,226,3.1
8083,5/1/19,12989,12528,461,3.5
8085,5/1/19,21825,21174,651,3
8087,5/1/19,16484,16073,411,2.5
8089,5/1/19,8367,8051,316,3.8
8091,5/1/19,2364,2294,70,3
8093,5/1/19,11201,10926,275,2.5
8095,5/1/19,2620,2583,37,1.4
8097,5/1/19,10958,10270,688,6.3
8099,5/1/19,6406,6258,148,2.3
8101,5/1/19,76192,73312,2880,3.8
8103,5/1/19,3030,2931,99,3.3
8105,5/1/19,5510,5329,181,3.3
8107,5/1/19,14965,14543,422,2.8
8109,5/1/19,3595,3484,111,3.1
8111,5/1/19,522,509,13,2.5
8113,5/1/19,4807,4449,358,7.4
8115,5/1/19,1227,1202,25,2
8117,5/1/19,19981,19453,528,2.6
8119,5/1/19,12769,12405,364,2.9
8121,5/1/19,3029,2972,57,1.9
8123,5/1/19,169182,165383,3799,2.2
8125,5/1/19,6620,6538,82,1.2
9001,5/1/19,479615,462831,16784,3.5
9003,5/1/19,481198,463467,17731,3.7
9005,5/1/19,104539,101200,3339,3.2
9007,5/1/19,93170,90440,2730,2.9
9009,5/1/19,459416,442036,17380,3.8
9011,5/1/19,137028,132279,4749,3.5
9013,5/1/19,86713,84011,2702,3.1
9015,5/1/19,63934,61453,2481,3.9
10001,5/1/19,78676,75742,2934,3.7
10003,5/1/19,298507,288526,9981,3.3
10005,5/1/19,107694,104351,3343,3.1
11001,5/1/19,408260,386959,21301,5.2
12001,5/1/19,137177,133331,3846,2.8
12003,5/1/19,11761,11396,365,3.1
12005,5/1/19,85129,81931,3198,3.8
12007,5/1/19,10936,10606,330,3
12009,5/1/19,282542,273791,8751,3.1
12011,5/1/19,1038920,1007986,30934,3
12013,5/1/19,4874,4694,180,3.7
12015,5/1/19,71663,69107,2556,3.6
12017,5/1/19,47445,45204,2241,4.7
12019,5/1/19,106837,103752,3085,2.9
12021,5/1/19,179247,174167,5080,2.8
12023,5/1/19,29421,28468,953,3.2
12027,5/1/19,14465,14013,452,3.1
12029,5/1/19,5817,5616,201,3.5
12031,5/1/19,488009,472465,15544,3.2
12033,5/1/19,145824,141392,4432,3
12035,5/1/19,47046,45286,1760,3.7
12037,5/1/19,4803,4641,162,3.4
12039,5/1/19,18666,17919,747,4
12041,5/1/19,7037,6801,236,3.4
12043,5/1/19,5682,5478,204,3.6
12045,5/1/19,5838,5557,281,4.8
12047,5/1/19,4327,4161,166,3.8
12049,5/1/19,8493,8091,402,4.7
12051,5/1/19,15853,15122,731,4.6
12053,5/1/19,71543,68603,2940,4.1
12055,5/1/19,36326,34736,1590,4.4
12057,5/1/19,745993,723555,22438,3
12059,5/1/19,7004,6765,239,3.4
12061,5/1/19,65226,62813,2413,3.7
12063,5/1/19,17402,16789,613,3.5
12065,5/1/19,5588,5403,185,3.3
12067,5/1/19,2888,2806,82,2.8
12069,5/1/19,158321,153421,4900,3.1
12071,5/1/19,345234,334730,10504,3
12073,5/1/19,154069,149589,4480,2.9
12075,5/1/19,16723,16110,613,3.7
12077,5/1/19,2653,2557,96,3.6
12079,5/1/19,7475,7210,265,3.5
12081,5/1/19,180133,174784,5349,3
12083,5/1/19,137269,132133,5136,3.7
12085,5/1/19,74285,72052,2233,3
12086,5/1/19,1374809,1341271,33538,2.4
12087,5/1/19,46864,45935,929,2
12089,5/1/19,40861,39721,1140,2.8
12091,5/1/19,98049,95563,2486,2.5
12093,5/1/19,17948,17370,578,3.2
12095,5/1/19,759130,737766,21364,2.8
12097,5/1/19,183323,177628,5695,3.1
12099,5/1/19,733666,710891,22775,3.1
12101,5/1/19,236718,228674,8044,3.4
12103,5/1/19,491818,477355,14463,2.9
12105,5/1/19,303558,292715,10843,3.6
12107,5/1/19,26801,25677,1124,4.2
12109,5/1/19,131605,128292,3313,2.5
12111,5/1/19,145475,139904,5571,3.8
12113,5/1/19,82808,80500,2308,2.8
12115,5/1/19,189243,183569,5674,3
12117,5/1/19,254496,247241,7255,2.9
12119,5/1/19,32657,31168,1489,4.6
12121,5/1/19,18071,17493,578,3.2
12123,5/1/19,8335,8056,279,3.3
12125,5/1/19,4646,4520,126,2.7
12127,5/1/19,254288,245737,8551,3.4
12129,5/1/19,14776,14355,421,2.8
12131,5/1/19,31979,31129,850,2.7
12133,5/1/19,9783,9476,307,3.1
13001,5/1/19,9159,8803,356,3.9
13003,5/1/19,4663,4529,134,2.9
13005,5/1/19,5082,4910,172,3.4
13007,5/1/19,1145,1092,53,4.6
13009,5/1/19,17393,16714,679,3.9
13011,5/1/19,9595,9344,251,2.6
13013,5/1/19,40150,39037,1113,2.8
13015,5/1/19,50177,48614,1563,3.1
13017,5/1/19,5288,5015,273,5.2
13019,5/1/19,7433,7180,253,3.4
13021,5/1/19,67578,65015,2563,3.8
13023,5/1/19,4567,4353,214,4.7
13025,5/1/19,7252,6973,279,3.8
13027,5/1/19,6834,6615,219,3.2
13029,5/1/19,18274,17763,511,2.8
13031,5/1/19,36749,35482,1267,3.4
13033,5/1/19,9119,8669,450,4.9
13035,5/1/19,10676,10319,357,3.3
13037,5/1/19,2162,2085,77,3.6
13039,5/1/19,20922,20195,727,3.5
13043,5/1/19,5559,5412,147,2.6
13045,5/1/19,54840,53017,1823,3.3
13047,5/1/19,33270,32360,910,2.7
13049,5/1/19,4760,4581,179,3.8
13051,5/1/19,139720,135309,4411,3.2
13053,5/1/19,1999,1910,89,4.5
13055,5/1/19,10155,9811,344,3.4
13057,5/1/19,135001,131402,3599,2.7
13059,5/1/19,58755,56782,1973,3.4
13061,5/1/19,845,788,57,6.7
13063,5/1/19,136902,131296,5606,4.1
13065,5/1/19,2823,2734,89,3.2
13067,5/1/19,422650,410393,12257,2.9
13069,5/1/19,18913,18199,714,3.8
13071,5/1/19,21273,20622,651,3.1
13073,5/1/19,74945,72789,2156,2.9
13075,5/1/19,7943,7700,243,3.1
13077,5/1/19,74148,72023,2125,2.9
13079,5/1/19,5579,5375,204,3.7
13081,5/1/19,9442,9101,341,3.6
13083,5/1/19,8141,7888,253,3.1
13085,5/1/19,12243,11894,349,2.9
13087,5/1/19,11451,11024,427,3.7
13089,5/1/19,397135,383704,13431,3.4
13091,5/1/19,7180,6763,417,5.8
13093,5/1/19,4981,4793,188,3.8
13095,5/1/19,38095,36368,1727,4.5
13097,5/1/19,72764,70270,2494,3.4
13099,5/1/19,4302,4145,157,3.6
13101,5/1/19,1887,1837,50,2.6
13103,5/1/19,30917,30060,857,2.8
13105,5/1/19,7570,7302,268,3.5
13107,5/1/19,8306,7948,358,4.3
13109,5/1/19,4778,4615,163,3.4
13111,5/1/19,11497,11133,364,3.2
13113,5/1/19,57640,55966,1674,2.9
13115,5/1/19,43562,42044,1518,3.5
13117,5/1/19,121329,118092,3237,2.7
13119,5/1/19,9875,9531,344,3.5
13121,5/1/19,553683,534754,18929,3.4
13123,5/1/19,11788,11387,401,3.4
13125,5/1/19,1270,1222,48,3.8
13127,5/1/19,39511,38270,1241,3.1
13129,5/1/19,28005,27174,831,3
13131,5/1/19,10377,10043,334,3.2
13133,5/1/19,6983,6718,265,3.8
13135,5/1/19,486567,472308,14259,2.9
13137,5/1/19,19087,18483,604,3.2
13139,5/1/19,101369,98617,2752,2.7
13141,5/1/19,2423,2304,119,4.9
13143,5/1/19,12472,12073,399,3.2
13145,5/1/19,16686,16187,499,3
13147,5/1/19,11500,11138,362,3.1
13149,5/1/19,5208,5041,167,3.2
13151,5/1/19,114824,110858,3966,3.5
13153,5/1/19,70322,68064,2258,3.2
13155,5/1/19,3290,3148,142,4.3
13157,5/1/19,36161,35234,927,2.6
13159,5/1/19,6893,6681,212,3.1
13161,5/1/19,6068,5801,267,4.4
13163,5/1/19,6484,6193,291,4.5
13165,5/1/19,3143,2990,153,4.9
13167,5/1/19,4084,3937,147,3.6
13169,5/1/19,13628,13202,426,3.1
13171,5/1/19,8165,7869,296,3.6
13173,5/1/19,3725,3591,134,3.6
13175,5/1/19,19330,18529,801,4.1
13177,5/1/19,14636,14210,426,2.9
13179,5/1/19,26108,25120,988,3.8
13181,5/1/19,3533,3403,130,3.7
13183,5/1/19,8125,7819,306,3.8
13185,5/1/19,50970,49322,1648,3.2
13187,5/1/19,16572,16081,491,3
13189,5/1/19,8795,8396,399,4.5
13191,5/1/19,6180,5965,215,3.5
13193,5/1/19,4707,4497,210,4.5
13195,5/1/19,13211,12820,391,3
13197,5/1/19,3309,3171,138,4.2
13199,5/1/19,8827,8453,374,4.2
13201,5/1/19,2740,2656,84,3.1
13205,5/1/19,8264,7918,346,4.2
13207,5/1/19,12926,12512,414,3.2
13209,5/1/19,3802,3607,195,5.1
13211,5/1/19,9149,8882,267,2.9
13213,5/1/19,15334,14691,643,4.2
13215,5/1/19,77696,74282,3414,4.4
13217,5/1/19,51853,49911,1942,3.7
13219,5/1/19,19410,18928,482,2.5
13221,5/1/19,6889,6667,222,3.2
13223,5/1/19,85392,82957,2435,2.9
13225,5/1/19,11780,11325,455,3.9
13227,5/1/19,15169,14738,431,2.8
13229,5/1/19,8700,8419,281,3.2
13231,5/1/19,8829,8577,252,2.9
13233,5/1/19,18335,17682,653,3.6
13235,5/1/19,4050,3887,163,4
13237,5/1/19,8141,7804,337,4.1
13239,5/1/19,798,757,41,5.1
13241,5/1/19,7158,6917,241,3.4
13243,5/1/19,2512,2398,114,4.5
13245,5/1/19,84899,81213,3686,4.3
13247,5/1/19,44495,42834,1661,3.7
13249,5/1/19,2208,2124,84,3.8
13251,5/1/19,5059,4823,236,4.7
13253,5/1/19,3046,2913,133,4.4
13255,5/1/19,28499,27378,1121,3.9
13257,5/1/19,10682,10291,391,3.7
13259,5/1/19,2407,2305,102,4.2
13261,5/1/19,12706,12126,580,4.6
13263,5/1/19,2828,2699,129,4.6
13265,5/1/19,557,536,21,3.8
13267,5/1/19,9438,9082,356,3.8
13269,5/1/19,3119,3004,115,3.7
13271,5/1/19,4340,3894,446,10.3
13273,5/1/19,3494,3316,178,5.1
13275,5/1/19,16205,15591,614,3.8
13277,5/1/19,19584,18980,604,3.1
13279,5/1/19,11594,11074,520,4.5
13281,5/1/19,3920,3744,176,4.5
13283,5/1/19,2667,2549,118,4.4
13285,5/1/19,37327,36209,1118,3
13287,5/1/19,3137,3011,126,4
13289,5/1/19,2858,2712,146,5.1
13291,5/1/19,10358,10038,320,3.1
13293,5/1/19,11213,10838,375,3.3
13295,5/1/19,31037,30084,953,3.1
13297,5/1/19,45756,44363,1393,3
13299,5/1/19,15543,15024,519,3.3
13301,5/1/19,2795,2676,119,4.3
13303,5/1/19,6976,6699,277,4
13305,5/1/19,11421,11000,421,3.7
13307,5/1/19,1000,950,50,5
13309,5/1/19,1628,1507,121,7.4
13311,5/1/19,16235,15828,407,2.5
13313,5/1/19,43160,41571,1589,3.7
13315,5/1/19,2688,2555,133,4.9
13317,5/1/19,3792,3629,163,4.3
13319,5/1/19,4004,3843,161,4
13321,5/1/19,8847,8502,345,3.9
15001,5/1/19,91401,88436,2965,3.2
15003,5/1/19,447027,435908,11119,2.5
15007,5/1/19,36400,35525,875,2.4
15009,5/1/19,85892,83776,2116,2.5
16001,5/1/19,253247,247441,5806,2.3
16003,5/1/19,1693,1574,119,7
16005,5/1/19,43094,42007,1087,2.5
16007,5/1/19,3009,2940,69,2.3
16009,5/1/19,4065,3873,192,4.7
16011,5/1/19,23926,23399,527,2.2
16013,5/1/19,11796,11479,317,2.7
16015,5/1/19,3484,3353,131,3.8
16017,5/1/19,19783,19046,737,3.7
16019,5/1/19,56889,55657,1232,2.2
16021,5/1/19,5482,5275,207,3.8
16023,5/1/19,1405,1376,29,2.1
16025,5/1/19,681,663,18,2.6
16027,5/1/19,103538,100624,2914,2.8
16029,5/1/19,4172,4090,82,2
16031,5/1/19,12222,11930,292,2.4
16033,5/1/19,386,375,11,2.8
16035,5/1/19,2878,2698,180,6.3
16037,5/1/19,2271,2197,74,3.3
16039,5/1/19,11618,11272,346,3
16041,5/1/19,7152,7011,141,2
16043,5/1/19,8026,7875,151,1.9
16045,5/1/19,8262,8011,251,3
16047,5/1/19,8225,8041,184,2.2
16049,5/1/19,6683,6417,266,4
16051,5/1/19,14075,13788,287,2
16053,5/1/19,12170,11890,280,2.3
16055,5/1/19,80622,78274,2348,2.9
16057,5/1/19,20328,19818,510,2.5
16059,5/1/19,3550,3415,135,3.8
16061,5/1/19,1690,1623,67,4
16063,5/1/19,2613,2535,78,3
16065,5/1/19,22353,21961,392,1.8
16067,5/1/19,11505,11233,272,2.4
16069,5/1/19,20989,20486,503,2.4
16071,5/1/19,2335,2291,44,1.9
16073,5/1/19,5488,5331,157,2.9
16075,5/1/19,11583,11224,359,3.1
16077,5/1/19,4120,4020,100,2.4
16079,5/1/19,5051,4777,274,5.4
16081,5/1/19,6466,6318,148,2.3
16083,5/1/19,41064,40010,1054,2.6
16085,5/1/19,5339,5144,195,3.7
16087,5/1/19,4576,4410,166,3.6
17001,5/1/19,32354,31453,901,2.8
17003,5/1/19,2043,1940,103,5
17005,5/1/19,7871,7633,238,3
17007,5/1/19,26116,24912,1204,4.6
17009,5/1/19,3010,2949,61,2
17011,5/1/19,17671,17038,633,3.6
17013,5/1/19,2348,2252,96,4.1
17015,5/1/19,7359,7124,235,3.2
17017,5/1/19,6205,5988,217,3.5
17019,5/1/19,109337,105800,3537,3.2
17021,5/1/19,14831,14252,579,3.9
17023,5/1/19,7823,7538,285,3.6
17025,5/1/19,6633,6372,261,3.9
17027,5/1/19,20589,20072,517,2.5
17029,5/1/19,23121,22314,807,3.5
17031,5/1/19,2577163,2487042,90121,3.5
17033,5/1/19,8747,8409,338,3.9
17035,5/1/19,6170,6008,162,2.6
17037,5/1/19,55303,53399,1904,3.4
17039,5/1/19,7525,7258,267,3.5
17041,5/1/19,10305,10010,295,2.9
17043,5/1/19,504588,491146,13442,2.7
17045,5/1/19,9139,8845,294,3.2
17047,5/1/19,2738,2652,86,3.1
17049,5/1/19,19444,18910,534,2.7
17051,5/1/19,10197,9837,360,3.5
17053,5/1/19,6612,6392,220,3.3
17055,5/1/19,16514,15752,762,4.6
17057,5/1/19,15346,14663,683,4.5
17059,5/1/19,2411,2311,100,4.1
17061,5/1/19,6153,5929,224,3.6
17063,5/1/19,25281,24283,998,3.9
17065,5/1/19,4531,4396,135,3
17067,5/1/19,8612,8295,317,3.7
17069,5/1/19,1315,1239,76,5.8
17071,5/1/19,3714,3562,152,4.1
17073,5/1/19,25280,24288,992,3.9
17075,5/1/19,14657,14173,484,3.3
17077,5/1/19,27867,26976,891,3.2
17079,5/1/19,4805,4641,164,3.4
17081,5/1/19,17309,16636,673,3.9
17083,5/1/19,11024,10598,426,3.9
17085,5/1/19,11134,10839,295,2.6
17087,5/1/19,4133,3931,202,4.9
17089,5/1/19,272469,262868,9601,3.5
17091,5/1/19,55598,53373,2225,4
17093,5/1/19,68171,66187,1984,2.9
17095,5/1/19,22178,21274,904,4.1
17097,5/1/19,375261,362928,12333,3.3
17099,5/1/19,54892,52514,2378,4.3
17101,5/1/19,5935,5669,266,4.5
17103,5/1/19,17658,17047,611,3.5
17105,5/1/19,16827,16252,575,3.4
17107,5/1/19,12910,12423,487,3.8
17109,5/1/19,13834,13315,519,3.8
17111,5/1/19,164558,159721,4837,2.9
17113,5/1/19,88117,85371,2746,3.1
17115,5/1/19,49294,47176,2118,4.3
17117,5/1/19,23108,22311,797,3.4
17119,5/1/19,134165,129775,4390,3.3
17121,5/1/19,17762,17073,689,3.9
17123,5/1/19,5419,5208,211,3.9
17125,5/1/19,6443,6163,280,4.3
17127,5/1/19,5639,5360,279,4.9
17129,5/1/19,6556,6358,198,3
17131,5/1/19,8202,7892,310,3.8
17133,5/1/19,18829,18354,475,2.5
17135,5/1/19,11919,11439,480,4
17137,5/1/19,16686,16146,540,3.2
17139,5/1/19,7631,7413,218,2.9
17141,5/1/19,25250,24231,1019,4
17143,5/1/19,85192,81568,3624,4.3
17145,5/1/19,8454,8093,361,4.3
17147,5/1/19,8722,8470,252,2.9
17149,5/1/19,7278,7037,241,3.3
17151,5/1/19,1725,1641,84,4.9
17153,5/1/19,1996,1889,107,5.4
17155,5/1/19,3058,2936,122,4
17157,5/1/19,14397,13967,430,3
17159,5/1/19,7351,7102,249,3.4
17161,5/1/19,71566,68578,2988,4.2
17163,5/1/19,126456,121668,4788,3.8
17165,5/1/19,9738,9300,438,4.5
17167,5/1/19,101270,97921,3349,3.3
17169,5/1/19,3366,3273,93,2.8
17171,5/1/19,2542,2454,88,3.5
17173,5/1/19,10891,10546,345,3.2
17175,5/1/19,2600,2478,122,4.7
17177,5/1/19,22122,21311,811,3.7
17179,5/1/19,64109,61872,2237,3.5
17181,5/1/19,7527,7167,360,4.8
17183,5/1/19,33026,31630,1396,4.2
17185,5/1/19,5865,5670,195,3.3
17187,5/1/19,8740,8416,324,3.7
17189,5/1/19,10366,10168,198,1.9
17191,5/1/19,7157,6872,285,4
17193,5/1/19,6715,6499,216,3.2
17195,5/1/19,28859,27877,982,3.4
17197,5/1/19,354714,342512,12202,3.4
17199,5/1/19,31799,30665,1134,3.6
17201,5/1/19,139169,132018,7151,5.1
17203,5/1/19,18955,18373,582,3.1
18001,5/1/19,17349,16944,405,2.3
18003,5/1/19,185976,180812,5164,2.8
18005,5/1/19,44899,43871,1028,2.3
18007,5/1/19,4662,4531,131,2.8
18009,5/1/19,5037,4873,164,3.3
18011,5/1/19,36470,35640,830,2.3
18013,5/1/19,7746,7538,208,2.7
18015,5/1/19,10379,10111,268,2.6
18017,5/1/19,18314,17767,547,3
18019,5/1/19,61410,59537,1873,3
18021,5/1/19,12149,11774,375,3.1
18023,5/1/19,17283,16876,407,2.4
18025,5/1/19,4834,4673,161,3.3
18027,5/1/19,16827,16428,399,2.4
18029,5/1/19,25839,25013,826,3.2
18031,5/1/19,15314,14924,390,2.5
18033,5/1/19,22742,22180,562,2.5
18035,5/1/19,53492,51612,1880,3.5
18037,5/1/19,23252,22750,502,2.2
18039,5/1/19,113356,110266,3090,2.7
18041,5/1/19,8815,8465,350,4
18043,5/1/19,41490,40293,1197,2.9
18045,5/1/19,8154,7901,253,3.1
18047,5/1/19,11596,11257,339,2.9
18049,5/1/19,10043,9776,267,2.7
18051,5/1/19,19354,18912,442,2.3
18053,5/1/19,32091,31054,1037,3.2
18055,5/1/19,13806,13315,491,3.6
18057,5/1/19,184182,179855,4327,2.3
18059,5/1/19,40417,39356,1061,2.6
18061,5/1/19,20239,19659,580,2.9
18063,5/1/19,90077,87849,2228,2.5
18065,5/1/19,22032,21375,657,3
18067,5/1/19,36160,34947,1213,3.4
18069,5/1/19,18289,17758,531,2.9
18071,5/1/19,22861,22294,567,2.5
18073,5/1/19,16493,16002,491,3
18075,5/1/19,9491,9232,259,2.7
18077,5/1/19,15143,14686,457,3
18079,5/1/19,13441,13054,387,2.9
18081,5/1/19,83177,81136,2041,2.5
18083,5/1/19,18314,17802,512,2.8
18085,5/1/19,42705,41651,1054,2.5
18087,5/1/19,20426,19918,508,2.5
18089,5/1/19,231078,221552,9526,4.1
18091,5/1/19,48002,46245,1757,3.7
18093,5/1/19,21270,20581,689,3.2
18095,5/1/19,59239,57311,1928,3.3
18097,5/1/19,490841,476103,14738,3
18099,5/1/19,23450,22805,645,2.8
18101,5/1/19,5384,5250,134,2.5
18103,5/1/19,15629,15124,505,3.2
18105,5/1/19,70883,68756,2127,3
18107,5/1/19,18852,18334,518,2.7
18109,5/1/19,36471,35445,1026,2.8
18111,5/1/19,7061,6836,225,3.2
18113,5/1/19,23807,23168,639,2.7
18115,5/1/19,3180,3084,96,3
18117,5/1/19,8597,8323,274,3.2
18119,5/1/19,9509,9180,329,3.5
18121,5/1/19,7259,7019,240,3.3
18123,5/1/19,9255,8988,267,2.9
18125,5/1/19,6120,5936,184,3
18127,5/1/19,87313,84513,2800,3.2
18129,5/1/19,13625,13289,336,2.5
18131,5/1/19,6645,6466,179,2.7
18133,5/1/19,16866,16337,529,3.1
18135,5/1/19,11522,11160,362,3.1
18137,5/1/19,14331,13926,405,2.8
18139,5/1/19,9148,8931,217,2.4
18141,5/1/19,136585,132205,4380,3.2
18143,5/1/19,10535,10178,357,3.4
18145,5/1/19,23240,22636,604,2.6
18147,5/1/19,11451,11148,303,2.6
18149,5/1/19,10098,9727,371,3.7
18151,5/1/19,20269,19784,485,2.4
18153,5/1/19,8499,8167,332,3.9
18155,5/1/19,5040,4894,146,2.9
18157,5/1/19,99035,96399,2636,2.7
18159,5/1/19,9458,9235,223,2.4
18161,5/1/19,3577,3476,101,2.8
18163,5/1/19,93951,91303,2648,2.8
18165,5/1/19,7068,6742,326,4.6
18167,5/1/19,48406,46561,1845,3.8
18169,5/1/19,15276,14857,419,2.7
18171,5/1/19,4279,4166,113,2.6
18173,5/1/19,32891,32012,879,2.7
18175,5/1/19,13796,13401,395,2.9
18177,5/1/19,31113,30117,996,3.2
18179,5/1/19,14555,14211,344,2.4
18181,5/1/19,13786,13463,323,2.3
18183,5/1/19,17860,17388,472,2.6
19001,5/1/19,4286,4199,87,2
19003,5/1/19,2225,2188,37,1.7
19005,5/1/19,7402,7204,198,2.7
19007,5/1/19,6072,5896,176,2.9
19009,5/1/19,3149,3084,65,2.1
19011,5/1/19,13583,13255,328,2.4
19013,5/1/19,70007,68157,1850,2.6
19015,5/1/19,15117,14786,331,2.2
19017,5/1/19,14053,13768,285,2
19019,5/1/19,11357,11096,261,2.3
19021,5/1/19,11887,11657,230,1.9
19023,5/1/19,7952,7746,206,2.6
19025,5/1/19,4365,4256,109,2.5
19027,5/1/19,11014,10805,209,1.9
19029,5/1/19,6987,6821,166,2.4
19031,5/1/19,11001,10767,234,2.1
19033,5/1/19,23846,23263,583,2.4
19035,5/1/19,6151,6000,151,2.5
19037,5/1/19,6520,6366,154,2.4
19039,5/1/19,4872,4744,128,2.6
19041,5/1/19,8534,8322,212,2.5
19043,5/1/19,10230,9976,254,2.5
19045,5/1/19,22941,22237,704,3.1
19047,5/1/19,8139,7905,234,2.9
19049,5/1/19,49996,49067,929,1.9
19051,5/1/19,4184,4091,93,2.2
19053,5/1/19,4425,4333,92,2.1
19055,5/1/19,10665,10461,204,1.9
19057,5/1/19,19681,18974,707,3.6
19059,5/1/19,10218,9983,235,2.3
19061,5/1/19,56823,55638,1185,2.1
19063,5/1/19,5290,5169,121,2.3
19065,5/1/19,10834,10516,318,2.9
19067,5/1/19,8900,8677,223,2.5
19069,5/1/19,5789,5672,117,2
19071,5/1/19,3640,3529,111,3
19073,5/1/19,5453,5314,139,2.5
19075,5/1/19,6567,6410,157,2.4
19077,5/1/19,5612,5465,147,2.6
19079,5/1/19,7003,6823,180,2.6
19081,5/1/19,5936,5805,131,2.2
19083,5/1/19,8121,7882,239,2.9
19085,5/1/19,7382,7224,158,2.1
19087,5/1/19,9926,9698,228,2.3
19089,5/1/19,5192,5075,117,2.3
19091,5/1/19,5136,5015,121,2.4
19093,5/1/19,4145,4077,68,1.6
19095,5/1/19,10534,10332,202,1.9
19097,5/1/19,11153,10870,283,2.5
19099,5/1/19,19974,19453,521,2.6
19101,5/1/19,10244,10012,232,2.3
19103,5/1/19,86388,84691,1697,2
19105,5/1/19,10700,10443,257,2.4
19107,5/1/19,5246,5109,137,2.6
19109,5/1/19,8466,8312,154,1.8
19111,5/1/19,16135,15596,539,3.3
19113,5/1/19,123295,120177,3118,2.5
19115,5/1/19,6050,5891,159,2.6
19117,5/1/19,4679,4595,84,1.8
19119,5/1/19,7126,7024,102,1.4
19121,5/1/19,8598,8336,262,3
19123,5/1/19,12006,11728,278,2.3
19125,5/1/19,18586,18230,356,1.9
19127,5/1/19,17945,17310,635,3.5
19129,5/1/19,7441,7273,168,2.3
19131,5/1/19,6950,6844,106,1.5
19133,5/1/19,4480,4377,103,2.3
19135,5/1/19,3996,3899,97,2.4
19137,5/1/19,5093,4977,116,2.3
19139,5/1/19,21898,21357,541,2.5
19141,5/1/19,8285,8127,158,1.9
19143,5/1/19,3576,3511,65,1.8
19145,5/1/19,6485,6329,156,2.4
19147,5/1/19,4814,4720,94,2
19149,5/1/19,14792,14516,276,1.9
19151,5/1/19,4404,4321,83,1.9
19153,5/1/19,271284,264440,6844,2.5
19155,5/1/19,48863,47787,1076,2.2
19157,5/1/19,10682,10458,224,2.1
19159,5/1/19,2477,2415,62,2.5
19161,5/1/19,5330,5225,105,2
19163,5/1/19,89892,87324,2568,2.9
19165,5/1/19,6734,6600,134,2
19167,5/1/19,21372,21030,342,1.6
19169,5/1/19,59824,58817,1007,1.7
19171,5/1/19,9490,9271,219,2.3
19173,5/1/19,3220,3163,57,1.8
19175,5/1/19,6302,6125,177,2.8
19177,5/1/19,3712,3625,87,2.3
19179,5/1/19,17808,17265,543,3
19181,5/1/19,28514,27875,639,2.2
19183,5/1/19,11950,11691,259,2.2
19185,5/1/19,2817,2751,66,2.3
19187,5/1/19,19566,19036,530,2.7
19189,5/1/19,5103,4974,129,2.5
19191,5/1/19,12204,11956,248,2
19193,5/1/19,55812,54540,1272,2.3
19195,5/1/19,4182,4084,98,2.3
19197,5/1/19,7134,6954,180,2.5
20001,5/1/19,6558,6348,210,3.2
20003,5/1/19,4109,3984,125,3
20005,5/1/19,6803,6467,336,4.9
20007,5/1/19,2233,2187,46,2.1
20009,5/1/19,13303,12929,374,2.8
20011,5/1/19,6691,6434,257,3.8
20013,5/1/19,5286,5114,172,3.3
20015,5/1/19,32302,31316,986,3.1
20017,5/1/19,1557,1518,39,2.5
20019,5/1/19,1405,1354,51,3.6
20021,5/1/19,10090,9748,342,3.4
20023,5/1/19,1253,1223,30,2.4
20025,5/1/19,1027,1000,27,2.6
20027,5/1/19,3683,3573,110,3
20029,5/1/19,3765,3650,115,3.1
20031,5/1/19,3845,3678,167,4.3
20033,5/1/19,870,850,20,2.3
20035,5/1/19,16178,15662,516,3.2
20037,5/1/19,18662,17967,695,3.7
20039,5/1/19,1162,1130,32,2.8
20041,5/1/19,8823,8546,277,3.1
20043,5/1/19,4060,3938,122,3
20045,5/1/19,65900,64130,1770,2.7
20047,5/1/19,1409,1372,37,2.6
20049,5/1/19,1109,1070,39,3.5
20051,5/1/19,16840,16465,375,2.2
20053,5/1/19,2778,2709,69,2.5
20055,5/1/19,20274,19796,478,2.4
20057,5/1/19,16865,16471,394,2.3
20059,5/1/19,13820,13382,438,3.2
20061,5/1/19,11295,10849,446,3.9
20063,5/1/19,1421,1394,27,1.9
20065,5/1/19,1086,1056,30,2.8
20067,5/1/19,3139,3051,88,2.8
20069,5/1/19,3131,3072,59,1.9
20071,5/1/19,763,748,15,2
20073,5/1/19,3157,3061,96,3
20075,5/1/19,1547,1517,30,1.9
20077,5/1/19,2918,2844,74,2.5
20079,5/1/19,16867,16407,460,2.7
20081,5/1/19,2135,2079,56,2.6
20083,5/1/19,942,922,20,2.1
20085,5/1/19,7093,6904,189,2.7
20087,5/1/19,9970,9699,271,2.7
20089,5/1/19,1277,1241,36,2.8
20091,5/1/19,336057,327266,8791,2.6
20093,5/1/19,1979,1930,49,2.5
20095,5/1/19,3361,3253,108,3.2
20097,5/1/19,1304,1275,29,2.2
20099,5/1/19,9956,9571,385,3.9
20101,5/1/19,746,729,17,2.3
20103,5/1/19,36091,34960,1131,3.1
20105,5/1/19,1606,1569,37,2.3
20107,5/1/19,4348,4116,232,5.3
20109,5/1/19,1580,1548,32,2
20111,5/1/19,16529,16005,524,3.2
20113,5/1/19,17054,16691,363,2.1
20115,5/1/19,5911,5750,161,2.7
20117,5/1/19,5339,5195,144,2.7
20119,5/1/19,2085,2036,49,2.4
20121,5/1/19,17295,16769,526,3
20123,5/1/19,3322,3246,76,2.3
20125,5/1/19,14703,14143,560,3.8
20127,5/1/19,2927,2856,71,2.4
20129,5/1/19,1110,1081,29,2.6
20131,5/1/19,5253,5123,130,2.5
20133,5/1/19,5993,5738,255,4.3
20135,5/1/19,1292,1262,30,2.3
20137,5/1/19,2638,2584,54,2
20139,5/1/19,7853,7615,238,3
20141,5/1/19,1994,1957,37,1.9
20143,5/1/19,2955,2882,73,2.5
20145,5/1/19,2737,2664,73,2.7
20147,5/1/19,2592,2528,64,2.5
20149,5/1/19,12552,12216,336,2.7
20151,5/1/19,4835,4708,127,2.6
20153,5/1/19,1390,1356,34,2.4
20155,5/1/19,29648,28519,1129,3.8
20157,5/1/19,2200,2148,52,2.4
20159,5/1/19,5161,5016,145,2.8
20161,5/1/19,35570,34650,920,2.6
20163,5/1/19,2516,2406,110,4.4
20165,5/1/19,1603,1554,49,3.1
20167,5/1/19,3249,3161,88,2.7
20169,5/1/19,30057,29247,810,2.7
20171,5/1/19,2675,2626,49,1.8
20173,5/1/19,250210,242059,8151,3.3
20175,5/1/19,9540,9253,287,3
20177,5/1/19,89829,87066,2763,3.1
20179,5/1/19,1319,1292,27,2
20181,5/1/19,2784,2711,73,2.6
20183,5/1/19,1914,1868,46,2.4
20185,5/1/19,1930,1878,52,2.7
20187,5/1/19,929,905,24,2.6
20189,5/1/19,2462,2399,63,2.6
20191,5/1/19,10781,10436,345,3.2
20193,5/1/19,4186,4091,95,2.3
20195,5/1/19,1363,1331,32,2.3
20197,5/1/19,3561,3460,101,2.8
20199,5/1/19,786,764,22,2.8
20201,5/1/19,2853,2784,69,2.4
20203,5/1/19,1494,1469,25,1.7
20205,5/1/19,3920,3770,150,3.8
20207,5/1/19,1656,1593,63,3.8
20209,5/1/19,76398,73399,2999,3.9
21001,5/1/19,7260,6893,367,5.1
21003,5/1/19,9225,8862,363,3.9
21005,5/1/19,11838,11417,421,3.6
21007,5/1/19,3520,3335,185,5.3
21009,5/1/19,18947,18128,819,4.3
21011,5/1/19,4685,4414,271,5.8
21013,5/1/19,8413,7951,462,5.5
21015,5/1/19,71141,68810,2331,3.3
21017,5/1/19,10125,9776,349,3.4
21019,5/1/19,17793,16824,969,5.4
21021,5/1/19,12693,12138,555,4.4
21023,5/1/19,3860,3679,181,4.7
21025,5/1/19,3567,3329,238,6.7
21027,5/1/19,8048,7655,393,4.9
21029,5/1/19,42850,41121,1729,4
21031,5/1/19,5170,4937,233,4.5
21033,5/1/19,5548,5282,266,4.8
21035,5/1/19,18735,17972,763,4.1
21037,5/1/19,50923,49183,1740,3.4
21039,5/1/19,2250,2166,84,3.7
21041,5/1/19,5345,5143,202,3.8
21043,5/1/19,9700,8958,742,7.6
21045,5/1/19,6743,6480,263,3.9
21047,5/1/19,25083,23678,1405,5.6
21049,5/1/19,17355,16691,664,3.8
21051,5/1/19,5175,4821,354,6.8
21053,5/1/19,4118,3906,212,5.1
21055,5/1/19,3851,3673,178,4.6
21057,5/1/19,3236,3105,131,4
21059,5/1/19,47562,45731,1831,3.8
21061,5/1/19,4860,4637,223,4.6
21063,5/1/19,2034,1890,144,7.1
21065,5/1/19,5375,5130,245,4.6
21067,5/1/19,176856,170978,5878,3.3
21069,5/1/19,6382,6058,324,5.1
21071,5/1/19,11158,10454,704,6.3
21073,5/1/19,24841,23919,922,3.7
21075,5/1/19,2065,1955,110,5.3
21077,5/1/19,4128,3970,158,3.8
21079,5/1/19,7787,7441,346,4.4
21081,5/1/19,11781,11319,462,3.9
21083,5/1/19,15952,15257,695,4.4
21085,5/1/19,11045,10520,525,4.8
21087,5/1/19,5209,4982,227,4.4
21089,5/1/19,13362,12551,811,6.1
21091,5/1/19,3987,3841,146,3.7
21093,5/1/19,49198,47252,1946,4
21095,5/1/19,6768,6295,473,7
21097,5/1/19,8876,8492,384,4.3
21099,5/1/19,8124,7784,340,4.2
21101,5/1/19,22047,21215,832,3.8
21103,5/1/19,8319,8030,289,3.5
21105,5/1/19,1876,1799,77,4.1
21107,5/1/19,18541,17710,831,4.5
21109,5/1/19,4118,3861,257,6.2
21111,5/1/19,400753,384593,16160,4
21113,5/1/19,26754,25829,925,3.5
21115,5/1/19,6780,6342,438,6.5
21117,5/1/19,88004,84981,3023,3.4
21119,5/1/19,4543,4251,292,6.4
21121,5/1/19,9912,9343,569,5.7
21123,5/1/19,6037,5778,259,4.3
21125,5/1/19,24602,23449,1153,4.7
21127,5/1/19,5193,4836,357,6.9
21129,5/1/19,2040,1932,108,5.3
21131,5/1/19,2694,2518,176,6.5
21133,5/1/19,6224,5831,393,6.3
21135,5/1/19,4679,4298,381,8.1
21137,5/1/19,9451,8992,459,4.9
21139,5/1/19,3648,3452,196,5.4
21141,5/1/19,12753,12258,495,3.9
21143,5/1/19,3124,2990,134,4.3
21145,5/1/19,29080,27708,1372,4.7
21147,5/1/19,4696,4427,269,5.7
21149,5/1/19,4280,4093,187,4.4
21151,5/1/19,47629,45805,1824,3.8
21153,5/1/19,3084,2804,280,9.1
21155,5/1/19,9854,9475,379,3.8
21157,5/1/19,15201,14542,659,4.3
21159,5/1/19,2794,2613,181,6.5
21161,5/1/19,7180,6802,378,5.3
21163,5/1/19,12342,11799,543,4.4
21165,5/1/19,2314,2171,143,6.2
21167,5/1/19,10184,9739,445,4.4
21169,5/1/19,4165,3983,182,4.4
21171,5/1/19,4745,4567,178,3.8
21173,5/1/19,11722,11119,603,5.1
21175,5/1/19,4625,4414,211,4.6
21177,5/1/19,10743,10120,623,5.8
21179,5/1/19,23351,22308,1043,4.5
21181,5/1/19,3320,3183,137,4.1
21183,5/1/19,9826,9350,476,4.8
21185,5/1/19,33417,32341,1076,3.2
21187,5/1/19,5198,4960,238,4.6
21189,5/1/19,1142,1065,77,6.7
21191,5/1/19,7027,6771,256,3.6
21193,5/1/19,8337,7884,453,5.4
21195,5/1/19,20046,18783,1263,6.3
21197,5/1/19,5030,4785,245,4.9
21199,5/1/19,26744,25527,1217,4.6
21201,5/1/19,827,786,41,5
21203,5/1/19,6722,6411,311,4.6
21205,5/1/19,10535,10028,507,4.8
21207,5/1/19,6331,5992,339,5.4
21209,5/1/19,29442,28437,1005,3.4
21211,5/1/19,25722,24870,852,3.3
21213,5/1/19,8991,8615,376,4.2
21215,5/1/19,10224,9879,345,3.4
21217,5/1/19,12722,12168,554,4.4
21219,5/1/19,5465,5265,200,3.7
21221,5/1/19,6051,5788,263,4.3
21223,5/1/19,3920,3747,173,4.4
21225,5/1/19,6199,5942,257,4.1
21227,5/1/19,65515,63113,2402,3.7
21229,5/1/19,6370,6141,229,3.6
21231,5/1/19,7559,7129,430,5.7
21233,5/1/19,5917,5685,232,3.9
21235,5/1/19,13685,12994,691,5
21237,5/1/19,1988,1866,122,6.1
21239,5/1/19,15378,14930,448,2.9
22001,5/1/19,23794,22645,1149,4.8
22003,5/1/19,8819,8378,441,5
22005,5/1/19,63517,61187,2330,3.7
22007,5/1/19,8830,8356,474,5.4
22009,5/1/19,15057,14327,730,4.8
22011,5/1/19,14652,13980,672,4.6
22013,5/1/19,5494,5199,295,5.4
22015,5/1/19,57266,55014,2252,3.9
22017,5/1/19,102546,97632,4914,4.8
22019,5/1/19,106696,102837,3859,3.6
22021,5/1/19,3760,3576,184,4.9
22023,5/1/19,3957,3830,127,3.2
22025,5/1/19,3315,3131,184,5.6
22027,5/1/19,5775,5503,272,4.7
22029,5/1/19,6961,6572,389,5.6
22031,5/1/19,10756,10188,568,5.3
22033,5/1/19,228772,219849,8923,3.9
22035,5/1/19,1849,1672,177,9.6
22037,5/1/19,7922,7595,327,4.1
22039,5/1/19,11946,11325,621,5.2
22041,5/1/19,7293,6847,446,6.1
22043,5/1/19,8073,7679,394,4.9
22045,5/1/19,28038,26637,1401,5
22047,5/1/19,13915,13199,716,5.1
22049,5/1/19,6807,6527,280,4.1
22051,5/1/19,212810,204783,8027,3.8
22053,5/1/19,13301,12763,538,4
22055,5/1/19,113198,108741,4457,3.9
22057,5/1/19,41857,40126,1731,4.1
22059,5/1/19,6636,6387,249,3.8
22061,5/1/19,22350,21274,1076,4.8
22063,5/1/19,68319,65795,2524,3.7
22065,5/1/19,3461,3219,242,7
22067,5/1/19,9943,9255,688,6.9
22069,5/1/19,16310,15487,823,5
22071,5/1/19,177750,170119,7631,4.3
22073,5/1/19,69828,66473,3355,4.8
22075,5/1/19,10032,9649,383,3.8
22077,5/1/19,9804,9347,457,4.7
22079,5/1/19,54606,52132,2474,4.5
22081,5/1/19,3705,3540,165,4.5
22083,5/1/19,8202,7751,451,5.5
22085,5/1/19,9183,8764,419,4.6
22087,5/1/19,19784,18901,883,4.5
22089,5/1/19,25030,24053,977,3.9
22091,5/1/19,4230,4009,221,5.2
22093,5/1/19,9167,8684,483,5.3
22095,5/1/19,19503,18544,959,4.9
22097,5/1/19,31657,29898,1759,5.6
22099,5/1/19,22102,21094,1008,4.6
22101,5/1/19,19586,18543,1043,5.3
22103,5/1/19,118839,114344,4495,3.8
22105,5/1/19,53707,51074,2633,4.9
22107,5/1/19,1390,1280,110,7.9
22109,5/1/19,46111,44174,1937,4.2
22111,5/1/19,9081,8613,468,5.2
22113,5/1/19,24010,22911,1099,4.6
22115,5/1/19,15647,14801,846,5.4
22117,5/1/19,16747,15844,903,5.4
22119,5/1/19,14368,13582,786,5.5
22121,5/1/19,13560,12998,562,4.1
22123,5/1/19,3612,3293,319,8.8
22125,5/1/19,5343,5154,189,3.5
22127,5/1/19,4833,4557,276,5.7
23001,5/1/19,54929,53340,1589,2.9
23003,5/1/19,30132,28457,1675,5.6
23005,5/1/19,163940,160004,3936,2.4
23007,5/1/19,13807,13202,605,4.4
23009,5/1/19,28960,28052,908,3.1
23011,5/1/19,61521,59788,1733,2.8
23013,5/1/19,20060,19503,557,2.8
23015,5/1/19,16673,16190,483,2.9
23017,5/1/19,25716,24778,938,3.6
23019,5/1/19,76372,73925,2447,3.2
23021,5/1/19,7242,6961,281,3.9
23023,5/1/19,19373,18930,443,2.3
23025,5/1/19,22325,21358,967,4.3
23027,5/1/19,20458,19841,617,3
23029,5/1/19,13580,12916,664,4.9
23031,5/1/19,112993,110198,2795,2.5
24001,5/1/19,32451,30996,1455,4.5
24003,5/1/19,316806,307393,9413,3
24005,5/1/19,456075,439672,16403,3.6
24009,5/1/19,50115,48591,1524,3
24011,5/1/19,18161,17570,591,3.3
24013,5/1/19,96179,93553,2626,2.7
24015,5/1/19,53266,51309,1957,3.7
24017,5/1/19,87457,84511,2946,3.4
24019,5/1/19,15876,15170,706,4.4
24021,5/1/19,135029,130896,4133,3.1
24023,5/1/19,15769,15182,587,3.7
24025,5/1/19,141802,137212,4590,3.2
24027,5/1/19,188488,183478,5010,2.7
24029,5/1/19,10325,9982,343,3.3
24031,5/1/19,560827,544690,16137,2.9
24033,5/1/19,510349,491927,18422,3.6
24035,5/1/19,28033,27210,823,2.9
24037,5/1/19,57083,55326,1757,3.1
24039,5/1/19,9364,8866,498,5.3
24041,5/1/19,19215,18597,618,3.2
24043,5/1/19,74529,71794,2735,3.7
24045,5/1/19,52028,49939,2089,4
24047,5/1/19,25636,24180,1456,5.7
24510,5/1/19,289733,275498,14235,4.9
25001,5/1/19,114572,110723,3849,3.4
25003,5/1/19,64590,62426,2164,3.4
25005,5/1/19,302177,291532,10645,3.5
25007,5/1/19,9472,9140,332,3.5
25009,5/1/19,426862,414146,12716,3
25011,5/1/19,41234,40145,1089,2.6
25013,5/1/19,229259,220032,9227,4
25015,5/1/19,90600,88189,2411,2.7
25017,5/1/19,922680,900731,21949,2.4
25019,5/1/19,7607,7399,208,2.7
25021,5/1/19,392176,382063,10113,2.6
25023,5/1/19,284232,275975,8257,2.9
25025,5/1/19,457442,445055,12387,2.7
25027,5/1/19,447824,434002,13822,3.1
26001,5/1/19,3985,3766,219,5.5
26003,5/1/19,3166,2914,252,8
26005,5/1/19,62719,60933,1786,2.8
26007,5/1/19,13410,12879,531,4
26009,5/1/19,10396,9927,469,4.5
26011,5/1/19,6162,5817,345,5.6
26013,5/1/19,3238,3032,206,6.4
26015,5/1/19,31759,30828,931,2.9
26017,5/1/19,50110,47976,2134,4.3
26019,5/1/19,8865,8478,387,4.4
26021,5/1/19,74374,71576,2798,3.8
26023,5/1/19,19488,18791,697,3.6
26025,5/1/19,62580,60160,2420,3.9
26027,5/1/19,24688,23692,996,4
26029,5/1/19,12980,12458,522,4
26031,5/1/19,10523,10092,431,4.1
26033,5/1/19,15929,15041,888,5.6
26035,5/1/19,11861,11224,637,5.4
26037,5/1/19,41601,40506,1095,2.6
26039,5/1/19,5679,5403,276,4.9
26041,5/1/19,17229,16394,835,4.8
26043,5/1/19,12278,11818,460,3.7
26045,5/1/19,57823,56093,1730,3
26047,5/1/19,17877,17065,812,4.5
26049,5/1/19,181436,171221,10215,5.6
26051,5/1/19,10019,9500,519,5.2
26053,5/1/19,5961,5661,300,5
26055,5/1/19,49882,48349,1533,3.1
26057,5/1/19,18094,17420,674,3.7
26059,5/1/19,20488,19688,800,3.9
26061,5/1/19,15411,14631,780,5.1
26063,5/1/19,15502,14885,617,4
26065,5/1/19,152963,148050,4913,3.2
26067,5/1/19,30410,29494,916,3
26069,5/1/19,10257,9726,531,5.2
26071,5/1/19,5143,4875,268,5.2
26073,5/1/19,34786,33545,1241,3.6
26075,5/1/19,74728,72195,2533,3.4
26077,5/1/19,133510,129306,4204,3.1
26079,5/1/19,7887,7525,362,4.6
26081,5/1/19,361569,351533,10036,2.8
26083,5/1/19,850,786,64,7.5
26085,5/1/19,3679,3460,219,6
26087,5/1/19,41041,39143,1898,4.6
26089,5/1/19,10546,10202,344,3.3
26091,5/1/19,46593,44949,1644,3.5
26093,5/1/19,103435,100407,3028,2.9
26095,5/1/19,2245,2107,138,6.1
26097,5/1/19,5414,5208,206,3.8
26099,5/1/19,447083,430327,16756,3.7
26101,5/1/19,10594,10088,506,4.8
26103,5/1/19,31833,30293,1540,4.8
26105,5/1/19,13866,13292,574,4.1
26107,5/1/19,18214,17437,777,4.3
26109,5/1/19,11125,10748,377,3.4
26111,5/1/19,40752,39371,1381,3.4
26113,5/1/19,6992,6721,271,3.9
26115,5/1/19,76340,73249,3091,4
26117,5/1/19,28380,27355,1025,3.6
26119,5/1/19,3040,2826,214,7
26121,5/1/19,77086,74039,3047,4
26123,5/1/19,23648,22741,907,3.8
26125,5/1/19,675493,654555,20938,3.1
26127,5/1/19,12251,11628,623,5.1
26129,5/1/19,8111,7653,458,5.6
26131,5/1/19,2090,1942,148,7.1
26133,5/1/19,11150,10751,399,3.6
26135,5/1/19,3169,2987,182,5.7
26137,5/1/19,11847,11313,534,4.5
26139,5/1/19,161829,157615,4214,2.6
26141,5/1/19,4994,4708,286,5.7
26143,5/1/19,7917,7414,503,6.4
26145,5/1/19,86642,82672,3970,4.6
26147,5/1/19,75426,72288,3138,4.2
26149,5/1/19,28215,27040,1175,4.2
26151,5/1/19,19595,18775,820,4.2
26153,5/1/19,3355,3149,206,6.1
26155,5/1/19,33711,32358,1353,4
26157,5/1/19,23907,22729,1178,4.9
26159,5/1/19,35079,33620,1459,4.2
26161,5/1/19,197099,191487,5612,2.8
26163,5/1/19,797188,760664,36524,4.6
26165,5/1/19,14932,14355,577,3.9
27001,5/1/19,7265,6953,312,4.3
27003,5/1/19,197531,192360,5171,2.6
27005,5/1/19,19120,18614,506,2.6
27007,5/1/19,24252,23424,828,3.4
27009,5/1/19,21959,21351,608,2.8
27011,5/1/19,2574,2503,71,2.8
27013,5/1/19,40793,39775,1018,2.5
27015,5/1/19,14565,14151,414,2.8
27017,5/1/19,17856,17219,637,3.6
27019,5/1/19,58710,57308,1402,2.4
27021,5/1/19,14481,13944,537,3.7
27023,5/1/19,7000,6791,209,3
27025,5/1/19,29838,28998,840,2.8
27027,5/1/19,36321,35375,946,2.6
27029,5/1/19,4391,4135,256,5.8
27031,5/1/19,3108,3014,94,3
27033,5/1/19,6018,5852,166,2.8
27035,5/1/19,32555,31547,1008,3.1
27037,5/1/19,241701,235621,6080,2.5
27039,5/1/19,11899,11605,294,2.5
27041,5/1/19,21261,20752,509,2.4
27043,5/1/19,7102,6871,231,3.3
27045,5/1/19,11650,11392,258,2.2
27047,5/1/19,16318,15893,425,2.6
27049,5/1/19,27167,26487,680,2.5
27051,5/1/19,3381,3278,103,3
27053,5/1/19,706676,688980,17696,2.5
27055,5/1/19,10442,10205,237,2.3
27057,5/1/19,10083,9695,388,3.8
27059,5/1/19,21151,20559,592,2.8
27061,5/1/19,22007,20931,1076,4.9
27063,5/1/19,5876,5739,137,2.3
27065,5/1/19,8949,8616,333,3.7
27067,5/1/19,24429,23779,650,2.7
27069,5/1/19,2445,2383,62,2.5
27071,5/1/19,6085,5723,362,5.9
27073,5/1/19,3673,3566,107,2.9
27075,5/1/19,5539,5388,151,2.7
27077,5/1/19,2471,2380,91,3.7
27079,5/1/19,16067,15591,476,3
27081,5/1/19,3370,3286,84,2.5
27083,5/1/19,14935,14560,375,2.5
27085,5/1/19,19396,18857,539,2.8
27087,5/1/19,2336,2259,77,3.3
27089,5/1/19,5528,5314,214,3.9
27091,5/1/19,10289,9993,296,2.9
27093,5/1/19,13416,13066,350,2.6
27095,5/1/19,12776,12319,457,3.6
27097,5/1/19,17695,17152,543,3.1
27099,5/1/19,20536,20011,525,2.6
27101,5/1/19,4991,4873,118,2.4
27103,5/1/19,21072,20606,466,2.2
27105,5/1/19,11389,11121,268,2.4
27107,5/1/19,3356,3236,120,3.6
27109,5/1/19,88457,86409,2048,2.3
27111,5/1/19,31903,31000,903,2.8
27113,5/1/19,8750,8506,244,2.8
27115,5/1/19,14969,14378,591,3.9
27117,5/1/19,5036,4914,122,2.4
27119,5/1/19,16813,16184,629,3.7
27121,5/1/19,6640,6486,154,2.3
27123,5/1/19,289708,281940,7768,2.7
27125,5/1/19,2235,2147,88,3.9
27127,5/1/19,7750,7523,227,2.9
27129,5/1/19,8809,8479,330,3.7
27131,5/1/19,37234,36318,916,2.5
27133,5/1/19,5802,5696,106,1.8
27135,5/1/19,7920,7693,227,2.9
27137,5/1/19,102292,98757,3535,3.5
27139,5/1/19,83559,81575,1984,2.4
27141,5/1/19,52275,50863,1412,2.7
27143,5/1/19,8703,8460,243,2.8
27145,5/1/19,91082,88687,2395,2.6
27147,5/1/19,20973,20419,554,2.6
27149,5/1/19,5694,5579,115,2
27151,5/1/19,4973,4837,136,2.7
27153,5/1/19,13572,13147,425,3.1
27155,5/1/19,1867,1813,54,2.9
27157,5/1/19,12435,12109,326,2.6
27159,5/1/19,5922,5684,238,4
27161,5/1/19,9073,8817,256,2.8
27163,5/1/19,143516,139937,3579,2.5
27165,5/1/19,6712,6503,209,3.1
27167,5/1/19,3589,3498,91,2.5
27169,5/1/19,29107,28351,756,2.6
27171,5/1/19,75507,73626,1881,2.5
27173,5/1/19,5476,5297,179,3.3
28001,5/1/19,11334,10596,738,6.5
28003,5/1/19,16209,15460,749,4.6
28005,5/1/19,4471,4190,281,6.3
28007,5/1/19,7096,6652,444,6.3
28009,5/1/19,3048,2865,183,6
28011,5/1/19,12384,11596,788,6.4
28013,5/1/19,5746,5451,295,5.1
28015,5/1/19,3471,3257,214,6.2
28017,5/1/19,6943,6549,394,5.7
28019,5/1/19,3745,3550,195,5.2
28021,5/1/19,3024,2702,322,10.6
28023,5/1/19,5906,5546,360,6.1
28025,5/1/19,7785,7238,547,7
28027,5/1/19,8439,7870,569,6.7
28029,5/1/19,11258,10522,736,6.5
28031,5/1/19,8114,7722,392,4.8
28033,5/1/19,91185,87215,3970,4.4
28035,5/1/19,33072,31357,1715,5.2
28037,5/1/19,2862,2685,177,6.2
28039,5/1/19,8916,8306,610,6.8
28041,5/1/19,4395,4065,330,7.5
28043,5/1/19,9636,9181,455,4.7
28045,5/1/19,18762,17746,1016,5.4
28047,5/1/19,86547,82196,4351,5
28049,5/1/19,107030,101428,5602,5.2
28051,5/1/19,5666,5059,607,10.7
28053,5/1/19,2264,2062,202,8.9
28055,5/1/19,388,340,48,12.4
28057,5/1/19,10513,10019,494,4.7
28059,5/1/19,58634,55188,3446,5.9
28061,5/1/19,6191,5783,408,6.6
28063,5/1/19,2035,1735,300,14.7
28065,5/1/19,4116,3852,264,6.4
28067,5/1/19,26280,24860,1420,5.4
28069,5/1/19,3578,3287,291,8.1
28071,5/1/19,28228,26841,1387,4.9
28073,5/1/19,30484,29210,1274,4.2
28075,5/1/19,30432,28744,1688,5.5
28077,5/1/19,4638,4361,277,6
28079,5/1/19,8095,7670,425,5.3
28081,5/1/19,40940,39231,1709,4.2
28083,5/1/19,9958,9256,702,7
28085,5/1/19,14688,13902,786,5.4
28087,5/1/19,25436,24093,1343,5.3
28089,5/1/19,53256,50952,2304,4.3
28091,5/1/19,9982,9465,517,5.2
28093,5/1/19,14465,13657,808,5.6
28095,5/1/19,15510,14660,850,5.5
28097,5/1/19,4041,3803,238,5.9
28099,5/1/19,10402,9797,605,5.8
28101,5/1/19,8895,8395,500,5.6
28103,5/1/19,3837,3567,270,7
28105,5/1/19,22959,21575,1384,6
28107,5/1/19,12658,11811,847,6.7
28109,5/1/19,23875,22687,1188,5
28111,5/1/19,4261,3986,275,6.5
28113,5/1/19,14653,13759,894,6.1
28115,5/1/19,14706,14084,622,4.2
28117,5/1/19,11390,10844,546,4.8
28119,5/1/19,2417,2231,186,7.7
28121,5/1/19,76120,73165,2955,3.9
28123,5/1/19,12814,12259,555,4.3
28125,5/1/19,1594,1469,125,7.8
28127,5/1/19,10780,10233,547,5.1
28129,5/1/19,6848,6504,344,5
28131,5/1/19,6950,6493,457,6.6
28133,5/1/19,7831,7237,594,7.6
28135,5/1/19,5380,5111,269,5
28137,5/1/19,12419,11714,705,5.7
28139,5/1/19,9459,8979,480,5.1
28141,5/1/19,8686,8275,411,4.7
28143,5/1/19,4468,4210,258,5.8
28145,5/1/19,14174,13597,577,4.1
28147,5/1/19,4977,4646,331,6.7
28149,5/1/19,20235,19048,1187,5.9
28151,5/1/19,17030,15846,1184,7
28153,5/1/19,7504,7066,438,5.8
28155,5/1/19,4011,3778,233,5.8
28157,5/1/19,2803,2550,253,9
28159,5/1/19,7462,7015,447,6
28161,5/1/19,4922,4636,286,5.8
28163,5/1/19,9467,8884,583,6.2
29001,5/1/19,10483,10067,416,4
29003,5/1/19,9707,9460,247,2.5
29005,5/1/19,2802,2698,104,3.7
29007,5/1/19,10841,10481,360,3.3
29009,5/1/19,15730,15283,447,2.8
29011,5/1/19,5332,5151,181,3.4
29013,5/1/19,7902,7623,279,3.5
29015,5/1/19,7298,7001,297,4.1
29017,5/1/19,5511,5316,195,3.5
29019,5/1/19,98620,96399,2221,2.3
29021,5/1/19,44268,43035,1233,2.8
29023,5/1/19,18149,17187,962,5.3
29025,5/1/19,4388,4258,130,3
29027,5/1/19,21366,20788,578,2.7
29029,5/1/19,19104,18396,708,3.7
29031,5/1/19,40845,39742,1103,2.7
29033,5/1/19,4740,4608,132,2.8
29035,5/1/19,2589,2468,121,4.7
29037,5/1/19,54457,52991,1466,2.7
29039,5/1/19,5825,5628,197,3.4
29041,5/1/19,3806,3710,96,2.5
29043,5/1/19,44656,43612,1044,2.3
29045,5/1/19,3270,3173,97,3
29047,5/1/19,135436,131974,3462,2.6
29049,5/1/19,10690,10424,266,2.5
29051,5/1/19,38876,37986,890,2.3
29053,5/1/19,7536,7314,222,2.9
29055,5/1/19,10950,10591,359,3.3
29057,5/1/19,3665,3564,101,2.8
29059,5/1/19,7111,6804,307,4.3
29061,5/1/19,4253,4137,116,2.7
29063,5/1/19,4837,4716,121,2.5
29065,5/1/19,6331,6128,203,3.2
29067,5/1/19,5136,4950,186,3.6
29069,5/1/19,11830,11244,586,5
29071,5/1/19,52824,51281,1543,2.9
29073,5/1/19,7808,7566,242,3.1
29075,5/1/19,3676,3580,96,2.6
29077,5/1/19,150934,147157,3777,2.5
29079,5/1/19,4498,4360,138,3.1
29081,5/1/19,3928,3823,105,2.7
29083,5/1/19,9920,9528,392,4
29085,5/1/19,3888,3758,130,3.3
29087,5/1/19,2684,2613,71,2.6
29089,5/1/19,4936,4802,134,2.7
29091,5/1/19,16437,15886,551,3.4
29093,5/1/19,3563,3416,147,4.1
29095,5/1/19,359802,347643,12159,3.4
29097,5/1/19,56765,55148,1617,2.8
29099,5/1/19,116881,113675,3206,2.7
29101,5/1/19,23062,22295,767,3.3
29103,5/1/19,1804,1756,48,2.7
29105,5/1/19,17988,16487,1501,8.3
29107,5/1/19,16824,16369,455,2.7
29109,5/1/19,18047,17531,516,2.9
29111,5/1/19,5113,4969,144,2.8
29113,5/1/19,28230,27422,808,2.9
29115,5/1/19,5197,4976,221,4.3
29117,5/1/19,7387,7225,162,2.2
29119,5/1/19,10615,10278,337,3.2
29121,5/1/19,7593,7379,214,2.8
29123,5/1/19,5536,5363,173,3.1
29125,5/1/19,3934,3822,112,2.8
29127,5/1/19,14519,14096,423,2.9
29129,5/1/19,1964,1917,47,2.4
29131,5/1/19,12525,12162,363,2.9
29133,5/1/19,5908,5705,203,3.4
29135,5/1/19,7371,7185,186,2.5
29137,5/1/19,3941,3804,137,3.5
29139,5/1/19,5818,5658,160,2.8
29141,5/1/19,8198,7913,285,3.5
29143,5/1/19,8384,8077,307,3.7
29145,5/1/19,27231,26380,851,3.1
29147,5/1/19,10679,10361,318,3
29149,5/1/19,4017,3873,144,3.6
29151,5/1/19,7140,6982,158,2.2
29153,5/1/19,3574,3408,166,4.6
29155,5/1/19,6461,6182,279,4.3
29157,5/1/19,10102,9873,229,2.3
29159,5/1/19,20914,20259,655,3.1
29161,5/1/19,19910,19315,595,3
29163,5/1/19,7582,7344,238,3.1
29165,5/1/19,58360,56954,1406,2.4
29167,5/1/19,14533,14085,448,3.1
29169,5/1/19,14699,14110,589,4
29171,5/1/19,2353,2279,74,3.1
29173,5/1/19,5667,5504,163,2.9
29175,5/1/19,10428,10087,341,3.3
29177,5/1/19,10932,10600,332,3
29179,5/1/19,3108,3009,99,3.2
29181,5/1/19,5167,4827,340,6.6
29183,5/1/19,225606,220332,5274,2.3
29185,5/1/19,3863,3703,160,4.1
29186,5/1/19,9237,9036,201,2.2
29187,5/1/19,26621,25769,852,3.2
29189,5/1/19,528571,513492,15079,2.9
29195,5/1/19,10723,10401,322,3
29197,5/1/19,1978,1911,67,3.4
29199,5/1/19,2434,2360,74,3
29201,5/1/19,20141,19518,623,3.1
29203,5/1/19,3289,3137,152,4.6
29205,5/1/19,3141,3071,70,2.2
29207,5/1/19,13323,12745,578,4.3
29209,5/1/19,13851,13343,508,3.7
29211,5/1/19,2750,2669,81,2.9
29213,5/1/19,27057,26121,936,3.5
29215,5/1/19,9259,8886,373,4
29217,5/1/19,9657,9358,299,3.1
29219,5/1/19,17864,17386,478,2.7
29221,5/1/19,10259,9856,403,3.9
29223,5/1/19,5336,5077,259,4.9
29225,5/1/19,17285,16747,538,3.1
29227,5/1/19,1224,1199,25,2
29229,5/1/19,7651,7319,332,4.3
29510,5/1/19,151574,146231,5343,3.5
30001,5/1/19,5058,4935,123,2.4
30003,5/1/19,4826,4507,319,6.6
30005,5/1/19,2505,2440,65,2.6
30007,5/1/19,2573,2480,93,3.6
30009,5/1/19,5456,5302,154,2.8
30011,5/1/19,622,603,19,3.1
30013,5/1/19,38071,37010,1061,2.8
30015,5/1/19,2449,2395,54,2.2
30017,5/1/19,6165,6037,128,2.1
30019,5/1/19,888,876,12,1.4
30021,5/1/19,4597,4507,90,2
30023,5/1/19,5040,4908,132,2.6
30025,5/1/19,1706,1685,21,1.2
30027,5/1/19,6064,5934,130,2.1
30029,5/1/19,47572,45732,1840,3.9
30031,5/1/19,67561,66059,1502,2.2
30033,5/1/19,730,719,11,1.5
30035,5/1/19,5601,5258,343,6.1
30037,5/1/19,363,349,14,3.9
30039,5/1/19,1640,1562,78,4.8
30041,5/1/19,7648,7433,215,2.8
30043,5/1/19,5667,5530,137,2.4
30045,5/1/19,922,902,20,2.2
30047,5/1/19,13337,12884,453,3.4
30049,5/1/19,35797,34970,827,2.3
30051,5/1/19,928,909,19,2
30053,5/1/19,8097,7643,454,5.6
30055,5/1/19,937,923,14,1.5
30057,5/1/19,4445,4330,115,2.6
30059,5/1/19,896,869,27,3
30061,5/1/19,1801,1727,74,4.1
30063,5/1/19,64193,62547,1646,2.6
30065,5/1/19,2235,2172,63,2.8
30067,5/1/19,8938,8677,261,2.9
30069,5/1/19,270,264,6,2.2
30071,5/1/19,1841,1795,46,2.5
30073,5/1/19,2695,2610,85,3.2
30075,5/1/19,942,927,15,1.6
30077,5/1/19,2975,2870,105,3.5
30079,5/1/19,472,457,15,3.2
30081,5/1/19,20337,19679,658,3.2
30083,5/1/19,5822,5689,133,2.3
30085,5/1/19,4554,4395,159,3.5
30087,5/1/19,3822,3669,153,4
30089,5/1/19,4879,4659,220,4.5
30091,5/1/19,1739,1707,32,1.8
30093,5/1/19,17086,16575,511,3
30095,5/1/19,5153,5017,136,2.6
30097,5/1/19,1778,1734,44,2.5
30099,5/1/19,2753,2683,70,2.5
30101,5/1/19,2112,2068,44,2.1
30103,5/1/19,331,324,7,2.1
30105,5/1/19,4096,4007,89,2.2
30107,5/1/19,777,756,21,2.7
30109,5/1/19,459,448,11,2.4
30111,5/1/19,81792,79672,2120,2.6
31001,5/1/19,16807,16318,489,2.9
31003,5/1/19,3635,3546,89,2.4
31005,5/1/19,227,218,9,4
31007,5/1/19,374,362,12,3.2
31009,5/1/19,264,253,11,4.2
31011,5/1/19,3042,2968,74,2.4
31013,5/1/19,5458,5275,183,3.4
31015,5/1/19,1090,1056,34,3.1
31017,5/1/19,1432,1384,48,3.4
31019,5/1/19,27973,27210,763,2.7
31021,5/1/19,3573,3468,105,2.9
31023,5/1/19,4676,4554,122,2.6
31025,5/1/19,13549,13117,432,3.2
31027,5/1/19,4602,4480,122,2.7
31029,5/1/19,2321,2267,54,2.3
31031,5/1/19,3478,3392,86,2.5
31033,5/1/19,4423,4268,155,3.5
31035,5/1/19,3343,3243,100,3
31037,5/1/19,5625,5477,148,2.6
31039,5/1/19,4831,4706,125,2.6
31041,5/1/19,6550,6395,155,2.4
31043,5/1/19,10685,10342,343,3.2
31045,5/1/19,5040,4889,151,3
31047,5/1/19,13046,12680,366,2.8
31049,5/1/19,976,948,28,2.9
31051,5/1/19,3055,2957,98,3.2
31053,5/1/19,19437,18879,558,2.9
31055,5/1/19,298676,289191,9485,3.2
31057,5/1/19,1192,1163,29,2.4
31059,5/1/19,3221,3138,83,2.6
31061,5/1/19,1490,1442,48,3.2
31063,5/1/19,1648,1599,49,3
31065,5/1/19,2663,2592,71,2.7
31067,5/1/19,11084,10741,343,3.1
31069,5/1/19,1121,1089,32,2.9
31071,5/1/19,1182,1140,42,3.6
31073,5/1/19,1130,1098,32,2.8
31075,5/1/19,430,419,11,2.6
31077,5/1/19,1272,1232,40,3.1
31079,5/1/19,31981,31015,966,3
31081,5/1/19,4815,4678,137,2.8
31083,5/1/19,1858,1807,51,2.7
31085,5/1/19,626,612,14,2.2
31087,5/1/19,1273,1231,42,3.3
31089,5/1/19,5903,5755,148,2.5
31091,5/1/19,460,448,12,2.6
31093,5/1/19,3379,3281,98,2.9
31095,5/1/19,4199,4091,108,2.6
31097,5/1/19,2091,2023,68,3.3
31099,5/1/19,3844,3749,95,2.5
31101,5/1/19,4693,4561,132,2.8
31103,5/1/19,608,593,15,2.5
31105,5/1/19,2036,1976,60,2.9
31107,5/1/19,4707,4581,126,2.7
31109,5/1/19,176840,171920,4920,2.8
31111,5/1/19,18413,17816,597,3.2
31113,5/1/19,486,472,14,2.9
31115,5/1/19,414,400,14,3.4
31117,5/1/19,447,436,11,2.5
31119,5/1/19,19717,19180,537,2.7
31121,5/1/19,4046,3928,118,2.9
31123,5/1/19,2634,2562,72,2.7
31125,5/1/19,2018,1963,55,2.7
31127,5/1/19,3684,3544,140,3.8
31129,5/1/19,2394,2331,63,2.6
31131,5/1/19,8490,8201,289,3.4
31133,5/1/19,1515,1472,43,2.8
31135,5/1/19,1844,1799,45,2.4
31137,5/1/19,5046,4912,134,2.7
31139,5/1/19,4151,4048,103,2.5
31141,5/1/19,17696,17170,526,3
31143,5/1/19,2985,2905,80,2.7
31145,5/1/19,5858,5695,163,2.8
31147,5/1/19,4325,4190,135,3.1
31149,5/1/19,880,854,26,3
31151,5/1/19,7476,7262,214,2.9
31153,5/1/19,96362,93570,2792,2.9
31155,5/1/19,11198,10886,312,2.8
31157,5/1/19,18344,17699,645,3.5
31159,5/1/19,8978,8701,277,3.1
31161,5/1/19,2709,2631,78,2.9
31163,5/1/19,1728,1676,52,3
31165,5/1/19,747,725,22,2.9
31167,5/1/19,3506,3418,88,2.5
31169,5/1/19,2832,2760,72,2.5
31171,5/1/19,434,420,14,3.2
31173,5/1/19,3026,2903,123,4.1
31175,5/1/19,2160,2089,71,3.3
31177,5/1/19,11262,10948,314,2.8
31179,5/1/19,5775,5621,154,2.7
31181,5/1/19,1709,1647,62,3.6
31183,5/1/19,605,590,15,2.5
31185,5/1/19,7319,7122,197,2.7
32001,5/1/19,10960,10575,385,3.5
32003,5/1/19,1129068,1083724,45344,4
32005,5/1/19,23033,22113,920,4
32007,5/1/19,27727,26966,761,2.7
32009,5/1/19,409,397,12,2.9
32011,5/1/19,1041,1017,24,2.3
32013,5/1/19,8105,7887,218,2.7
32015,5/1/19,3184,3094,90,2.8
32017,5/1/19,2043,1963,80,3.9
32019,5/1/19,23521,22494,1027,4.4
32021,5/1/19,2045,1958,87,4.3
32023,5/1/19,17216,16332,884,5.1
32027,5/1/19,2479,2386,93,3.8
32029,5/1/19,2028,1953,75,3.7
32031,5/1/19,254713,246796,7917,3.1
32033,5/1/19,4573,4440,133,2.9
32510,5/1/19,26393,25380,1013,3.8
33001,5/1/19,31360,30604,756,2.4
33003,5/1/19,23058,22462,596,2.6
33005,5/1/19,40798,39804,994,2.4
33007,5/1/19,14473,14005,468,3.2
33009,5/1/19,48979,47934,1045,2.1
33011,5/1/19,241922,235916,6006,2.5
33013,5/1/19,83272,81486,1786,2.1
33015,5/1/19,187235,182487,4748,2.5
33017,5/1/19,74743,73148,1595,2.1
33019,5/1/19,22958,22444,514,2.2
34001,5/1/19,118905,113924,4981,4.2
34003,5/1/19,475708,463823,11885,2.5
34005,5/1/19,228810,222498,6312,2.8
34007,5/1/19,250146,241616,8530,3.4
34009,5/1/19,45722,43420,2302,5
34011,5/1/19,66272,63414,2858,4.3
34013,5/1/19,363798,349937,13861,3.8
34015,5/1/19,148228,143675,4553,3.1
34017,5/1/19,356257,346126,10131,2.8
34019,5/1/19,64294,62802,1492,2.3
34021,5/1/19,200414,195107,5307,2.6
34023,5/1/19,434190,422701,11489,2.6
34025,5/1/19,325339,316581,8758,2.7
34027,5/1/19,254079,247938,6141,2.4
34029,5/1/19,271491,263213,8278,3
34031,5/1/19,238429,229862,8567,3.6
34033,5/1/19,29366,28226,1140,3.9
34035,5/1/19,169680,165297,4383,2.6
34037,5/1/19,73338,71275,2063,2.8
34039,5/1/19,272862,264372,8490,3.1
34041,5/1/19,56014,54496,1518,2.7
35001,5/1/19,330378,316802,13576,4.1
35003,5/1/19,1143,1083,60,5.2
35005,5/1/19,26927,25736,1191,4.4
35006,5/1/19,8999,8506,493,5.5
35007,5/1/19,5187,4939,248,4.8
35009,5/1/19,21645,20828,817,3.8
35011,5/1/19,781,752,29,3.7
35013,5/1/19,97165,91993,5172,5.3
35015,5/1/19,33603,32661,942,2.8
35017,5/1/19,12138,11614,524,4.3
35019,5/1/19,1556,1474,82,5.3
35021,5/1/19,269,258,11,4.1
35023,5/1/19,2161,2083,78,3.6
35025,5/1/19,30562,29471,1091,3.6
35027,5/1/19,9178,8817,361,3.9
35028,5/1/19,9353,9076,277,3
35029,5/1/19,10336,9189,1147,11.1
35031,5/1/19,24006,22521,1485,6.2
35033,5/1/19,2207,2096,111,5
35035,5/1/19,24574,23451,1123,4.6
35037,5/1/19,3238,3080,158,4.9
35039,5/1/19,16795,16022,773,4.6
35041,5/1/19,7971,7647,324,4.1
35043,5/1/19,65743,62842,2901,4.4
35045,5/1/19,51710,49183,2527,4.9
35047,5/1/19,10534,9964,570,5.4
35049,5/1/19,74140,71375,2765,3.7
35051,5/1/19,3802,3543,259,6.8
35053,5/1/19,6397,6063,334,5.2
35055,5/1/19,14437,13573,864,6
35057,5/1/19,5561,5225,336,6
35059,5/1/19,1839,1781,58,3.2
35061,5/1/19,30341,28867,1474,4.9
36001,5/1/19,156369,151216,5153,3.3
36003,5/1/19,18788,17882,906,4.8
36005,5/1/19,593792,563604,30188,5.1
36007,5/1/19,83571,80202,3369,4
36009,5/1/19,32798,31356,1442,4.4
36011,5/1/19,35254,33919,1335,3.8
36013,5/1/19,53789,51590,2199,4.1
36015,5/1/19,34843,33505,1338,3.8
36017,5/1/19,21531,20720,811,3.8
36019,5/1/19,35916,34502,1414,3.9
36021,5/1/19,30633,29745,888,2.9
36023,5/1/19,22520,21637,883,3.9
36025,5/1/19,18565,17818,747,4
36027,5/1/19,143341,138631,4710,3.3
36029,5/1/19,438920,422597,16323,3.7
36031,5/1/19,16060,15390,670,4.2
36033,5/1/19,19058,18217,841,4.4
36035,5/1/19,22476,21513,963,4.3
36037,5/1/19,29264,28278,986,3.4
36039,5/1/19,19754,18932,822,4.2
36041,5/1/19,2148,2045,103,4.8
36043,5/1/19,27554,26416,1138,4.1
36045,5/1/19,43684,41687,1997,4.6
36047,5/1/19,1193721,1146523,47198,4
36049,5/1/19,11139,10623,516,4.6
36051,5/1/19,30104,29019,1085,3.6
36053,5/1/19,32048,30840,1208,3.8
36055,5/1/19,360232,346738,13494,3.7
36057,5/1/19,21923,20959,964,4.4
36059,5/1/19,705819,683602,22217,3.1
36061,5/1/19,908821,877586,31235,3.4
36063,5/1/19,97773,93645,4128,4.2
36065,5/1/19,100665,96819,3846,3.8
36067,5/1/19,219017,211357,7660,3.5
36069,5/1/19,54831,52925,1906,3.5
36071,5/1/19,183648,177295,6353,3.5
36073,5/1/19,17054,16380,674,4
36075,5/1/19,52342,49806,2536,4.8
36077,5/1/19,27561,26596,965,3.5
36079,5/1/19,51119,49415,1704,3.3
36081,5/1/19,1134869,1096753,38116,3.4
36083,5/1/19,80450,77708,2742,3.4
36085,5/1/19,221299,213068,8231,3.7
36087,5/1/19,154867,149875,4992,3.2
36089,5/1/19,42661,40561,2100,4.9
36091,5/1/19,117895,114354,3541,3
36093,5/1/19,75509,72865,2644,3.5
36095,5/1/19,14240,13696,544,3.8
36097,5/1/19,7992,7697,295,3.7
36099,5/1/19,15719,15200,519,3.3
36101,5/1/19,41809,40121,1688,4
36103,5/1/19,773165,748168,24997,3.2
36105,5/1/19,35767,34486,1281,3.6
36107,5/1/19,22671,21851,820,3.6
36109,5/1/19,49179,47577,1602,3.3
36111,5/1/19,87373,84431,2942,3.4
36113,5/1/19,30925,29720,1205,3.9
36115,5/1/19,27109,26162,947,3.5
36117,5/1/19,42983,41477,1506,3.5
36119,5/1/19,483414,466951,16463,3.4
36121,5/1/19,17475,16864,611,3.5
36123,5/1/19,11354,10991,363,3.2
37001,5/1/19,82382,79241,3141,3.8
37003,5/1/19,18229,17604,625,3.4
37005,5/1/19,4471,4266,205,4.6
37007,5/1/19,10863,10431,432,4
37009,5/1/19,12998,12523,475,3.7
37011,5/1/19,7537,7255,282,3.7
37013,5/1/19,19720,18824,896,4.5
37015,5/1/19,7865,7493,372,4.7
37017,5/1/19,14834,14158,676,4.6
37019,5/1/19,55192,52409,2783,5
37021,5/1/19,141587,137318,4269,3
37023,5/1/19,41334,39802,1532,3.7
37025,5/1/19,109427,105551,3876,3.5
37027,5/1/19,36881,35367,1514,4.1
37029,5/1/19,4710,4533,177,3.8
37031,5/1/19,32760,31436,1324,4
37033,5/1/19,9931,9479,452,4.6
37035,5/1/19,79553,76706,2847,3.6
37037,5/1/19,35821,34600,1221,3.4
37039,5/1/19,11304,10816,488,4.3
37041,5/1/19,5602,5331,271,4.8
37043,5/1/19,4209,4019,190,4.5
37045,5/1/19,48663,46778,1885,3.9
37047,5/1/19,22917,21802,1115,4.9
37049,5/1/19,42079,40359,1720,4.1
37051,5/1/19,129505,123017,6488,5
37053,5/1/19,14036,13545,491,3.5
37055,5/1/19,21133,20291,842,4
37057,5/1/19,81773,78796,2977,3.6
37059,5/1/19,20911,20201,710,3.4
37061,5/1/19,25753,24713,1040,4
37063,5/1/19,172081,166083,5998,3.5
37065,5/1/19,21397,20141,1256,5.9
37067,5/1/19,189926,182800,7126,3.8
37069,5/1/19,31454,30192,1262,4
37071,5/1/19,111389,107114,4275,3.8
37073,5/1/19,5365,5144,221,4.1
37075,5/1/19,3306,3129,177,5.4
37077,5/1/19,30429,29390,1039,3.4
37079,5/1/19,9789,9407,382,3.9
37081,5/1/19,265923,255082,10841,4.1
37083,5/1/19,20624,19497,1127,5.5
37085,5/1/19,53717,51190,2527,4.7
37087,5/1/19,30233,29193,1040,3.4
37089,5/1/19,55688,53786,1902,3.4
37091,5/1/19,9289,8805,484,5.2
37093,5/1/19,20418,19431,987,4.8
37095,5/1/19,2091,1956,135,6.5
37097,5/1/19,89816,86587,3229,3.6
37099,5/1/19,20102,19260,842,4.2
37101,5/1/19,99689,96066,3623,3.6
37103,5/1/19,4470,4300,170,3.8
37105,5/1/19,26242,25053,1189,4.5
37107,5/1/19,28370,27299,1071,3.8
37109,5/1/19,43619,42077,1542,3.5
37111,5/1/19,21053,20281,772,3.7
37113,5/1/19,15697,15089,608,3.9
37115,5/1/19,10281,9894,387,3.8
37117,5/1/19,9189,8717,472,5.1
37119,5/1/19,623436,600751,22685,3.6
37121,5/1/19,6065,5784,281,4.6
37123,5/1/19,11750,11297,453,3.9
37125,5/1/19,43355,41728,1627,3.8
37127,5/1/19,43497,41360,2137,4.9
37129,5/1/19,125380,120911,4469,3.6
37131,5/1/19,7853,7465,388,4.9
37133,5/1/19,65820,62796,3024,4.6
37135,5/1/19,79200,76525,2675,3.4
37137,5/1/19,5400,5195,205,3.8
37139,5/1/19,16893,16148,745,4.4
37141,5/1/19,29276,28137,1139,3.9
37143,5/1/19,5048,4795,253,5
37145,5/1/19,18562,17786,776,4.2
37147,5/1/19,91057,87152,3905,4.3
37149,5/1/19,9155,8805,350,3.8
37151,5/1/19,67201,64690,2511,3.7
37153,5/1/19,16914,16059,855,5.1
37155,5/1/19,50438,47748,2690,5.3
37157,5/1/19,40689,38909,1780,4.4
37159,5/1/19,66398,63788,2610,3.9
37161,5/1/19,25805,24584,1221,4.7
37163,5/1/19,29815,28699,1116,3.7
37165,5/1/19,11603,10878,725,6.2
37167,5/1/19,30510,29383,1127,3.7
37169,5/1/19,21939,21153,786,3.6
37171,5/1/19,34403,33155,1248,3.6
37173,5/1/19,7117,6846,271,3.8
37175,5/1/19,14809,14252,557,3.8
37177,5/1/19,1587,1499,88,5.5
37179,5/1/19,124344,119994,4350,3.5
37181,5/1/19,17663,16692,971,5.5
37183,5/1/19,598255,577937,20318,3.4
37185,5/1/19,6718,6340,378,5.6
37187,5/1/19,4534,4281,253,5.6
37189,5/1/19,29420,28349,1071,3.6
37191,5/1/19,52968,50774,2194,4.1
37193,5/1/19,29530,28343,1187,4
37195,5/1/19,35160,33079,2081,5.9
37197,5/1/19,17998,17373,625,3.5
37199,5/1/19,8527,8213,314,3.7
38001,5/1/19,1031,1012,19,1.8
38003,5/1/19,5160,5022,138,2.7
38005,5/1/19,2250,2161,89,4
38007,5/1/19,415,407,8,1.9
38009,5/1/19,2994,2912,82,2.7
38011,5/1/19,1717,1694,23,1.3
38013,5/1/19,1084,1062,22,2
38015,5/1/19,49190,48193,997,2
38017,5/1/19,102622,100795,1827,1.8
38019,5/1/19,1934,1890,44,2.3
38021,5/1/19,2308,2268,40,1.7
38023,5/1/19,1464,1444,20,1.4
38025,5/1/19,3179,3131,48,1.5
38027,5/1/19,1252,1196,56,4.5
38029,5/1/19,1450,1397,53,3.7
38031,5/1/19,1528,1492,36,2.4
38033,5/1/19,850,836,14,1.6
38035,5/1/19,37080,36371,709,1.9
38037,5/1/19,1176,1149,27,2.3
38039,5/1/19,1030,1008,22,2.1
38041,5/1/19,1384,1364,20,1.4
38043,5/1/19,1244,1197,47,3.8
38045,5/1/19,2095,2055,40,1.9
38047,5/1/19,859,840,19,2.2
38049,5/1/19,3071,2988,83,2.7
38051,5/1/19,1126,1093,33,2.9
38053,5/1/19,10417,10286,131,1.3
38055,5/1/19,4771,4647,124,2.6
38057,5/1/19,3909,3787,122,3.1
38059,5/1/19,16138,15764,374,2.3
38061,5/1/19,7266,7186,80,1.1
38063,5/1/19,1395,1359,36,2.6
38065,5/1/19,855,829,26,3
38067,5/1/19,3330,3222,108,3.2
38069,5/1/19,1758,1711,47,2.7
38071,5/1/19,5568,5420,148,2.7
38073,5/1/19,2779,2737,42,1.5
38075,5/1/19,1205,1175,30,2.5
38077,5/1/19,8528,8351,177,2.1
38079,5/1/19,4487,4215,272,6.1
38081,5/1/19,2577,2537,40,1.6
38083,5/1/19,692,674,18,2.6
38085,5/1/19,1235,1185,50,4
38087,5/1/19,386,378,8,2.1
38089,5/1/19,18609,18286,323,1.7
38091,5/1/19,969,949,20,2.1
38093,5/1/19,10229,10024,205,2
38095,5/1/19,1183,1156,27,2.3
38097,5/1/19,4366,4249,117,2.7
38099,5/1/19,5181,5032,149,2.9
38101,5/1/19,31527,30846,681,2.2
38103,5/1/19,1927,1878,49,2.5
38105,5/1/19,24122,23736,386,1.6
39001,5/1/19,10643,10063,580,5.4
39003,5/1/19,47927,46296,1631,3.4
39005,5/1/19,26601,25675,926,3.5
39007,5/1/19,44478,42758,1720,3.9
39009,5/1/19,25784,24580,1204,4.7
39011,5/1/19,25079,24417,662,2.6
39013,5/1/19,29966,28614,1352,4.5
39015,5/1/19,19413,18636,777,4
39017,5/1/19,193937,187606,6331,3.3
39019,5/1/19,12980,12408,572,4.4
39021,5/1/19,20144,19529,615,3.1
39023,5/1/19,63202,60959,2243,3.5
39025,5/1/19,106197,102769,3428,3.2
39027,5/1/19,17477,16759,718,4.1
39029,5/1/19,47278,45296,1982,4.2
39031,5/1/19,14465,13711,754,5.2
39033,5/1/19,18315,17597,718,3.9
39035,5/1/19,610757,586088,24669,4
39037,5/1/19,26076,25285,791,3
39039,5/1/19,18042,17387,655,3.6
39041,5/1/19,109530,106485,3045,2.8
39043,5/1/19,37862,36402,1460,3.9
39045,5/1/19,77484,74935,2549,3.3
39047,5/1/19,13850,13376,474,3.4
39049,5/1/19,692216,670275,21941,3.2
39051,5/1/19,22541,21732,809,3.6
39053,5/1/19,11962,11431,531,4.4
39055,5/1/19,48949,47411,1538,3.1
39057,5/1/19,82835,80088,2747,3.3
39059,5/1/19,18604,17800,804,4.3
39061,5/1/19,413795,399880,13915,3.4
39063,5/1/19,41692,40488,1204,2.9
39065,5/1/19,14141,13629,512,3.6
39067,5/1/19,6791,6506,285,4.2
39069,5/1/19,13242,12749,493,3.7
39071,5/1/19,17039,16311,728,4.3
39073,5/1/19,12920,12432,488,3.8
39075,5/1/19,21082,20541,541,2.6
39077,5/1/19,28018,26824,1194,4.3
39079,5/1/19,12729,12071,658,5.2
39081,5/1/19,27453,26107,1346,4.9
39083,5/1/19,31360,30324,1036,3.3
39085,5/1/19,125860,121538,4322,3.4
39087,5/1/19,23573,22520,1053,4.5
39089,5/1/19,89826,86927,2899,3.2
39091,5/1/19,22952,22259,693,3
39093,5/1/19,152990,147055,5935,3.9
39095,5/1/19,213172,201455,11717,5.5
39097,5/1/19,20725,20118,607,2.9
39099,5/1/19,103061,97695,5366,5.2
39101,5/1/19,28782,27770,1012,3.5
39103,5/1/19,97318,94180,3138,3.2
39105,5/1/19,8927,8397,530,5.9
39107,5/1/19,23770,23234,536,2.3
39109,5/1/19,53848,52119,1729,3.2
39111,5/1/19,5325,4947,378,7.1
39113,5/1/19,251188,241531,9657,3.8
39115,5/1/19,6753,6416,337,5
39117,5/1/19,16653,16088,565,3.4
39119,5/1/19,39318,37742,1576,4
39121,5/1/19,4695,4426,269,5.7
39123,5/1/19,21407,20521,886,4.1
39125,5/1/19,8694,8409,285,3.3
39127,5/1/19,15717,15062,655,4.2
39129,5/1/19,26279,25375,904,3.4
39131,5/1/19,10824,10290,534,4.9
39133,5/1/19,86732,83673,3059,3.5
39135,5/1/19,21046,20362,684,3.3
39137,5/1/19,19010,18526,484,2.5
39139,5/1/19,52363,50390,1973,3.8
39141,5/1/19,35309,34062,1247,3.5
39143,5/1/19,30456,29402,1054,3.5
39145,5/1/19,28744,27209,1535,5.3
39147,5/1/19,27373,26304,1069,3.9
39149,5/1/19,24258,23512,746,3.1
39151,5/1/19,185679,178255,7424,4
39153,5/1/19,270730,260755,9975,3.7
39155,5/1/19,86618,81845,4773,5.5
39157,5/1/19,45193,43514,1679,3.7
39159,5/1/19,28848,28045,803,2.8
39161,5/1/19,15128,14716,412,2.7
39163,5/1/19,5563,5316,247,4.4
39165,5/1/19,118589,114921,3668,3.1
39167,5/1/19,27281,26047,1234,4.5
39169,5/1/19,62160,60443,1717,2.8
39171,5/1/19,18933,18414,519,2.7
39173,5/1/19,71488,68968,2520,3.5
39175,5/1/19,13108,12631,477,3.6
40001,5/1/19,8038,7708,330,4.1
40003,5/1/19,2853,2802,51,1.8
40005,5/1/19,4896,4686,210,4.3
40007,5/1/19,2892,2834,58,2
40009,5/1/19,10687,10404,283,2.6
40011,5/1/19,4780,4692,88,1.8
40013,5/1/19,21291,20640,651,3.1
40015,5/1/19,11710,11319,391,3.3
40017,5/1/19,73747,71743,2004,2.7
40019,5/1/19,21688,20973,715,3.3
40021,5/1/19,18938,18198,740,3.9
40023,5/1/19,5415,5162,253,4.7
40025,5/1/19,1291,1270,21,1.6
40027,5/1/19,142229,138221,4008,2.8
40029,5/1/19,2634,2545,89,3.4
40031,5/1/19,48114,46429,1685,3.5
40033,5/1/19,2704,2621,83,3.1
40035,5/1/19,5921,5719,202,3.4
40037,5/1/19,31480,30361,1119,3.6
40039,5/1/19,15721,15355,366,2.3
40041,5/1/19,18039,17382,657,3.6
40043,5/1/19,2985,2935,50,1.7
40045,5/1/19,2180,2130,50,2.3
40047,5/1/19,27053,26271,782,2.9
40049,5/1/19,12559,12173,386,3.1
40051,5/1/19,26272,25510,762,2.9
40053,5/1/19,2641,2581,60,2.3
40055,5/1/19,1813,1745,68,3.8
40057,5/1/19,1153,1119,34,2.9
40059,5/1/19,1721,1670,51,3
40061,5/1/19,4240,4047,193,4.6
40063,5/1/19,5355,5101,254,4.7
40065,5/1/19,10589,10283,306,2.9
40067,5/1/19,2500,2424,76,3
40069,5/1/19,3766,3618,148,3.9
40071,5/1/19,18349,17565,784,4.3
40073,5/1/19,9150,8961,189,2.1
40075,5/1/19,3466,3341,125,3.6
40077,5/1/19,3151,2979,172,5.5
40079,5/1/19,19040,18178,862,4.5
40081,5/1/19,15691,15152,539,3.4
40083,5/1/19,21957,21329,628,2.9
40085,5/1/19,6168,6034,134,2.2
40087,5/1/19,19477,18981,496,2.5
40089,5/1/19,14126,13363,763,5.4
40091,5/1/19,7172,6802,370,5.2
40093,5/1/19,3863,3786,77,2
40095,5/1/19,6861,6634,227,3.3
40097,5/1/19,19469,18854,615,3.2
40099,5/1/19,6377,6201,176,2.8
40101,5/1/19,29291,28180,1111,3.8
40103,5/1/19,5689,5551,138,2.4
40105,5/1/19,4595,4432,163,3.5
40107,5/1/19,4673,4468,205,4.4
40109,5/1/19,382977,371217,11760,3.1
40111,5/1/19,15620,14867,753,4.8
40113,5/1/19,20579,19813,766,3.7
40115,5/1/19,14157,13664,493,3.5
40117,5/1/19,7322,7043,279,3.8
40119,5/1/19,38202,37051,1151,3
40121,5/1/19,17287,16629,658,3.8
40123,5/1/19,19093,18550,543,2.8
40125,5/1/19,32350,31181,1169,3.6
40127,5/1/19,4249,4050,199,4.7
40129,5/1/19,1884,1837,47,2.5
40131,5/1/19,44923,43555,1368,3
40133,5/1/19,9391,8977,414,4.4
40135,5/1/19,16158,15546,612,3.8
40137,5/1/19,18458,17725,733,4
40139,5/1/19,10992,10766,226,2.1
40141,5/1/19,2966,2865,101,3.4
40143,5/1/19,322365,312440,9925,3.1
40145,5/1/19,37788,36667,1121,3
40147,5/1/19,22177,21443,734,3.3
40149,5/1/19,5190,5034,156,3
40151,5/1/19,4595,4498,97,2.1
40153,5/1/19,9083,8855,228,2.5
41001,5/1/19,7083,6796,287,4.1
41003,5/1/19,48453,47186,1267,2.6
41005,5/1/19,217809,210914,6895,3.2
41007,5/1/19,19465,18806,659,3.4
41009,5/1/19,24246,23232,1014,4.2
41011,5/1/19,26244,25057,1187,4.5
41013,5/1/19,9536,9081,455,4.8
41015,5/1/19,8832,8425,407,4.6
41017,5/1/19,95754,92455,3299,3.4
41019,5/1/19,45903,43868,2035,4.4
41021,5/1/19,995,963,32,3.2
41023,5/1/19,3158,2978,180,5.7
41025,5/1/19,3594,3431,163,4.5
41027,5/1/19,13665,13253,412,3
41029,5/1/19,102918,98748,4170,4.1
41031,5/1/19,10269,9838,431,4.2
41033,5/1/19,35781,34163,1618,4.5
41035,5/1/19,29449,27955,1494,5.1
41037,5/1/19,3587,3417,170,4.7
41039,5/1/19,180388,173668,6720,3.7
41041,5/1/19,21018,20216,802,3.8
41043,5/1/19,58533,56217,2316,4
41045,5/1/19,12240,11801,439,3.6
41047,5/1/19,160870,154969,5901,3.7
41049,5/1/19,5713,5523,190,3.3
41051,5/1/19,451939,437953,13986,3.1
41053,5/1/19,39515,38032,1483,3.8
41055,5/1/19,908,880,28,3.1
41057,5/1/19,11896,11483,413,3.5
41059,5/1/19,37004,35565,1439,3.9
41061,5/1/19,11989,11508,481,4
41063,5/1/19,3446,3263,183,5.3
41065,5/1/19,12620,12138,482,3.8
41067,5/1/19,322589,313340,9249,2.9
41069,5/1/19,734,703,31,4.2
41071,5/1/19,54433,52761,1672,3.1
42001,5/1/19,55202,53566,1636,3
42003,5/1/19,645320,620491,24829,3.8
42005,5/1/19,31858,30589,1269,4
42007,5/1/19,83546,80074,3472,4.2
42009,5/1/19,23747,22883,864,3.6
42011,5/1/19,215269,206516,8753,4.1
42013,5/1/19,59231,56970,2261,3.8
42015,5/1/19,29000,27937,1063,3.7
42017,5/1/19,342764,330483,12281,3.6
42019,5/1/19,99167,95769,3398,3.4
42021,5/1/19,57872,55196,2676,4.6
42023,5/1/19,2093,1992,101,4.8
42025,5/1/19,31940,30430,1510,4.7
42027,5/1/19,80537,77900,2637,3.3
42029,5/1/19,285817,277199,8618,3
42031,5/1/19,16940,16217,723,4.3
42033,5/1/19,35633,34139,1494,4.2
42035,5/1/19,18151,17272,879,4.8
42037,5/1/19,33102,31567,1535,4.6
42039,5/1/19,38918,37277,1641,4.2
42041,5/1/19,131431,127290,4141,3.2
42043,5/1/19,143294,137960,5334,3.7
42045,5/1/19,297218,285654,11564,3.9
42047,5/1/19,15676,15031,645,4.1
42049,5/1/19,127955,122691,5264,4.1
42051,5/1/19,56464,53688,2776,4.9
42053,5/1/19,1810,1717,93,5.1
42055,5/1/19,77185,74508,2677,3.5
42057,5/1/19,7842,7566,276,3.5
42059,5/1/19,16461,15698,763,4.6
42061,5/1/19,19954,19062,892,4.5
42063,5/1/19,39078,37378,1700,4.4
42065,5/1/19,20572,19776,796,3.9
42067,5/1/19,12517,12057,460,3.7
42069,5/1/19,104226,99529,4697,4.5
42071,5/1/19,283772,274746,9026,3.2
42073,5/1/19,40604,38837,1767,4.4
42075,5/1/19,72444,69914,2530,3.5
42077,5/1/19,192177,183998,8179,4.3
42079,5/1/19,156061,147935,8126,5.2
42081,5/1/19,56285,53845,2440,4.3
42083,5/1/19,17351,16570,781,4.5
42085,5/1/19,49226,47049,2177,4.4
42087,5/1/19,21008,20195,813,3.9
42089,5/1/19,82569,78455,4114,5
42091,5/1/19,453174,438252,14922,3.3
42093,5/1/19,8991,8691,300,3.3
42095,5/1/19,160818,154093,6725,4.2
42097,5/1/19,43542,41369,2173,5
42099,5/1/19,24355,23585,770,3.2
42101,5/1/19,714610,677228,37382,5.2
42103,5/1/19,25064,23794,1270,5.1
42105,5/1/19,7242,6899,343,4.7
42107,5/1/19,66167,62985,3182,4.8
42109,5/1/19,20507,19220,1287,6.3
42111,5/1/19,33343,31922,1421,4.3
42113,5/1/19,2670,2561,109,4.1
42115,5/1/19,20557,19790,767,3.7
42117,5/1/19,19139,18271,868,4.5
42119,5/1/19,20159,19323,836,4.1
42121,5/1/19,22490,21541,949,4.2
42123,5/1/19,18969,18221,748,3.9
42125,5/1/19,106350,102099,4251,4
42127,5/1/19,22071,21187,884,4
42129,5/1/19,179556,172627,6929,3.9
42131,5/1/19,13504,12909,595,4.4
42133,5/1/19,234833,226589,8244,3.5
44001,5/1/19,25770,25061,709,2.8
44003,5/1/19,89848,87243,2605,2.9
44005,5/1/19,43814,42625,1189,2.7
44007,5/1/19,322636,310889,11747,3.6
44009,5/1/19,68246,66345,1901,2.8
45001,5/1/19,10063,9750,313,3.1
45003,5/1/19,75187,73008,2179,2.9
45005,5/1/19,2736,2604,132,4.8
45007,5/1/19,91292,88883,2409,2.6
45009,5/1/19,5059,4800,259,5.1
45011,5/1/19,8310,7975,335,4
45013,5/1/19,78297,76246,2051,2.6
45015,5/1/19,104410,101831,2579,2.5
45017,5/1/19,6600,6386,214,3.2
45019,5/1/19,212703,207919,4784,2.2
45021,5/1/19,25139,24400,739,2.9
45023,5/1/19,13379,12862,517,3.9
45025,5/1/19,22389,21789,600,2.7
45027,5/1/19,12952,12481,471,3.6
45029,5/1/19,16933,16426,507,3
45031,5/1/19,30620,29624,996,3.3
45033,5/1/19,13058,12574,484,3.7
45035,5/1/19,78487,76563,1924,2.5
45037,5/1/19,10825,10529,296,2.7
45039,5/1/19,9587,9195,392,4.1
45041,5/1/19,67211,65322,1889,2.8
45043,5/1/19,26337,25460,877,3.3
45045,5/1/19,255031,248920,6111,2.4
45047,5/1/19,31492,30540,952,3
45049,5/1/19,8569,8350,219,2.6
45051,5/1/19,151028,146195,4833,3.2
45053,5/1/19,12822,12503,319,2.5
45055,5/1/19,29229,28423,806,2.8
45057,5/1/19,41173,39866,1307,3.2
45059,5/1/19,30265,29392,873,2.9
45061,5/1/19,6579,6347,232,3.5
45063,5/1/19,149887,146427,3460,2.3
45065,5/1/19,3403,3311,92,2.7
45067,5/1/19,13165,12665,500,3.8
45069,5/1/19,9143,8763,380,4.2
45071,5/1/19,19445,18957,488,2.5
45073,5/1/19,35142,34195,947,2.7
45075,5/1/19,34808,33376,1432,4.1
45077,5/1/19,57511,55921,1590,2.8
45079,5/1/19,197929,192519,5410,2.7
45081,5/1/19,9063,8832,231,2.5
45083,5/1/19,153077,149286,3791,2.5
45085,5/1/19,43736,42343,1393,3.2
45087,5/1/19,11649,11259,390,3.3
45089,5/1/19,12184,11699,485,4
45091,5/1/19,139825,136106,3719,2.7
46003,5/1/19,1532,1492,40,2.6
46005,5/1/19,9730,9443,287,2.9
46007,5/1/19,1074,1018,56,5.2
46009,5/1/19,2837,2752,85,3
46011,5/1/19,18957,18334,623,3.3
46013,5/1/19,20925,20309,616,2.9
46015,5/1/19,2462,2386,76,3.1
46017,5/1/19,678,641,37,5.5
46019,5/1/19,5019,4855,164,3.3
46021,5/1/19,764,735,29,3.8
46023,5/1/19,3802,3662,140,3.7
46025,5/1/19,1903,1835,68,3.6
46027,5/1/19,7060,6819,241,3.4
46029,5/1/19,15468,14999,469,3
46031,5/1/19,1357,1270,87,6.4
46033,5/1/19,3986,3827,159,4
46035,5/1/19,11112,10805,307,2.8
46037,5/1/19,2785,2681,104,3.7
46039,5/1/19,2185,2094,91,4.2
46041,5/1/19,2135,2018,117,5.5
46043,5/1/19,1579,1539,40,2.5
46045,5/1/19,2041,1982,59,2.9
46047,5/1/19,3056,2935,121,4
46049,5/1/19,1037,1004,33,3.2
46051,5/1/19,4436,4318,118,2.7
46053,5/1/19,2061,1993,68,3.3
46055,5/1/19,1042,1012,30,2.9
46057,5/1/19,3284,3187,97,3
46059,5/1/19,1792,1746,46,2.6
46061,5/1/19,1721,1656,65,3.8
46063,5/1/19,712,692,20,2.8
46065,5/1/19,10137,9885,252,2.5
46067,5/1/19,3566,3465,101,2.8
46069,5/1/19,664,642,22,3.3
46071,5/1/19,1324,1265,59,4.5
46073,5/1/19,1105,1075,30,2.7
46075,5/1/19,550,534,16,2.9
46077,5/1/19,2683,2611,72,2.7
46079,5/1/19,6755,6526,229,3.4
46081,5/1/19,13292,12871,421,3.2
46083,5/1/19,34548,33684,864,2.5
46085,5/1/19,1676,1607,69,4.1
46087,5/1/19,3058,2977,81,2.6
46089,5/1/19,977,941,36,3.7
46091,5/1/19,2411,2329,82,3.4
46093,5/1/19,14153,13669,484,3.4
46095,5/1/19,732,699,33,4.5
46097,5/1/19,1166,1134,32,2.7
46099,5/1/19,112808,109796,3012,2.7
46101,5/1/19,4005,3906,99,2.5
46102,5/1/19,3486,3209,277,7.9
46103,5/1/19,56795,54959,1836,3.2
46105,5/1/19,1436,1391,45,3.1
46107,5/1/19,1042,1010,32,3.1
46109,5/1/19,4769,4587,182,3.8
46111,5/1/19,1136,1099,37,3.3
46115,5/1/19,3198,3094,104,3.3
46117,5/1/19,1852,1803,49,2.6
46119,5/1/19,796,773,23,2.9
46121,5/1/19,3155,2981,174,5.5
46123,5/1/19,3010,2929,81,2.7
46125,5/1/19,4677,4549,128,2.7
46127,5/1/19,8395,8138,257,3.1
46129,5/1/19,2108,2004,104,4.9
46135,5/1/19,12085,11749,336,2.8
46137,5/1/19,909,864,45,5
47001,5/1/19,34922,33779,1143,3.3
47003,5/1/19,21331,20609,722,3.4
47005,5/1/19,7013,6737,276,3.9
47007,5/1/19,4294,4078,216,5
47009,5/1/19,63933,62104,1829,2.9
47011,5/1/19,51293,49638,1655,3.2
47013,5/1/19,14927,14299,628,4.2
47015,5/1/19,6637,6448,189,2.8
47017,5/1/19,12178,11608,570,4.7
47019,5/1/19,24155,23202,953,3.9
47021,5/1/19,22106,21558,548,2.5
47023,5/1/19,8608,8334,274,3.2
47025,5/1/19,13212,12709,503,3.8
47027,5/1/19,2794,2644,150,5.4
47029,5/1/19,15225,14654,571,3.8
47031,5/1/19,25748,24959,789,3.1
47033,5/1/19,6970,6751,219,3.1
47035,5/1/19,23635,22725,910,3.9
47037,5/1/19,408924,399165,9759,2.4
47039,5/1/19,4590,4368,222,4.8
47041,5/1/19,7885,7592,293,3.7
47043,5/1/19,27297,26528,769,2.8
47045,5/1/19,16412,15609,803,4.9
47047,5/1/19,19205,18560,645,3.4
47049,5/1/19,7495,7235,260,3.5
47051,5/1/19,20077,19451,626,3.1
47053,5/1/19,22200,21350,850,3.8
47055,5/1/19,15076,14545,531,3.5
47057,5/1/19,9546,9191,355,3.7
47059,5/1/19,30198,29025,1173,3.9
47061,5/1/19,5008,4831,177,3.5
47063,5/1/19,28444,27437,1007,3.5
47065,5/1/19,184908,179358,5550,3
47067,5/1/19,2136,2025,111,5.2
47069,5/1/19,9463,9064,399,4.2
47071,5/1/19,10485,10092,393,3.7
47073,5/1/19,24034,23138,896,3.7
47075,5/1/19,7674,7326,348,4.5
47077,5/1/19,12412,11944,468,3.8
47079,5/1/19,14316,13779,537,3.8
47081,5/1/19,11520,11197,323,2.8
47083,5/1/19,3258,3126,132,4.1
47085,5/1/19,9063,8751,312,3.4
47087,5/1/19,4687,4502,185,3.9
47089,5/1/19,24867,24009,858,3.5
47091,5/1/19,7721,7474,247,3.2
47093,5/1/19,246242,239507,6735,2.7
47095,5/1/19,1753,1664,89,5.1
47097,5/1/19,9800,9326,474,4.8
47099,5/1/19,19351,18625,726,3.8
47101,5/1/19,5199,5014,185,3.6
47103,5/1/19,16881,16396,485,2.9
47105,5/1/19,23563,22802,761,3.2
47107,5/1/19,23660,22816,844,3.6
47109,5/1/19,8490,8091,399,4.7
47111,5/1/19,11266,10914,352,3.1
47113,5/1/19,49515,47909,1606,3.2
47115,5/1/19,12518,12053,465,3.7
47117,5/1/19,15874,15400,474,3
47119,5/1/19,49749,48456,1293,2.6
47121,5/1/19,5265,5043,222,4.2
47123,5/1/19,20377,19693,684,3.4
47125,5/1/19,85927,82874,3053,3.6
47127,5/1/19,3642,3550,92,2.5
47129,5/1/19,7912,7616,296,3.7
47131,5/1/19,12604,12042,562,4.5
47133,5/1/19,9813,9472,341,3.5
47135,5/1/19,3159,3034,125,4
47137,5/1/19,2394,2295,99,4.1
47139,5/1/19,7388,7117,271,3.7
47141,5/1/19,35083,33931,1152,3.3
47143,5/1/19,13302,12560,742,5.6
47145,5/1/19,23571,22666,905,3.8
47147,5/1/19,38268,37211,1057,2.8
47149,5/1/19,186137,181653,4484,2.4
47151,5/1/19,8475,8162,313,3.7
47153,5/1/19,6201,5976,225,3.6
47155,5/1/19,55529,54079,1450,2.6
47157,5/1/19,449602,432943,16659,3.7
47159,5/1/19,9511,9250,261,2.7
47161,5/1/19,5535,5310,225,4.1
47163,5/1/19,71307,68827,2480,3.5
47165,5/1/19,103449,100891,2558,2.5
47167,5/1/19,28348,27341,1007,3.6
47169,5/1/19,5470,5309,161,2.9
47171,5/1/19,7066,6736,330,4.7
47173,5/1/19,7682,7392,290,3.8
47175,5/1/19,2120,2039,81,3.8
47177,5/1/19,16956,16342,614,3.6
47179,5/1/19,60715,58705,2010,3.3
47181,5/1/19,6330,6079,251,4
47183,5/1/19,16162,15580,582,3.6
47185,5/1/19,12329,11919,410,3.3
47187,5/1/19,129758,126830,2928,2.3
47189,5/1/19,77375,75430,1945,2.5
48001,5/1/19,23658,23062,596,2.5
48003,5/1/19,9918,9733,185,1.9
48005,5/1/19,35464,34203,1261,3.6
48007,5/1/19,9392,9033,359,3.8
48009,5/1/19,4122,4021,101,2.5
48011,5/1/19,935,912,23,2.5
48013,5/1/19,21532,20831,701,3.3
48015,5/1/19,14008,13585,423,3
48017,5/1/19,2579,2489,90,3.5
48019,5/1/19,9979,9693,286,2.9
48021,5/1/19,42481,41399,1082,2.5
48023,5/1/19,1773,1740,33,1.9
48025,5/1/19,9832,9458,374,3.8
48027,5/1/19,142794,137938,4856,3.4
48029,5/1/19,939530,913425,26105,2.8
48031,5/1/19,6420,6279,141,2.2
48033,5/1/19,428,418,10,2.3
48035,5/1/19,8310,8058,252,3
48037,5/1/19,39869,38290,1579,4
48039,5/1/19,177805,171291,6514,3.7
48041,5/1/19,118688,115826,2862,2.4
48043,5/1/19,4264,4158,106,2.5
48045,5/1/19,599,581,18,3
48047,5/1/19,2579,2474,105,4.1
48049,5/1/19,15567,15072,495,3.2
48051,5/1/19,8337,8115,222,2.7
48053,5/1/19,23470,22905,565,2.4
48055,5/1/19,19492,18911,581,3
48057,5/1/19,12303,11957,346,2.8
48059,5/1/19,6062,5898,164,2.7
48061,5/1/19,165540,157496,8044,4.9
48063,5/1/19,4949,4768,181,3.7
48065,5/1/19,3030,2960,70,2.3
48067,5/1/19,12385,11901,484,3.9
48069,5/1/19,3494,3406,88,2.5
48071,5/1/19,19305,18521,784,4.1
48073,5/1/19,20878,20205,673,3.2
48075,5/1/19,2979,2911,68,2.3
48077,5/1/19,4921,4784,137,2.8
48079,5/1/19,1140,1108,32,2.8
48081,5/1/19,1433,1388,45,3.1
48083,5/1/19,2878,2779,99,3.4
48085,5/1/19,557130,541551,15579,2.8
48087,5/1/19,1153,1122,31,2.7
48089,5/1/19,9769,9490,279,2.9
48091,5/1/19,72552,70660,1892,2.6
48093,5/1/19,5557,5402,155,2.8
48095,5/1/19,1194,1154,40,3.4
48097,5/1/19,19839,19366,473,2.4
48099,5/1/19,23947,23105,842,3.5
48101,5/1/19,561,542,19,3.4
48103,5/1/19,1570,1516,54,3.4
48105,5/1/19,1652,1614,38,2.3
48107,5/1/19,2526,2439,87,3.4
48109,5/1/19,1046,1002,44,4.2
48111,5/1/19,3942,3879,63,1.6
48113,5/1/19,1348169,1305837,42332,3.1
48115,5/1/19,4647,4475,172,3.7
48117,5/1/19,8525,8323,202,2.4
48119,5/1/19,2432,2359,73,3
48121,5/1/19,488831,475839,12992,2.7
48123,5/1/19,9693,9469,224,2.3
48125,5/1/19,692,666,26,3.8
48127,5/1/19,7532,7368,164,2.2
48129,5/1/19,1484,1443,41,2.8
48131,5/1/19,4976,4794,182,3.7
48133,5/1/19,8399,8140,259,3.1
48135,5/1/19,87802,85848,1954,2.2
48137,5/1/19,1015,994,21,2.1
48139,5/1/19,91616,89066,2550,2.8
48141,5/1/19,359618,347269,12349,3.4
48143,5/1/19,21119,20553,566,2.7
48145,5/1/19,6552,6358,194,3
48147,5/1/19,17290,16866,424,2.5
48149,5/1/19,12490,12186,304,2.4
48151,5/1/19,1638,1597,41,2.5
48153,5/1/19,2614,2506,108,4.1
48155,5/1/19,576,558,18,3.1
48157,5/1/19,389097,376950,12147,3.1
48159,5/1/19,4678,4528,150,3.2
48161,5/1/19,6344,6077,267,4.2
48163,5/1/19,10545,10305,240,2.3
48165,5/1/19,9910,9705,205,2.1
48167,5/1/19,163966,158141,5825,3.6
48169,5/1/19,2172,2123,49,2.3
48171,5/1/19,13529,13232,297,2.2
48173,5/1/19,804,790,14,1.7
48175,5/1/19,3251,3160,91,2.8
48177,5/1/19,9614,9390,224,2.3
48179,5/1/19,8039,7784,255,3.2
48181,5/1/19,63849,62095,1754,2.7
48183,5/1/19,58114,56193,1921,3.3
48185,5/1/19,11295,10904,391,3.5
48187,5/1/19,80696,78578,2118,2.6
48189,5/1/19,12380,11871,509,4.1
48191,5/1/19,1091,1053,38,3.5
48193,5/1/19,3623,3531,92,2.5
48195,5/1/19,2787,2729,58,2.1
48197,5/1/19,1722,1676,46,2.7
48199,5/1/19,25175,24146,1029,4.1
48201,5/1/19,2297242,2218425,78817,3.4
48203,5/1/19,29206,28149,1057,3.6
48205,5/1/19,2813,2775,38,1.4
48207,5/1/19,2298,2228,70,3
48209,5/1/19,118708,115883,2825,2.4
48211,5/1/19,1958,1899,59,3
48213,5/1/19,36335,35223,1112,3.1
48215,5/1/19,349154,330272,18882,5.4
48217,5/1/19,16315,15845,470,2.9
48219,5/1/19,11314,11006,308,2.7
48221,5/1/19,27284,26477,807,3
48223,5/1/19,17556,17081,475,2.7
48225,5/1/19,10233,9963,270,2.6
48227,5/1/19,13916,13544,372,2.7
48229,5/1/19,1834,1762,72,3.9
48231,5/1/19,42931,41533,1398,3.3
48233,5/1/19,8673,8355,318,3.7
48235,5/1/19,762,745,17,2.2
48237,5/1/19,3493,3403,90,2.6
48239,5/1/19,7533,7333,200,2.7
48241,5/1/19,12782,12104,678,5.3
48243,5/1/19,1066,1042,24,2.3
48245,5/1/19,106124,100688,5436,5.1
48247,5/1/19,1883,1805,78,4.1
48249,5/1/19,16902,16213,689,4.1
48251,5/1/19,81294,79038,2256,2.8
48253,5/1/19,5697,5492,205,3.6
48255,5/1/19,7091,6933,158,2.2
48257,5/1/19,63817,61954,1863,2.9
48259,5/1/19,21963,21434,529,2.4
48261,5/1/19,243,237,6,2.5
48263,5/1/19,494,485,9,1.8
48265,5/1/19,22313,21736,577,2.6
48267,5/1/19,1863,1812,51,2.7
48269,5/1/19,248,243,5,2
48271,5/1/19,1378,1333,45,3.3
48273,5/1/19,13673,13158,515,3.8
48275,5/1/19,1471,1430,41,2.8
48277,5/1/19,23807,23080,727,3.1
48279,5/1/19,5340,5164,176,3.3
48281,5/1/19,9151,8893,258,2.8
48283,5/1/19,4376,4285,91,2.1
48285,5/1/19,8602,8362,240,2.8
48287,5/1/19,10400,10167,233,2.2
48289,5/1/19,6229,5984,245,3.9
48291,5/1/19,32747,31323,1424,4.3
48293,5/1/19,8498,8208,290,3.4
48295,5/1/19,1678,1640,38,2.3
48297,5/1/19,5471,5316,155,2.8
48299,5/1/19,8624,8357,267,3.1
48301,5/1/19,560,556,4,0.7
48303,5/1/19,157583,153767,3816,2.4
48305,5/1/19,2797,2727,70,2.5
48307,5/1/19,3471,3254,217,6.3
48309,5/1/19,118574,115138,3436,2.9
48311,5/1/19,766,757,9,1.2
48313,5/1/19,4546,4377,169,3.7
48315,5/1/19,4206,4055,151,3.6
48317,5/1/19,2881,2825,56,1.9
48319,5/1/19,1783,1732,51,2.9
48321,5/1/19,16711,15897,814,4.9
48323,5/1/19,23940,22264,1676,7
48325,5/1/19,21649,21052,597,2.8
48327,5/1/19,861,835,26,3
48329,5/1/19,106821,104937,1884,1.8
48331,5/1/19,9769,9326,443,4.5
48333,5/1/19,1869,1819,50,2.7
48335,5/1/19,2335,2266,69,3
48337,5/1/19,9371,9134,237,2.5
48339,5/1/19,281724,273191,8533,3
48341,5/1/19,11014,10790,224,2
48343,5/1/19,4787,4565,222,4.6
48345,5/1/19,485,471,14,2.9
48347,5/1/19,28005,27118,887,3.2
48349,5/1/19,23734,23059,675,2.8
48351,5/1/19,5136,4862,274,5.3
48353,5/1/19,6885,6711,174,2.5
48355,5/1/19,166696,160625,6071,3.6
48357,5/1/19,4317,4216,101,2.3
48359,5/1/19,923,900,23,2.5
48361,5/1/19,36131,34488,1643,4.5
48363,5/1/19,13651,13258,393,2.9
48365,5/1/19,10053,9694,359,3.6
48367,5/1/19,66708,64992,1716,2.6
48369,5/1/19,4947,4853,94,1.9
48371,5/1/19,6352,6169,183,2.9
48373,5/1/19,17777,17055,722,4.1
48375,5/1/19,55078,53794,1284,2.3
48377,5/1/19,3061,2883,178,5.8
48379,5/1/19,6034,5875,159,2.6
48381,5/1/19,72095,70567,1528,2.1
48383,5/1/19,1935,1894,41,2.1
48385,5/1/19,1068,1031,37,3.5
48387,5/1/19,5084,4882,202,4
48389,5/1/19,11299,11134,165,1.5
48391,5/1/19,3197,3092,105,3.3
48393,5/1/19,416,403,13,3.1
48395,5/1/19,7652,7407,245,3.2
48397,5/1/19,51486,50039,1447,2.8
48399,5/1/19,4638,4530,108,2.3
48401,5/1/19,22997,22278,719,3.1
48403,5/1/19,3757,3547,210,5.6
48405,5/1/19,3317,3181,136,4.1
48407,5/1/19,11725,11257,468,4
48409,5/1/19,29775,28331,1444,4.8
48411,5/1/19,2506,2434,72,2.9
48413,5/1/19,1326,1291,35,2.6
48415,5/1/19,6801,6606,195,2.9
48417,5/1/19,1905,1865,40,2.1
48419,5/1/19,11172,10798,374,3.3
48421,5/1/19,1378,1350,28,2
48423,5/1/19,106825,103662,3163,3
48425,5/1/19,4314,4183,131,3
48427,5/1/19,25066,23089,1977,7.9
48429,5/1/19,4117,3999,118,2.9
48431,5/1/19,596,579,17,2.9
48433,5/1/19,603,588,15,2.5
48435,5/1/19,1518,1471,47,3.1
48437,5/1/19,2648,2562,86,3.2
48439,5/1/19,1071220,1039833,31387,2.9
48441,5/1/19,66381,64675,1706,2.6
48443,5/1/19,394,384,10,2.5
48445,5/1/19,5088,4916,172,3.4
48447,5/1/19,663,644,19,2.9
48449,5/1/19,12901,12417,484,3.8
48451,5/1/19,54167,52694,1473,2.7
48453,5/1/19,734176,717545,16631,2.3
48455,5/1/19,5298,5088,210,4
48457,5/1/19,7086,6743,343,4.8
48459,5/1/19,17838,17272,566,3.2
48461,5/1/19,1678,1631,47,2.8
48463,5/1/19,11587,11201,386,3.3
48465,5/1/19,22998,22302,696,3
48467,5/1/19,26019,25294,725,2.8
48469,5/1/19,42610,41303,1307,3.1
48471,5/1/19,23894,23053,841,3.5
48473,5/1/19,23295,22540,755,3.2
48475,5/1/19,7477,7331,146,2
48477,5/1/19,14998,14573,425,2.8
48479,5/1/19,118482,114466,4016,3.4
48481,5/1/19,21762,21107,655,3
48483,5/1/19,2280,2222,58,2.5
48485,5/1/19,55852,54273,1579,2.8
48487,5/1/19,4951,4798,153,3.1
48489,5/1/19,6531,6003,528,8.1
48491,5/1/19,311131,303292,7839,2.5
48493,5/1/19,24648,24034,614,2.5
48495,5/1/19,3930,3831,99,2.5
48497,5/1/19,31575,30706,869,2.8
48499,5/1/19,17632,17039,593,3.4
48501,5/1/19,3811,3717,94,2.5
48503,5/1/19,8005,7796,209,2.6
48505,5/1/19,5174,4950,224,4.3
48507,5/1/19,3285,3042,243,7.4
49001,5/1/19,2943,2846,97,3.3
49003,5/1/19,25911,25279,632,2.4
49005,5/1/19,65000,63619,1381,2.1
49007,5/1/19,8646,8323,323,3.7
49009,5/1/19,428,415,13,3
49011,5/1/19,173826,169656,4170,2.4
49013,5/1/19,7789,7488,301,3.9
49015,5/1/19,4522,4368,154,3.4
49017,5/1/19,3080,2953,127,4.1
49019,5/1/19,6578,6431,147,2.2
49021,5/1/19,23823,23108,715,3
49023,5/1/19,5639,5493,146,2.6
49025,5/1/19,3900,3806,94,2.4
49027,5/1/19,6118,5955,163,2.7
49029,5/1/19,5569,5433,136,2.4
49031,5/1/19,495,473,22,4.4
49033,5/1/19,1193,1160,33,2.8
49035,5/1/19,631449,615461,15988,2.5
49037,5/1/19,5959,5714,245,4.1
49039,5/1/19,12595,12216,379,3
49041,5/1/19,9783,9512,271,2.8
49043,5/1/19,23268,22497,771,3.3
49045,5/1/19,33788,32844,944,2.8
49047,5/1/19,13696,13172,524,3.8
49049,5/1/19,303124,295836,7288,2.4
49051,5/1/19,15793,15315,478,3
49053,5/1/19,75961,73839,2122,2.8
49055,5/1/19,1484,1426,58,3.9
49057,5/1/19,127352,123875,3477,2.7
50001,5/1/19,20690,20266,424,2
50003,5/1/19,18110,17613,497,2.7
50005,5/1/19,14529,14181,348,2.4
50007,5/1/19,96087,94418,1669,1.7
50009,5/1/19,2687,2615,72,2.7
50011,5/1/19,27417,26900,517,1.9
50013,5/1/19,3990,3912,78,2
50015,5/1/19,13815,13404,411,3
50017,5/1/19,15947,15629,318,2
50019,5/1/19,13181,12735,446,3.4
50021,5/1/19,30460,29601,859,2.8
50023,5/1/19,34227,33521,706,2.1
50025,5/1/19,22028,21450,578,2.6
50027,5/1/19,28495,27915,580,2
51001,5/1/19,16601,16079,522,3.1
51003,5/1/19,58002,56554,1448,2.5
51005,5/1/19,6918,6708,210,3
51007,5/1/19,6265,6077,188,3
51009,5/1/19,15054,14586,468,3.1
51011,5/1/19,7151,6917,234,3.3
51013,5/1/19,155416,152528,2888,1.9
51015,5/1/19,37583,36678,905,2.4
51017,5/1/19,2481,2425,56,2.3
51019,5/1/19,38544,37484,1060,2.8
51021,5/1/19,2871,2804,67,2.3
51023,5/1/19,17462,17049,413,2.4
51025,5/1/19,6029,5766,263,4.4
51027,5/1/19,6755,6443,312,4.6
51029,5/1/19,6482,6225,257,4
51031,5/1/19,26061,25264,797,3.1
51033,5/1/19,15281,14823,458,3
51035,5/1/19,13438,13031,407,3
51036,5/1/19,3657,3536,121,3.3
51037,5/1/19,5248,5074,174,3.3
51041,5/1/19,188282,183290,4992,2.7
51043,5/1/19,7605,7426,179,2.4
51045,5/1/19,2314,2240,74,3.2
51047,5/1/19,24708,24092,616,2.5
51049,5/1/19,4654,4527,127,2.7
51051,5/1/19,4745,4533,212,4.5
51053,5/1/19,13692,13260,432,3.2
51057,5/1/19,5524,5348,176,3.2
51059,5/1/19,639829,625467,14362,2.2
51061,5/1/19,37340,36441,899,2.4
51063,5/1/19,8206,8010,196,2.4
51065,5/1/19,14112,13792,320,2.3
51067,5/1/19,26472,25719,753,2.8
51069,5/1/19,48140,46999,1141,2.4
51071,5/1/19,7951,7712,239,3
51073,5/1/19,19668,19173,495,2.5
51075,5/1/19,11257,10955,302,2.7
51077,5/1/19,8227,8021,206,2.5
51079,5/1/19,10629,10390,239,2.2
51081,5/1/19,4270,4136,134,3.1
51083,5/1/19,15771,15192,579,3.7
51085,5/1/19,59460,58048,1412,2.4
51087,5/1/19,182735,177878,4857,2.7
51089,5/1/19,23818,23069,749,3.1
51091,5/1/19,1217,1188,29,2.4
51093,5/1/19,19539,18989,550,2.8
51095,5/1/19,36822,35876,946,2.6
51097,5/1/19,3872,3766,106,2.7
51099,5/1/19,13413,13074,339,2.5
51101,5/1/19,9169,8944,225,2.5
51103,5/1/19,5438,5251,187,3.4
51105,5/1/19,8308,8024,284,3.4
51107,5/1/19,223937,218858,5079,2.3
51109,5/1/19,19942,19433,509,2.6
51111,5/1/19,5338,5170,168,3.1
51113,5/1/19,7448,7288,160,2.1
51115,5/1/19,4161,4047,114,2.7
51117,5/1/19,12656,12169,487,3.8
51119,5/1/19,5273,5145,128,2.4
51121,5/1/19,50735,49315,1420,2.8
51125,5/1/19,7533,7322,211,2.8
51127,5/1/19,12530,12232,298,2.4
51131,5/1/19,5390,5174,216,4
51133,5/1/19,5658,5458,200,3.5
51135,5/1/19,7288,7090,198,2.7
51137,5/1/19,17374,16871,503,2.9
51139,5/1/19,12090,11694,396,3.3
51141,5/1/19,7458,7207,251,3.4
51143,5/1/19,30158,29180,978,3.2
51145,5/1/19,14186,13855,331,2.3
51147,5/1/19,10573,10168,405,3.8
51149,5/1/19,15119,14641,478,3.2
51153,5/1/19,247123,241065,6058,2.5
51155,5/1/19,16208,15721,487,3
51157,5/1/19,3702,3615,87,2.4
51159,5/1/19,4091,3986,105,2.6
51161,5/1/19,49649,48434,1215,2.4
51163,5/1/19,10885,10605,280,2.6
51165,5/1/19,41210,40187,1023,2.5
51167,5/1/19,11153,10744,409,3.7
51169,5/1/19,9166,8883,283,3.1
51171,5/1/19,22248,21701,547,2.5
51173,5/1/19,13721,13263,458,3.3
51175,5/1/19,9059,8839,220,2.4
51177,5/1/19,67401,65534,1867,2.8
51179,5/1/19,72476,70538,1938,2.7
51181,5/1/19,3625,3507,118,3.3
51183,5/1/19,3755,3595,160,4.3
51185,5/1/19,15888,15282,606,3.8
51187,5/1/19,20528,19986,542,2.6
51191,5/1/19,26819,26002,817,3
51193,5/1/19,9548,9253,295,3.1
51195,5/1/19,13343,12785,558,4.2
51197,5/1/19,13684,13261,423,3.1
51199,5/1/19,32977,32125,852,2.6
51510,5/1/19,101979,99914,2065,2
51520,5/1/19,7242,6987,255,3.5
51530,5/1/19,3320,3233,87,2.6
51540,5/1/19,26850,26182,668,2.5
51550,5/1/19,123427,119974,3453,2.8
51570,5/1/19,8840,8569,271,3.1
51580,5/1/19,2400,2313,87,3.6
51590,5/1/19,19119,18152,967,5.1
51595,5/1/19,2278,2177,101,4.4
51600,5/1/19,13555,13267,288,2.1
51610,5/1/19,8664,8489,175,2
51620,5/1/19,3589,3456,133,3.7
51630,5/1/19,14239,13777,462,3.2
51640,5/1/19,2963,2875,88,3
51650,5/1/19,64685,62373,2312,3.6
51660,5/1/19,24704,23855,849,3.4
51670,5/1/19,9684,9311,373,3.9
51678,5/1/19,2108,2013,95,4.5
51680,5/1/19,36477,35125,1352,3.7
51683,5/1/19,22180,21662,518,2.3
51685,5/1/19,9440,9216,224,2.4
51690,5/1/19,5465,5251,214,3.9
51700,5/1/19,89270,86350,2920,3.3
51710,5/1/19,112289,108542,3747,3.3
51720,5/1/19,1673,1617,56,3.3
51730,5/1/19,13061,12358,703,5.4
51735,5/1/19,6404,6259,145,2.3
51740,5/1/19,44503,42858,1645,3.7
51750,5/1/19,8759,8444,315,3.6
51760,5/1/19,118823,115059,3764,3.2
51770,5/1/19,49388,47994,1394,2.8
51775,5/1/19,13045,12700,345,2.6
51790,5/1/19,12302,11982,320,2.6
51800,5/1/19,44879,43554,1325,3
51810,5/1/19,234504,228415,6089,2.6
51820,5/1/19,10749,10454,295,2.7
51830,5/1/19,6740,6482,258,3.8
51840,5/1/19,14762,14367,395,2.7
53001,5/1/19,10022,9546,476,4.7
53003,5/1/19,10271,9872,399,3.9
53005,5/1/19,103049,98038,5011,4.9
53007,5/1/19,43412,41294,2118,4.9
53009,5/1/19,28618,26881,1737,6.1
53011,5/1/19,239246,228001,11245,4.7
53013,5/1/19,1849,1754,95,5.1
53015,5/1/19,47572,44682,2890,6.1
53017,5/1/19,21608,20496,1112,5.1
53019,5/1/19,2575,2318,257,10
53021,5/1/19,43872,41440,2432,5.5
53023,5/1/19,905,864,41,4.5
53025,5/1/19,46618,43699,2919,6.3
53027,5/1/19,28923,26947,1976,6.8
53029,5/1/19,35691,33947,1744,4.9
53031,5/1/19,12674,11988,686,5.4
53033,5/1/19,1286119,1251636,34483,2.7
53035,5/1/19,127404,121653,5751,4.5
53037,5/1/19,23650,22499,1151,4.9
53039,5/1/19,10462,9893,569,5.4
53041,5/1/19,34791,32769,2022,5.8
53043,5/1/19,5015,4792,223,4.4
53045,5/1/19,24801,23253,1548,6.2
53047,5/1/19,20034,18782,1252,6.2
53049,5/1/19,8475,7888,587,6.9
53051,5/1/19,4998,4660,338,6.8
53053,5/1/19,437533,415224,22309,5.1
53055,5/1/19,8537,8230,307,3.6
53057,5/1/19,62744,59463,3281,5.2
53059,5/1/19,5482,5200,282,5.1
53061,5/1/19,437788,425237,12551,2.9
53063,5/1/19,253402,240750,12652,5
53065,5/1/19,18903,17714,1189,6.3
53067,5/1/19,141359,134649,6710,4.7
53069,5/1/19,1370,1289,81,5.9
53071,5/1/19,29812,28470,1342,4.5
53073,5/1/19,114936,109533,5403,4.7
53075,5/1/19,23361,22400,961,4.1
53077,5/1/19,130493,121637,8856,6.8
54001,5/1/19,7117,6733,384,5.4
54003,5/1/19,58021,56082,1939,3.3
54005,5/1/19,7407,7024,383,5.2
54007,5/1/19,5222,4891,331,6.3
54009,5/1/19,9977,9502,475,4.8
54011,5/1/19,41469,39831,1638,3.9
54013,5/1/19,2494,2254,240,9.6
54015,5/1/19,3095,2880,215,6.9
54017,5/1/19,4051,3884,167,4.1
54019,5/1/19,16299,15473,826,5.1
54021,5/1/19,2430,2287,143,5.9
54023,5/1/19,5933,5657,276,4.7
54025,5/1/19,16090,15442,648,4
54027,5/1/19,10739,10375,364,3.4
54029,5/1/19,13012,12424,588,4.5
54031,5/1/19,5793,5544,249,4.3
54033,5/1/19,34587,33186,1401,4.1
54035,5/1/19,13666,13075,591,4.3
54037,5/1/19,30806,29938,868,2.8
54039,5/1/19,82037,78516,3521,4.3
54041,5/1/19,6805,6441,364,5.3
54043,5/1/19,7139,6746,393,5.5
54045,5/1/19,11133,10540,593,5.3
54047,5/1/19,4367,3979,388,8.9
54049,5/1/19,25468,24284,1184,4.6
54051,5/1/19,14235,13425,810,5.7
54053,5/1/19,10317,9783,534,5.2
54055,5/1/19,21046,19925,1121,5.3
54057,5/1/19,12663,12098,565,4.5
54059,5/1/19,6924,6499,425,6.1
54061,5/1/19,54482,52600,1882,3.5
54063,5/1/19,6031,5797,234,3.9
54065,5/1/19,8172,7881,291,3.6
54067,5/1/19,9443,8943,500,5.3
54069,5/1/19,21399,20496,903,4.2
54071,5/1/19,3755,3621,134,3.6
54073,5/1/19,2879,2712,167,5.8
54075,5/1/19,3634,3389,245,6.7
54077,5/1/19,15561,14927,634,4.1
54079,5/1/19,26685,25603,1082,4.1
54081,5/1/19,30606,29289,1317,4.3
54083,5/1/19,12406,11723,683,5.5
54085,5/1/19,4373,4179,194,4.4
54087,5/1/19,5063,4657,406,8
54089,5/1/19,4343,4134,209,4.8
54091,5/1/19,7887,7551,336,4.3
54093,5/1/19,3275,3124,151,4.6
54095,5/1/19,3124,2901,223,7.1
54097,5/1/19,9592,9063,529,5.5
54099,5/1/19,15728,14960,768,4.9
54101,5/1/19,3359,3190,169,5
54103,5/1/19,6588,6190,398,6
54105,5/1/19,2278,2131,147,6.5
54107,5/1/19,36722,35008,1714,4.7
54109,5/1/19,6667,6237,430,6.4
55001,5/1/19,8185,7866,319,3.9
55003,5/1/19,7843,7527,316,4
55005,5/1/19,24283,23544,739,3
55007,5/1/19,7470,7135,335,4.5
55009,5/1/19,141495,137231,4264,3
55011,5/1/19,6457,6236,221,3.4
55013,5/1/19,7054,6754,300,4.3
55015,5/1/19,27405,26656,749,2.7
55017,5/1/19,33030,32038,992,3
55019,5/1/19,17646,17142,504,2.9
55021,5/1/19,31036,30138,898,2.9
55023,5/1/19,7482,7224,258,3.4
55025,5/1/19,317217,309205,8012,2.5
55027,5/1/19,47130,45848,1282,2.7
55029,5/1/19,15222,14751,471,3.1
55031,5/1/19,23026,22199,827,3.6
55033,5/1/19,23795,22986,809,3.4
55035,5/1/19,59141,57418,1723,2.9
55037,5/1/19,2182,2107,75,3.4
55039,5/1/19,57109,55549,1560,2.7
55041,5/1/19,3970,3780,190,4.8
55043,5/1/19,28004,27163,841,3
55045,5/1/19,20659,20099,560,2.7
55047,5/1/19,9488,9177,311,3.3
55049,5/1/19,13436,13092,344,2.6
55051,5/1/19,2489,2375,114,4.6
55053,5/1/19,10268,9952,316,3.1
55055,5/1/19,45486,44145,1341,2.9
55057,5/1/19,13547,13161,386,2.8
55059,5/1/19,89079,85859,3220,3.6
55061,5/1/19,10924,10615,309,2.8
55063,5/1/19,66388,64520,1868,2.8
55065,5/1/19,10042,9796,246,2.4
55067,5/1/19,9299,8988,311,3.3
55069,5/1/19,14916,14465,451,3
55071,5/1/19,40749,39534,1215,3
55073,5/1/19,73010,71015,1995,2.7
55075,5/1/19,19413,18736,677,3.5
55077,5/1/19,7668,7429,239,3.1
55078,5/1/19,1606,1502,104,6.5
55079,5/1/19,463479,446389,17090,3.7
55081,5/1/19,23338,22706,632,2.7
55083,5/1/19,20354,19728,626,3.1
55085,5/1/19,17671,17070,601,3.4
55087,5/1/19,102622,99720,2902,2.8
55089,5/1/19,48706,47320,1386,2.8
55091,5/1/19,4137,4024,113,2.7
55093,5/1/19,25171,24405,766,3
55095,5/1/19,24251,23532,719,3
55097,5/1/19,38662,37428,1234,3.2
55099,5/1/19,6373,6148,225,3.5
55101,5/1/19,98154,94638,3516,3.6
55103,5/1/19,9191,8928,263,2.9
55105,5/1/19,84832,81881,2951,3.5
55107,5/1/19,6589,6330,259,3.9
55109,5/1/19,50017,48595,1422,2.8
55111,5/1/19,35232,34303,929,2.6
55113,5/1/19,7947,7658,289,3.6
55115,5/1/19,20937,20336,601,2.9
55117,5/1/19,62176,60546,1630,2.6
55119,5/1/19,10817,10502,315,2.9
55121,5/1/19,15874,15395,479,3
55123,5/1/19,15311,14867,444,2.9
55125,5/1/19,10066,9724,342,3.4
55127,5/1/19,58390,56619,1771,3
55129,5/1/19,7766,7511,255,3.3
55131,5/1/19,76685,74593,2092,2.7
55133,5/1/19,223493,217136,6357,2.8
55135,5/1/19,25789,25031,758,2.9
55137,5/1/19,11308,10923,385,3.4
55139,5/1/19,91139,88493,2646,2.9
55141,5/1/19,34846,33703,1143,3.3
56001,5/1/19,20622,19998,624,3
56003,5/1/19,5241,5035,206,3.9
56005,5/1/19,23085,22347,738,3.2
56007,5/1/19,7775,7544,231,3
56009,5/1/19,8591,8365,226,2.6
56011,5/1/19,3636,3530,106,2.9
56013,5/1/19,18375,17683,692,3.8
56015,5/1/19,6458,6222,236,3.7
56017,5/1/19,2161,2091,70,3.2
56019,5/1/19,4111,3972,139,3.4
56021,5/1/19,48095,46554,1541,3.2
56023,5/1/19,8817,8543,274,3.1
56025,5/1/19,38975,37548,1427,3.7
56027,5/1/19,1205,1173,32,2.7
56029,5/1/19,15678,15141,537,3.4
56031,5/1/19,4681,4539,142,3
56033,5/1/19,15553,15069,484,3.1
56035,5/1/19,3975,3816,159,4
56037,5/1/19,21472,20730,742,3.5
56039,5/1/19,14760,14327,433,2.9
56041,5/1/19,9175,8843,332,3.6
56043,5/1/19,3880,3741,139,3.6
56045,5/1/19,3802,3695,107,2.8
72001,5/1/19,4105,3564,541,13.2
72003,5/1/19,11980,10837,1143,9.5
72005,5/1/19,14575,13200,1375,9.4
72007,5/1/19,6510,5947,563,8.6
72009,5/1/19,6462,5789,673,10.4
72011,5/1/19,8882,8175,707,8
72013,5/1/19,23924,21780,2144,9
72015,5/1/19,4735,4113,622,13.1
72017,5/1/19,5893,5252,641,10.9
72019,5/1/19,7280,6702,578,7.9
72021,5/1/19,65062,61315,3747,5.8
72023,5/1/19,13504,12437,1067,7.9
72025,5/1/19,47586,44605,2981,6.3
72027,5/1/19,9469,8745,724,7.6
72029,5/1/19,15949,15007,942,5.9
72031,5/1/19,61219,57954,3265,5.3
72033,5/1/19,7804,7293,511,6.5
72035,5/1/19,16045,15034,1011,6.3
72037,5/1/19,3737,3350,387,10.4
72039,5/1/19,3681,3299,382,10.4
72041,5/1/19,15422,14460,962,6.2
72043,5/1/19,9975,8815,1160,11.6
72045,5/1/19,4858,4464,394,8.1
72047,5/1/19,8860,8109,751,8.5
72049,5/1/19,905,881,24,2.7
72051,5/1/19,13116,12443,673,5.1
72053,5/1/19,11019,9839,1180,10.7
72054,5/1/19,3318,2958,360,10.8
72055,5/1/19,3901,3387,514,13.2
72057,5/1/19,11174,9904,1270,11.4
72059,5/1/19,5241,4573,668,12.7
72061,5/1/19,37618,36196,1422,3.8
72063,5/1/19,17975,17047,928,5.2
72065,5/1/19,13512,11987,1525,11.3
72067,5/1/19,5412,4964,448,8.3
72069,5/1/19,17177,15481,1696,9.9
72071,5/1/19,12338,11315,1023,8.3
72073,5/1/19,4275,3668,607,14.2
72075,5/1/19,15088,13573,1515,10
72077,5/1/19,12168,11236,932,7.7
72079,5/1/19,5175,4539,636,12.3
72081,5/1/19,6842,5883,959,14
72083,5/1/19,2658,2374,284,10.7
72085,5/1/19,11213,10290,923,8.2
72087,5/1/19,8371,7779,592,7.1
72089,5/1/19,6165,5627,538,8.7
72091,5/1/19,11421,10540,881,7.7
72093,5/1/19,1880,1633,247,13.1
72095,5/1/19,2981,2511,470,15.8
72097,5/1/19,21919,19748,2171,9.9
72099,5/1/19,10514,9486,1028,9.8
72101,5/1/19,7912,7232,680,8.6
72103,5/1/19,8085,7432,653,8.1
72105,5/1/19,6991,6465,526,7.5
72107,5/1/19,4878,4457,421,8.6
72109,5/1/19,4384,3716,668,15.2
72111,5/1/19,5931,5089,842,14.2
72113,5/1/19,45712,41400,4312,9.4
72115,5/1/19,6050,5409,641,10.6
72117,5/1/19,4693,4155,538,11.5
72119,5/1/19,16815,15677,1138,6.8
72121,5/1/19,6077,5309,768,12.6
72123,5/1/19,7155,6159,996,13.9
72125,5/1/19,9725,8680,1045,10.7
72127,5/1/19,134101,127285,6816,5.1
72129,5/1/19,11607,10667,940,8.1
72131,5/1/19,10345,8950,1395,13.5
72133,5/1/19,8881,8002,879,9.9
72135,5/1/19,26964,25574,1390,5.2
72137,5/1/19,29073,27519,1554,5.3
72139,5/1/19,26991,25782,1209,4.5
72141,5/1/19,6631,5948,683,10.3
72143,5/1/19,9620,8920,700,7.3
72145,5/1/19,13143,11963,1180,9
72147,5/1/19,2675,2499,176,6.6
72149,5/1/19,7455,6339,1116,15
72151,5/1/19,8787,7691,1096,12.5
72153,5/1/19,9797,8395,1402,14.3
1001,6/1/19,26310,25536,774,2.9
1003,6/1/19,99811,97012,2799,2.8
1005,6/1/19,8504,8148,356,4.2
1007,6/1/19,8690,8401,289,3.3
1009,6/1/19,25384,24655,729,2.9
1011,6/1/19,4830,4663,167,3.5
1013,6/1/19,9321,8986,335,3.6
1015,6/1/19,46355,44571,1784,3.8
1017,6/1/19,15694,15204,490,3.1
1019,6/1/19,11795,11428,367,3.1
1021,6/1/19,19808,19241,567,2.9
1023,6/1/19,4607,4370,237,5.1
1025,6/1/19,7661,7192,469,6.1
1027,6/1/19,6075,5873,202,3.3
1029,6/1/19,5823,5633,190,3.3
1031,6/1/19,21625,20957,668,3.1
1033,6/1/19,23550,22586,964,4.1
1035,6/1/19,4562,4372,190,4.2
1037,6/1/19,4598,4447,151,3.3
1039,6/1/19,15705,15144,561,3.6
1041,6/1/19,6524,6339,185,2.8
1043,6/1/19,38692,37576,1116,2.9
1045,6/1/19,20783,20081,702,3.4
1047,6/1/19,14541,13655,886,6.1
1049,6/1/19,31358,30402,956,3
1051,6/1/19,37763,36700,1063,2.8
1053,6/1/19,14767,14200,567,3.8
1055,6/1/19,42958,41363,1595,3.7
1057,6/1/19,6626,6392,234,3.5
1059,6/1/19,14746,14306,440,3
1061,6/1/19,11096,10756,340,3.1
1063,6/1/19,2913,2726,187,6.4
1065,6/1/19,6081,5793,288,4.7
1067,6/1/19,6989,6722,267,3.8
1069,6/1/19,46396,44857,1539,3.3
1071,6/1/19,23717,22892,825,3.5
1073,6/1/19,318920,308975,9945,3.1
1075,6/1/19,5886,5667,219,3.7
1077,6/1/19,42522,40930,1592,3.7
1079,6/1/19,14365,13872,493,3.4
1081,6/1/19,75926,73599,2327,3.1
1083,6/1/19,43831,42545,1286,2.9
1085,6/1/19,3592,3386,206,5.7
1087,6/1/19,7848,7458,390,5
1089,6/1/19,185081,179819,5262,2.8
1091,6/1/19,7798,7507,291,3.7
1093,6/1/19,13078,12599,479,3.7
1095,6/1/19,44544,43365,1179,2.6
1097,6/1/19,189001,181447,7554,4
1099,6/1/19,7304,6931,373,5.1
1101,6/1/19,106141,102661,3480,3.3
1103,6/1/19,58390,56736,1654,2.8
1105,6/1/19,3378,3154,224,6.6
1107,6/1/19,7875,7537,338,4.3
1109,6/1/19,15294,14737,557,3.6
1111,6/1/19,9601,9284,317,3.3
1113,6/1/19,23827,23082,745,3.1
1115,6/1/19,40584,39394,1190,2.9
1117,6/1/19,115952,113206,2746,2.4
1119,6/1/19,4900,4634,266,5.4
1121,6/1/19,35803,34481,1322,3.7
1123,6/1/19,19046,18447,599,3.1
1125,6/1/19,103801,100525,3276,3.2
1127,6/1/19,25432,24526,906,3.6
1129,6/1/19,6808,6482,326,4.8
1131,6/1/19,2737,2548,189,6.9
1133,6/1/19,10111,9753,358,3.5
2013,6/1/19,2600,2533,67,2.6
2016,6/1/19,3224,3100,124,3.8
2020,6/1/19,147549,139737,7812,5.3
2050,6/1/19,7468,6429,1039,13.9
2060,6/1/19,708,688,20,2.8
2068,6/1/19,1696,1634,62,3.7
2070,6/1/19,2282,2100,182,8
2090,6/1/19,44424,42004,2420,5.4
2100,6/1/19,1320,1244,76,5.8
2105,6/1/19,1414,1302,112,7.9
2110,6/1/19,17596,16846,750,4.3
2122,6/1/19,27620,25950,1670,6
2130,6/1/19,7558,7132,426,5.6
2150,6/1/19,5904,5602,302,5.1
2158,6/1/19,2572,1936,636,24.7
2164,6/1/19,837,755,82,9.8
2170,6/1/19,47338,43822,3516,7.4
2180,6/1/19,4093,3567,526,12.9
2185,6/1/19,3422,3184,238,7
2188,6/1/19,2931,2435,496,16.9
2195,6/1/19,1425,1307,118,8.3
2198,6/1/19,3114,2823,291,9.3
2220,6/1/19,4689,4507,182,3.9
2230,6/1/19,1096,1062,34,3.1
2240,6/1/19,2920,2659,261,8.9
2261,6/1/19,5495,5156,339,6.2
2275,6/1/19,1068,989,79,7.4
2282,6/1/19,256,242,14,5.5
2290,6/1/19,2569,2186,383,14.9
4001,6/1/19,20716,18542,2174,10.5
4003,6/1/19,50239,47200,3039,6
4005,6/1/19,78032,73438,4594,5.9
4007,6/1/19,22116,20885,1231,5.6
4009,6/1/19,15091,14290,801,5.3
4011,6/1/19,4572,4375,197,4.3
4012,6/1/19,8808,8255,553,6.3
4013,6/1/19,2305444,2205818,99626,4.3
4015,6/1/19,88783,83550,5233,5.9
4017,6/1/19,41765,38591,3174,7.6
4019,6/1/19,497736,474059,23677,4.8
4021,6/1/19,184761,175087,9674,5.2
4023,6/1/19,19900,18358,1542,7.7
4025,6/1/19,108141,103044,5097,4.7
4027,6/1/19,96187,78050,18137,18.9
5001,6/1/19,9531,9238,293,3.1
5003,6/1/19,7989,7533,456,5.7
5005,6/1/19,16670,15979,691,4.1
5007,6/1/19,137247,133457,3790,2.8
5009,6/1/19,16381,15854,527,3.2
5011,6/1/19,4603,4402,201,4.4
5013,6/1/19,2504,2388,116,4.6
5015,6/1/19,13079,12701,378,2.9
5017,6/1/19,3352,3116,236,7
5019,6/1/19,9479,9074,405,4.3
5021,6/1/19,5787,5492,295,5.1
5023,6/1/19,9590,9175,415,4.3
5025,6/1/19,3227,3099,128,4
5027,6/1/19,9186,8715,471,5.1
5029,6/1/19,8467,8062,405,4.8
5031,6/1/19,55875,54127,1748,3.1
5033,6/1/19,27291,26319,972,3.6
5035,6/1/19,21634,20560,1074,5
5037,6/1/19,7622,7298,324,4.3
5039,6/1/19,2902,2751,151,5.2
5041,6/1/19,5483,5210,273,5
5043,6/1/19,7857,7423,434,5.5
5045,6/1/19,63109,61150,1959,3.1
5047,6/1/19,7604,7315,289,3.8
5049,6/1/19,5181,4968,213,4.1
5051,6/1/19,41985,40295,1690,4
5053,6/1/19,8494,8201,293,3.4
5055,6/1/19,20257,19468,789,3.9
5057,6/1/19,10074,9663,411,4.1
5059,6/1/19,14244,13673,571,4
5061,6/1/19,5758,5550,208,3.6
5063,6/1/19,16714,15981,733,4.4
5065,6/1/19,4927,4628,299,6.1
5067,6/1/19,5907,5489,418,7.1
5069,6/1/19,27984,26287,1697,6.1
5071,6/1/19,10478,9874,604,5.8
5073,6/1/19,2502,2380,122,4.9
5075,6/1/19,6748,6437,311,4.6
5077,6/1/19,2832,2704,128,4.5
5079,6/1/19,3979,3785,194,4.9
5081,6/1/19,5625,5380,245,4.4
5083,6/1/19,8737,8345,392,4.5
5085,6/1/19,34743,33649,1094,3.1
5087,6/1/19,7413,7219,194,2.6
5089,6/1/19,6870,6593,277,4
5091,6/1/19,20214,19318,896,4.4
5093,6/1/19,17797,16467,1330,7.5
5095,6/1/19,2799,2663,136,4.9
5097,6/1/19,3109,2977,132,4.2
5099,6/1/19,3732,3555,177,4.7
5101,6/1/19,3402,3283,119,3.5
5103,6/1/19,10055,9537,518,5.2
5105,6/1/19,4332,4141,191,4.4
5107,6/1/19,6481,6089,392,6
5109,6/1/19,4418,4248,170,3.8
5111,6/1/19,10310,9920,390,3.8
5113,6/1/19,8183,7831,352,4.3
5115,6/1/19,28918,27454,1464,5.1
5117,6/1/19,3610,3452,158,4.4
5119,6/1/19,192483,185580,6903,3.6
5121,6/1/19,7399,7069,330,4.5
5123,6/1/19,8355,7884,471,5.6
5125,6/1/19,59756,58020,1736,2.9
5127,6/1/19,4389,4241,148,3.4
5129,6/1/19,3159,3024,135,4.3
5131,6/1/19,57505,55484,2021,3.5
5133,6/1/19,5522,5251,271,4.9
5135,6/1/19,5877,5556,321,5.5
5137,6/1/19,4863,4628,235,4.8
5139,6/1/19,16095,15186,909,5.6
5141,6/1/19,5907,5624,283,4.8
5143,6/1/19,125099,121812,3287,2.6
5145,6/1/19,33955,32402,1553,4.6
5147,6/1/19,2801,2648,153,5.5
5149,6/1/19,8386,8021,365,4.4
6001,6/1/19,840754,814723,26031,3.1
6003,6/1/19,483,449,34,7
6005,6/1/19,14982,14422,560,3.7
6007,6/1/19,97541,92299,5242,5.4
6009,6/1/19,21403,20596,807,3.8
6011,6/1/19,11020,9841,1179,10.7
6013,6/1/19,558996,540960,18036,3.2
6015,6/1/19,9734,9210,524,5.4
6017,6/1/19,91488,88194,3294,3.6
6019,6/1/19,451786,420043,31743,7
6021,6/1/19,12841,12038,803,6.3
6023,6/1/19,62345,60059,2286,3.7
6025,6/1/19,71901,58759,13142,18.3
6027,6/1/19,8808,8501,307,3.5
6029,6/1/19,390954,359852,31102,8
6031,6/1/19,57229,52687,4542,7.9
6033,6/1/19,29417,27993,1424,4.8
6035,6/1/19,9633,9188,445,4.6
6037,6/1/19,5079145,4851414,227731,4.5
6039,6/1/19,62281,58016,4265,6.8
6041,6/1/19,139248,135896,3352,2.4
6043,6/1/19,7834,7518,316,4
6045,6/1/19,39064,37597,1467,3.8
6047,6/1/19,115242,105906,9336,8.1
6049,6/1/19,3357,3167,190,5.7
6051,6/1/19,8240,7912,328,4
6053,6/1/19,231689,220670,11019,4.8
6055,6/1/19,75059,72992,2067,2.8
6057,6/1/19,48284,46665,1619,3.4
6059,6/1/19,1613664,1566398,47266,2.9
6061,6/1/19,187021,180999,6022,3.2
6063,6/1/19,8309,7803,506,6.1
6065,6/1/19,1095978,1048189,47789,4.4
6067,6/1/19,709868,682632,27236,3.8
6069,6/1/19,31305,29797,1508,4.8
6071,6/1/19,959870,920468,39402,4.1
6073,6/1/19,1582682,1529812,52870,3.3
6075,6/1/19,578941,565408,13533,2.3
6077,6/1/19,327178,308158,19020,5.8
6079,6/1/19,142111,137872,4239,3
6081,6/1/19,456418,446509,9909,2.2
6083,6/1/19,221045,213517,7528,3.4
6085,6/1/19,1049760,1022128,27632,2.6
6087,6/1/19,144904,138792,6112,4.2
6089,6/1/19,74445,71043,3402,4.6
6091,6/1/19,1358,1292,66,4.9
6093,6/1/19,17507,16503,1004,5.7
6095,6/1/19,209064,201001,8063,3.9
6097,6/1/19,256989,249774,7215,2.8
6099,6/1/19,242761,227352,15409,6.3
6101,6/1/19,46161,42926,3235,7
6103,6/1/19,25681,24242,1439,5.6
6105,6/1/19,4967,4729,238,4.8
6107,6/1/19,205888,187049,18839,9.2
6109,6/1/19,21324,20385,939,4.4
6111,6/1/19,421387,406224,15163,3.6
6113,6/1/19,108473,104174,4299,4
6115,6/1/19,29717,27954,1763,5.9
8001,6/1/19,277181,268734,8447,3
8003,6/1/19,8751,8444,307,3.5
8005,6/1/19,371533,360803,10730,2.9
8007,6/1/19,7202,6959,243,3.4
8009,6/1/19,2165,2125,40,1.8
8011,6/1/19,1899,1841,58,3.1
8013,6/1/19,195857,190697,5160,2.6
8014,6/1/19,40826,39735,1091,2.7
8015,6/1/19,10581,10327,254,2.4
8017,6/1/19,1164,1142,22,1.9
8019,6/1/19,6174,5999,175,2.8
8021,6/1/19,4160,4007,153,3.7
8023,6/1/19,1904,1831,73,3.8
8025,6/1/19,1514,1447,67,4.4
8027,6/1/19,2129,2055,74,3.5
8029,6/1/19,14566,14068,498,3.4
8031,6/1/19,424447,412478,11969,2.8
8033,6/1/19,1167,1133,34,2.9
8035,6/1/19,197806,192707,5099,2.6
8037,6/1/19,36254,35368,886,2.4
8039,6/1/19,15430,15058,372,2.4
8041,6/1/19,344798,332737,12061,3.5
8043,6/1/19,15753,15038,715,4.5
8045,6/1/19,32983,32098,885,2.7
8047,6/1/19,3861,3759,102,2.6
8049,6/1/19,10033,9790,243,2.4
8051,6/1/19,11622,11361,261,2.2
8053,6/1/19,509,497,12,2.4
8055,6/1/19,2586,2446,140,5.4
8057,6/1/19,1022,995,27,2.6
8059,6/1/19,341468,332232,9236,2.7
8061,6/1/19,941,923,18,1.9
8063,6/1/19,4383,4301,82,1.9
8065,6/1/19,4860,4729,131,2.7
8067,6/1/19,32708,31870,838,2.6
8069,6/1/19,207215,201970,5245,2.5
8071,6/1/19,6581,6314,267,4.1
8073,6/1/19,2447,2389,58,2.4
8075,6/1/19,11124,10830,294,2.6
8077,6/1/19,76133,73374,2759,3.6
8079,6/1/19,599,583,16,2.7
8081,6/1/19,7520,7279,241,3.2
8083,6/1/19,13235,12763,472,3.6
8085,6/1/19,22127,21452,675,3.1
8087,6/1/19,16453,15976,477,2.9
8089,6/1/19,8426,8076,350,4.2
8091,6/1/19,2687,2616,71,2.6
8093,6/1/19,11397,11104,293,2.6
8095,6/1/19,2667,2615,52,1.9
8097,6/1/19,11469,11099,370,3.2
8099,6/1/19,6316,6119,197,3.1
8101,6/1/19,76305,73050,3255,4.3
8103,6/1/19,3014,2900,114,3.8
8105,6/1/19,5582,5359,223,4
8107,6/1/19,16272,15865,407,2.5
8109,6/1/19,3607,3445,162,4.5
8111,6/1/19,666,649,17,2.6
8113,6/1/19,5716,5560,156,2.7
8115,6/1/19,1236,1204,32,2.6
8117,6/1/19,21768,21295,473,2.2
8119,6/1/19,12938,12509,429,3.3
8121,6/1/19,3019,2948,71,2.4
8123,6/1/19,168997,164284,4713,2.8
8125,6/1/19,6554,6442,112,1.7
9001,6/1/19,487316,468879,18437,3.8
9003,6/1/19,483358,464258,19100,4
9005,6/1/19,106325,102699,3626,3.4
9007,6/1/19,93801,90715,3086,3.3
9009,6/1/19,463719,444742,18977,4.1
9011,6/1/19,139268,134073,5195,3.7
9013,6/1/19,87146,84165,2981,3.4
9015,6/1/19,64690,61907,2783,4.3
10001,6/1/19,79134,75389,3745,4.7
10003,6/1/19,298263,286113,12150,4.1
10005,6/1/19,113355,109350,4005,3.5
11001,6/1/19,412636,388574,24062,5.8
12001,6/1/19,136507,131999,4508,3.3
12003,6/1/19,11877,11468,409,3.4
12005,6/1/19,86456,83140,3316,3.8
12007,6/1/19,10848,10477,371,3.4
12009,6/1/19,285268,275572,9696,3.4
12011,6/1/19,1042537,1008746,33791,3.2
12013,6/1/19,4930,4728,202,4.1
12015,6/1/19,71458,68683,2775,3.9
12017,6/1/19,47675,45230,2445,5.1
12019,6/1/19,107826,104315,3511,3.3
12021,6/1/19,175950,170083,5867,3.3
12023,6/1/19,29772,28714,1058,3.6
12027,6/1/19,13948,13422,526,3.8
12029,6/1/19,5604,5362,242,4.3
12031,6/1/19,493308,475547,17761,3.6
12033,6/1/19,146497,141441,5056,3.5
12035,6/1/19,47115,45178,1937,4.1
12037,6/1/19,4909,4743,166,3.4
12039,6/1/19,18894,18075,819,4.3
12041,6/1/19,7027,6756,271,3.9
12043,6/1/19,4962,4730,232,4.7
12045,6/1/19,5925,5640,285,4.8
12047,6/1/19,4654,4467,187,4
12049,6/1/19,7983,7524,459,5.7
12051,6/1/19,14454,13494,960,6.6
12053,6/1/19,72111,68838,3273,4.5
12055,6/1/19,36110,34342,1768,4.9
12057,6/1/19,749157,724334,24823,3.3
12059,6/1/19,6984,6721,263,3.8
12061,6/1/19,65296,62589,2707,4.1
12063,6/1/19,16961,16279,682,4
12065,6/1/19,5527,5328,199,3.6
12067,6/1/19,2764,2670,94,3.4
12069,6/1/19,159415,153889,5526,3.5
12071,6/1/19,344466,332575,11891,3.5
12073,6/1/19,153149,147885,5264,3.4
12075,6/1/19,16512,15828,684,4.1
12077,6/1/19,2652,2548,104,3.9
12079,6/1/19,7482,7181,301,4
12081,6/1/19,179539,173507,6032,3.4
12083,6/1/19,137956,132220,5736,4.2
12085,6/1/19,74044,71503,2541,3.4
12086,6/1/19,1369579,1335085,34494,2.5
12087,6/1/19,46480,45460,1020,2.2
12089,6/1/19,41273,39970,1303,3.2
12091,6/1/19,100089,97273,2816,2.8
12093,6/1/19,17141,16480,661,3.9
12095,6/1/19,764141,740245,23896,3.1
12097,6/1/19,184769,178276,6493,3.5
12099,6/1/19,732206,706550,25656,3.5
12101,6/1/19,238424,229470,8954,3.8
12103,6/1/19,494700,479006,15694,3.2
12105,6/1/19,305166,292952,12214,4
12107,6/1/19,26286,25049,1237,4.7
12109,6/1/19,132876,129083,3793,2.9
12111,6/1/19,144998,138820,6178,4.3
12113,6/1/19,83264,80562,2702,3.2
12115,6/1/19,189165,182798,6367,3.4
12117,6/1/19,256100,248055,8045,3.1
12119,6/1/19,32753,31116,1637,5
12121,6/1/19,18334,17688,646,3.5
12123,6/1/19,8409,8086,323,3.8
12125,6/1/19,4587,4436,151,3.3
12127,6/1/19,254596,245147,9449,3.7
12129,6/1/19,14682,14217,465,3.2
12131,6/1/19,32577,31623,954,2.9
12133,6/1/19,9735,9387,348,3.6
13001,6/1/19,8926,8507,419,4.7
13003,6/1/19,4548,4415,133,2.9
13005,6/1/19,4971,4776,195,3.9
13007,6/1/19,1107,1050,57,5.1
13009,6/1/19,17355,16534,821,4.7
13011,6/1/19,9484,9185,299,3.2
13013,6/1/19,40336,39071,1265,3.1
13015,6/1/19,50366,48621,1745,3.5
13017,6/1/19,5235,4939,296,5.7
13019,6/1/19,7336,7049,287,3.9
13021,6/1/19,67942,64974,2968,4.4
13023,6/1/19,4570,4293,277,6.1
13025,6/1/19,7239,6927,312,4.3
13027,6/1/19,6711,6458,253,3.8
13029,6/1/19,18352,17751,601,3.3
13031,6/1/19,35985,34367,1618,4.5
13033,6/1/19,9100,8605,495,5.4
13035,6/1/19,10723,10321,402,3.7
13037,6/1/19,2087,2005,82,3.9
13039,6/1/19,21040,20210,830,3.9
13043,6/1/19,5467,5298,169,3.1
13045,6/1/19,55161,53001,2160,3.9
13047,6/1/19,33496,32407,1089,3.3
13049,6/1/19,4747,4545,202,4.3
13051,6/1/19,140415,135352,5063,3.6
13053,6/1/19,1975,1888,87,4.4
13055,6/1/19,10147,9744,403,4
13057,6/1/19,135665,131531,4134,3
13059,6/1/19,58389,55941,2448,4.2
13061,6/1/19,860,797,63,7.3
13063,6/1/19,137980,131466,6514,4.7
13065,6/1/19,2711,2587,124,4.6
13067,6/1/19,424718,410884,13834,3.3
13069,6/1/19,18610,17872,738,4
13071,6/1/19,21018,20290,728,3.5
13073,6/1/19,75153,72629,2524,3.4
13075,6/1/19,7854,7567,287,3.7
13077,6/1/19,74601,72087,2514,3.4
13079,6/1/19,5567,5347,220,4
13081,6/1/19,9488,9099,389,4.1
13083,6/1/19,8172,7872,300,3.7
13085,6/1/19,12260,11874,386,3.1
13087,6/1/19,11307,10824,483,4.3
13089,6/1/19,399254,384310,14944,3.7
13091,6/1/19,7156,6709,447,6.2
13093,6/1/19,4941,4723,218,4.4
13095,6/1/19,38298,36239,2059,5.4
13097,6/1/19,73255,70372,2883,3.9
13099,6/1/19,4284,4099,185,4.3
13101,6/1/19,1841,1778,63,3.4
13103,6/1/19,31057,30065,992,3.2
13105,6/1/19,7589,7276,313,4.1
13107,6/1/19,8134,7685,449,5.5
13109,6/1/19,4749,4561,188,4
13111,6/1/19,11570,11162,408,3.5
13113,6/1/19,57999,56045,1954,3.4
13115,6/1/19,43887,42135,1752,4
13117,6/1/19,121956,118178,3778,3.1
13119,6/1/19,9815,9429,386,3.9
13121,6/1/19,556898,535369,21529,3.9
13123,6/1/19,11785,11326,459,3.9
13125,6/1/19,1249,1199,50,4
13127,6/1/19,39788,38384,1404,3.5
13129,6/1/19,28205,27215,990,3.5
13131,6/1/19,10229,9837,392,3.8
13133,6/1/19,7128,6848,280,3.9
13135,6/1/19,489340,472790,16550,3.4
13137,6/1/19,18992,18293,699,3.7
13139,6/1/19,101625,98426,3199,3.1
13141,6/1/19,2377,2246,131,5.5
13143,6/1/19,12534,12077,457,3.6
13145,6/1/19,16595,16034,561,3.4
13147,6/1/19,11353,10934,419,3.7
13149,6/1/19,5233,5033,200,3.8
13151,6/1/19,115657,111061,4596,4
13153,6/1/19,70665,68092,2573,3.6
13155,6/1/19,3079,2922,157,5.1
13157,6/1/19,36186,35124,1062,2.9
13159,6/1/19,6894,6662,232,3.4
13161,6/1/19,6068,5751,317,5.2
13163,6/1/19,6501,6149,352,5.4
13165,6/1/19,3120,2954,166,5.3
13167,6/1/19,4044,3882,162,4
13169,6/1/19,13636,13157,479,3.5
13171,6/1/19,8230,7872,358,4.3
13173,6/1/19,3715,3558,157,4.2
13175,6/1/19,19282,18340,942,4.9
13177,6/1/19,14644,14150,494,3.4
13179,6/1/19,25867,24768,1099,4.2
13181,6/1/19,3506,3365,141,4
13183,6/1/19,8012,7662,350,4.4
13185,6/1/19,51042,49034,2008,3.9
13187,6/1/19,16739,16132,607,3.6
13189,6/1/19,8845,8375,470,5.3
13191,6/1/19,6165,5932,233,3.8
13193,6/1/19,4645,4406,239,5.1
13195,6/1/19,13049,12614,435,3.3
13197,6/1/19,3293,3136,157,4.8
13199,6/1/19,8868,8430,438,4.9
13201,6/1/19,2695,2592,103,3.8
13205,6/1/19,8171,7763,408,5
13207,6/1/19,12923,12464,459,3.6
13209,6/1/19,3780,3551,229,6.1
13211,6/1/19,9133,8826,307,3.4
13213,6/1/19,15437,14645,792,5.1
13215,6/1/19,77679,73779,3900,5
13217,6/1/19,52184,49936,2248,4.3
13219,6/1/19,19194,18628,566,2.9
13221,6/1/19,6777,6531,246,3.6
13223,6/1/19,85834,83042,2792,3.3
13225,6/1/19,11817,11256,561,4.7
13227,6/1/19,15244,14756,488,3.2
13229,6/1/19,8627,8302,325,3.8
13231,6/1/19,8867,8567,300,3.4
13233,6/1/19,18415,17697,718,3.9
13235,6/1/19,4034,3858,176,4.4
13237,6/1/19,8130,7762,368,4.5
13239,6/1/19,798,756,42,5.3
13241,6/1/19,7253,6981,272,3.8
13243,6/1/19,2453,2322,131,5.3
13245,6/1/19,85343,81115,4228,5
13247,6/1/19,44765,42888,1877,4.2
13249,6/1/19,2191,2098,93,4.2
13251,6/1/19,5004,4721,283,5.7
13253,6/1/19,3009,2859,150,5
13255,6/1/19,28619,27390,1229,4.3
13257,6/1/19,10642,10195,447,4.2
13259,6/1/19,2340,2226,114,4.9
13261,6/1/19,12608,11961,647,5.1
13263,6/1/19,2833,2682,151,5.3
13265,6/1/19,571,545,26,4.6
13267,6/1/19,9397,8997,400,4.3
13269,6/1/19,3126,3001,125,4
13271,6/1/19,4177,3666,511,12.2
13273,6/1/19,3485,3293,192,5.5
13275,6/1/19,16197,15488,709,4.4
13277,6/1/19,19516,18811,705,3.6
13279,6/1/19,11505,10902,603,5.2
13281,6/1/19,3945,3734,211,5.3
13283,6/1/19,2607,2458,149,5.7
13285,6/1/19,37491,36192,1299,3.5
13287,6/1/19,3116,2991,125,4
13289,6/1/19,2874,2708,166,5.8
13291,6/1/19,10215,9868,347,3.4
13293,6/1/19,11261,10828,433,3.8
13295,6/1/19,31198,30090,1108,3.6
13297,6/1/19,45963,44400,1563,3.4
13299,6/1/19,15428,14835,593,3.8
13301,6/1/19,2798,2667,131,4.7
13303,6/1/19,6985,6672,313,4.5
13305,6/1/19,11478,10973,505,4.4
13307,6/1/19,978,927,51,5.2
13309,6/1/19,1573,1436,137,8.7
13311,6/1/19,16286,15824,462,2.8
13313,6/1/19,43389,41528,1861,4.3
13315,6/1/19,2676,2533,143,5.3
13317,6/1/19,3845,3667,178,4.6
13319,6/1/19,3940,3764,176,4.5
13321,6/1/19,8768,8418,350,4
15001,6/1/19,91356,87520,3836,4.2
15003,6/1/19,450087,435685,14402,3.2
15007,6/1/19,36943,35813,1130,3.1
15009,6/1/19,87202,84492,2710,3.1
16001,6/1/19,255346,249113,6233,2.4
16003,6/1/19,1782,1681,101,5.7
16005,6/1/19,42500,41377,1123,2.6
16007,6/1/19,3084,3008,76,2.5
16009,6/1/19,4140,3991,149,3.6
16011,6/1/19,24082,23514,568,2.4
16013,6/1/19,12565,12278,287,2.3
16015,6/1/19,3515,3380,135,3.8
16017,6/1/19,20390,19694,696,3.4
16019,6/1/19,57821,56562,1259,2.2
16021,6/1/19,5562,5373,189,3.4
16023,6/1/19,1415,1383,32,2.3
16025,6/1/19,704,689,15,2.1
16027,6/1/19,105204,101873,3331,3.2
16029,6/1/19,4220,4132,88,2.1
16031,6/1/19,12403,12106,297,2.4
16033,6/1/19,389,377,12,3.1
16035,6/1/19,2935,2771,164,5.6
16037,6/1/19,2497,2424,73,2.9
16039,6/1/19,11847,11460,387,3.3
16041,6/1/19,7036,6881,155,2.2
16043,6/1/19,8108,7952,156,1.9
16045,6/1/19,8343,8107,236,2.8
16047,6/1/19,8313,8110,203,2.4
16049,6/1/19,6811,6547,264,3.9
16051,6/1/19,14240,13946,294,2.1
16053,6/1/19,12347,12060,287,2.3
16055,6/1/19,81852,79473,2379,2.9
16057,6/1/19,19399,18873,526,2.7
16059,6/1/19,3722,3592,130,3.5
16061,6/1/19,1719,1643,76,4.4
16063,6/1/19,2736,2660,76,2.8
16065,6/1/19,22812,22391,421,1.8
16067,6/1/19,11580,11301,279,2.4
16069,6/1/19,21107,20587,520,2.5
16071,6/1/19,2392,2342,50,2.1
16073,6/1/19,5680,5509,171,3
16075,6/1/19,11811,11419,392,3.3
16077,6/1/19,4092,3981,111,2.7
16079,6/1/19,5204,4950,254,4.9
16081,6/1/19,7204,7081,123,1.7
16083,6/1/19,41624,40503,1121,2.7
16085,6/1/19,5922,5767,155,2.6
16087,6/1/19,4672,4492,180,3.9
17001,6/1/19,32700,31656,1044,3.2
17003,6/1/19,2074,1933,141,6.8
17005,6/1/19,7900,7615,285,3.6
17007,6/1/19,26593,25167,1426,5.4
17009,6/1/19,2988,2919,69,2.3
17011,6/1/19,17704,17021,683,3.9
17013,6/1/19,2380,2247,133,5.6
17015,6/1/19,7520,7257,263,3.5
17017,6/1/19,6253,6010,243,3.9
17019,6/1/19,105029,100912,4117,3.9
17021,6/1/19,14882,14193,689,4.6
17023,6/1/19,7703,7388,315,4.1
17025,6/1/19,6646,6353,293,4.4
17027,6/1/19,20665,20072,593,2.9
17029,6/1/19,22991,21987,1004,4.4
17031,6/1/19,2636171,2524474,111697,4.2
17033,6/1/19,8776,8422,354,4
17035,6/1/19,6055,5867,188,3.1
17037,6/1/19,55910,53696,2214,4
17039,6/1/19,7401,7110,291,3.9
17041,6/1/19,10329,9946,383,3.7
17043,6/1/19,515730,498538,17192,3.3
17045,6/1/19,9015,8649,366,4.1
17047,6/1/19,2799,2698,101,3.6
17049,6/1/19,19491,18892,599,3.1
17051,6/1/19,10090,9702,388,3.8
17053,6/1/19,6322,6070,252,4
17055,6/1/19,16365,15536,829,5.1
17057,6/1/19,15351,14570,781,5.1
17059,6/1/19,2385,2275,110,4.6
17061,6/1/19,6124,5867,257,4.2
17063,6/1/19,25864,24615,1249,4.8
17065,6/1/19,4505,4347,158,3.5
17067,6/1/19,8654,8272,382,4.4
17069,6/1/19,1309,1218,91,7
17071,6/1/19,3745,3593,152,4.1
17073,6/1/19,25409,24342,1067,4.2
17075,6/1/19,14963,14446,517,3.5
17077,6/1/19,27347,26294,1053,3.9
17079,6/1/19,4759,4569,190,4
17081,6/1/19,17479,16675,804,4.6
17083,6/1/19,11113,10617,496,4.5
17085,6/1/19,11215,10891,324,2.9
17087,6/1/19,4081,3849,232,5.7
17089,6/1/19,275648,264683,10965,4
17091,6/1/19,56391,53910,2481,4.4
17093,6/1/19,69833,67165,2668,3.8
17095,6/1/19,22109,21110,999,4.5
17097,6/1/19,383562,369802,13760,3.6
17099,6/1/19,55328,52706,2622,4.7
17101,6/1/19,5964,5665,299,5
17103,6/1/19,17657,16962,695,3.9
17105,6/1/19,16785,16135,650,3.9
17107,6/1/19,12642,12092,550,4.4
17109,6/1/19,12515,11883,632,5
17111,6/1/19,168037,162000,6037,3.6
17113,6/1/19,87302,83966,3336,3.8
17115,6/1/19,49456,46891,2565,5.2
17117,6/1/19,23251,22312,939,4
17119,6/1/19,135737,130250,5487,4
17121,6/1/19,17786,17029,757,4.3
17123,6/1/19,5420,5195,225,4.2
17125,6/1/19,6398,6073,325,5.1
17127,6/1/19,5692,5360,332,5.8
17129,6/1/19,6608,6399,209,3.2
17131,6/1/19,8209,7887,322,3.9
17133,6/1/19,18984,18406,578,3
17135,6/1/19,12060,11517,543,4.5
17137,6/1/19,16824,16197,627,3.7
17139,6/1/19,7770,7502,268,3.4
17141,6/1/19,25677,24577,1100,4.3
17143,6/1/19,86056,81952,4104,4.8
17145,6/1/19,8331,7919,412,4.9
17147,6/1/19,8352,8061,291,3.5
17149,6/1/19,7295,7021,274,3.8
17151,6/1/19,1705,1611,94,5.5
17153,6/1/19,1977,1858,119,6
17155,6/1/19,3091,2954,137,4.4
17157,6/1/19,14316,13810,506,3.5
17159,6/1/19,7304,7015,289,4
17161,6/1/19,72226,69015,3211,4.4
17163,6/1/19,127859,122148,5711,4.5
17165,6/1/19,9567,9067,500,5.2
17167,6/1/19,102846,98876,3970,3.9
17169,6/1/19,3438,3321,117,3.4
17171,6/1/19,2537,2434,103,4.1
17173,6/1/19,10817,10413,404,3.7
17175,6/1/19,2590,2462,128,4.9
17177,6/1/19,22379,21495,884,4
17179,6/1/19,64722,62085,2637,4.1
17181,6/1/19,7420,7043,377,5.1
17183,6/1/19,33223,31639,1584,4.8
17185,6/1/19,5871,5640,231,3.9
17187,6/1/19,8663,8315,348,4
17189,6/1/19,10448,10194,254,2.4
17191,6/1/19,7113,6796,317,4.5
17193,6/1/19,6685,6458,227,3.4
17195,6/1/19,29411,28245,1166,4
17197,6/1/19,363149,347660,15489,4.3
17199,6/1/19,31232,29907,1325,4.2
17201,6/1/19,141305,133567,7738,5.5
17203,6/1/19,19044,18407,637,3.3
18001,6/1/19,17514,17035,479,2.7
18003,6/1/19,189241,183273,5968,3.2
18005,6/1/19,45511,44331,1180,2.6
18007,6/1/19,4508,4356,152,3.4
18009,6/1/19,5046,4859,187,3.7
18011,6/1/19,36885,35936,949,2.6
18013,6/1/19,7851,7610,241,3.1
18015,6/1/19,10062,9764,298,3
18017,6/1/19,18418,17815,603,3.3
18019,6/1/19,62644,60502,2142,3.4
18021,6/1/19,12118,11698,420,3.5
18023,6/1/19,17268,16808,460,2.7
18025,6/1/19,4961,4776,185,3.7
18027,6/1/19,17158,16694,464,2.7
18029,6/1/19,26308,25388,920,3.5
18031,6/1/19,15491,15053,438,2.8
18033,6/1/19,23066,22417,649,2.8
18035,6/1/19,52488,50317,2171,4.1
18037,6/1/19,23738,23133,605,2.5
18039,6/1/19,115752,112169,3583,3.1
18041,6/1/19,8905,8475,430,4.8
18043,6/1/19,42291,40929,1362,3.2
18045,6/1/19,8144,7869,275,3.4
18047,6/1/19,11759,11363,396,3.4
18049,6/1/19,10154,9856,298,2.9
18051,6/1/19,19619,19115,504,2.6
18053,6/1/19,31365,30187,1178,3.8
18055,6/1/19,13637,13089,548,4
18057,6/1/19,186644,181697,4947,2.7
18059,6/1/19,40927,39712,1215,3
18061,6/1/19,20614,19958,656,3.2
18063,6/1/19,91311,88761,2550,2.8
18065,6/1/19,22351,21625,726,3.2
18067,6/1/19,36204,34839,1365,3.8
18069,6/1/19,18375,17788,587,3.2
18071,6/1/19,23180,22518,662,2.9
18073,6/1/19,16580,16019,561,3.4
18075,6/1/19,9577,9296,281,2.9
18077,6/1/19,15175,14649,526,3.5
18079,6/1/19,13737,13307,430,3.1
18081,6/1/19,84237,81909,2328,2.8
18083,6/1/19,18796,18196,600,3.2
18085,6/1/19,43084,41838,1246,2.9
18087,6/1/19,20563,19987,576,2.8
18089,6/1/19,234040,223278,10762,4.6
18091,6/1/19,48878,46882,1996,4.1
18093,6/1/19,20803,20028,775,3.7
18095,6/1/19,60018,57827,2191,3.7
18097,6/1/19,498035,481261,16774,3.4
18099,6/1/19,23823,23105,718,3
18101,6/1/19,5510,5360,150,2.7
18103,6/1/19,15774,15177,597,3.8
18105,6/1/19,67118,64610,2508,3.7
18107,6/1/19,18849,18244,605,3.2
18109,6/1/19,36932,35774,1158,3.1
18111,6/1/19,7102,6837,265,3.7
18113,6/1/19,24144,23409,735,3
18115,6/1/19,3248,3135,113,3.5
18117,6/1/19,8703,8381,322,3.7
18119,6/1/19,9003,8625,378,4.2
18121,6/1/19,7305,7032,273,3.7
18123,6/1/19,9423,9108,315,3.3
18125,6/1/19,6210,5982,228,3.7
18127,6/1/19,88365,85154,3211,3.6
18129,6/1/19,13864,13481,383,2.8
18131,6/1/19,6741,6542,199,3
18133,6/1/19,17087,16460,627,3.7
18135,6/1/19,11467,11052,415,3.6
18137,6/1/19,14672,14207,465,3.2
18139,6/1/19,9063,8827,236,2.6
18141,6/1/19,137320,132230,5090,3.7
18143,6/1/19,10738,10335,403,3.8
18145,6/1/19,23524,22831,693,2.9
18147,6/1/19,11688,11332,356,3
18149,6/1/19,10247,9839,408,4
18151,6/1/19,20899,20338,561,2.7
18153,6/1/19,8446,8090,356,4.2
18155,6/1/19,5128,4959,169,3.3
18157,6/1/19,96641,93567,3074,3.2
18159,6/1/19,9407,9152,255,2.7
18161,6/1/19,3636,3513,123,3.4
18163,6/1/19,96088,93054,3034,3.2
18165,6/1/19,7024,6684,340,4.8
18167,6/1/19,48446,46366,2080,4.3
18169,6/1/19,14960,14478,482,3.2
18171,6/1/19,4260,4132,128,3
18173,6/1/19,33630,32617,1013,3
18175,6/1/19,13956,13506,450,3.2
18177,6/1/19,31317,30169,1148,3.7
18179,6/1/19,14721,14330,391,2.7
18181,6/1/19,13849,13482,367,2.7
18183,6/1/19,18112,17586,526,2.9
19001,6/1/19,4375,4279,96,2.2
19003,6/1/19,2310,2272,38,1.6
19005,6/1/19,7500,7284,216,2.9
19007,6/1/19,6270,6061,209,3.3
19009,6/1/19,3174,3096,78,2.5
19011,6/1/19,13771,13400,371,2.7
19013,6/1/19,70176,68031,2145,3.1
19015,6/1/19,15098,14700,398,2.6
19017,6/1/19,14041,13733,308,2.2
19019,6/1/19,11577,11294,283,2.4
19021,6/1/19,11809,11508,301,2.5
19023,6/1/19,8089,7863,226,2.8
19025,6/1/19,4414,4300,114,2.6
19027,6/1/19,11296,11062,234,2.1
19029,6/1/19,7122,6932,190,2.7
19031,6/1/19,11184,10913,271,2.4
19033,6/1/19,24551,23846,705,2.9
19035,6/1/19,6298,6134,164,2.6
19037,6/1/19,6674,6510,164,2.5
19039,6/1/19,4981,4839,142,2.9
19041,6/1/19,8806,8562,244,2.8
19043,6/1/19,10515,10237,278,2.6
19045,6/1/19,23476,22615,861,3.7
19047,6/1/19,8294,8029,265,3.2
19049,6/1/19,50861,49786,1075,2.1
19051,6/1/19,4310,4199,111,2.6
19053,6/1/19,4340,4228,112,2.6
19055,6/1/19,10904,10665,239,2.2
19057,6/1/19,20075,19223,852,4.2
19059,6/1/19,11532,11268,264,2.3
19061,6/1/19,56757,55404,1353,2.4
19063,6/1/19,5474,5296,178,3.3
19065,6/1/19,10327,9971,356,3.4
19067,6/1/19,9087,8819,268,2.9
19069,6/1/19,5984,5853,131,2.2
19071,6/1/19,3725,3579,146,3.9
19073,6/1/19,5589,5397,192,3.4
19075,6/1/19,6572,6394,178,2.7
19077,6/1/19,5698,5534,164,2.9
19079,6/1/19,6997,6814,183,2.6
19081,6/1/19,6103,5942,161,2.6
19083,6/1/19,8319,8066,253,3
19085,6/1/19,7493,7312,181,2.4
19087,6/1/19,9755,9488,267,2.7
19089,6/1/19,5277,5143,134,2.5
19091,6/1/19,5276,5158,118,2.2
19093,6/1/19,4209,4127,82,1.9
19095,6/1/19,10734,10512,222,2.1
19097,6/1/19,11363,11041,322,2.8
19099,6/1/19,20529,19956,573,2.8
19101,6/1/19,10114,9865,249,2.5
19103,6/1/19,87383,85343,2040,2.3
19105,6/1/19,10855,10559,296,2.7
19107,6/1/19,5369,5209,160,3
19109,6/1/19,8753,8577,176,2
19111,6/1/19,16616,15976,640,3.9
19113,6/1/19,125418,121743,3675,2.9
19115,6/1/19,6202,6012,190,3.1
19117,6/1/19,4823,4722,101,2.1
19119,6/1/19,7327,7223,104,1.4
19121,6/1/19,8764,8455,309,3.5
19123,6/1/19,12140,11823,317,2.6
19125,6/1/19,18986,18585,401,2.1
19127,6/1/19,18383,17662,721,3.9
19129,6/1/19,7542,7363,179,2.4
19131,6/1/19,7259,7147,112,1.5
19133,6/1/19,4591,4450,141,3.1
19135,6/1/19,4109,3998,111,2.7
19137,6/1/19,5199,5062,137,2.6
19139,6/1/19,22624,21982,642,2.8
19141,6/1/19,8489,8293,196,2.3
19143,6/1/19,3637,3562,75,2.1
19145,6/1/19,6609,6433,176,2.7
19147,6/1/19,4924,4817,107,2.2
19149,6/1/19,15073,14738,335,2.2
19151,6/1/19,4618,4528,90,1.9
19153,6/1/19,276442,268421,8021,2.9
19155,6/1/19,49697,48453,1244,2.5
19157,6/1/19,10197,9934,263,2.6
19159,6/1/19,2543,2470,73,2.9
19161,6/1/19,5478,5358,120,2.2
19163,6/1/19,91849,88674,3175,3.5
19165,6/1/19,6946,6798,148,2.1
19167,6/1/19,20911,20516,395,1.9
19169,6/1/19,56480,55101,1379,2.4
19171,6/1/19,9691,9450,241,2.5
19173,6/1/19,3278,3208,70,2.1
19175,6/1/19,6430,6223,207,3.2
19177,6/1/19,3792,3691,101,2.7
19179,6/1/19,18107,17489,618,3.4
19181,6/1/19,29070,28309,761,2.6
19183,6/1/19,12063,11777,286,2.4
19185,6/1/19,2887,2810,77,2.7
19187,6/1/19,20027,19350,677,3.4
19189,6/1/19,5323,5131,192,3.6
19191,6/1/19,11632,11331,301,2.6
19193,6/1/19,56999,55441,1558,2.7
19195,6/1/19,4347,4229,118,2.7
19197,6/1/19,7298,7115,183,2.5
20001,6/1/19,6654,6366,288,4.3
20003,6/1/19,4253,4116,137,3.2
20005,6/1/19,7062,6642,420,5.9
20007,6/1/19,2365,2313,52,2.2
20009,6/1/19,13600,13196,404,3
20011,6/1/19,6793,6485,308,4.5
20013,6/1/19,5406,5227,179,3.3
20015,6/1/19,32804,31684,1120,3.4
20017,6/1/19,1627,1591,36,2.2
20019,6/1/19,1477,1413,64,4.3
20021,6/1/19,10255,9823,432,4.2
20023,6/1/19,1320,1286,34,2.6
20025,6/1/19,1072,1046,26,2.4
20027,6/1/19,3856,3723,133,3.4
20029,6/1/19,3853,3726,127,3.3
20031,6/1/19,3998,3803,195,4.9
20033,6/1/19,899,877,22,2.4
20035,6/1/19,16242,15659,583,3.6
20037,6/1/19,18992,18200,792,4.2
20039,6/1/19,1233,1195,38,3.1
20041,6/1/19,8948,8562,386,4.3
20043,6/1/19,4206,4045,161,3.8
20045,6/1/19,62085,60098,1987,3.2
20047,6/1/19,1487,1451,36,2.4
20049,6/1/19,1181,1131,50,4.2
20051,6/1/19,17310,16894,416,2.4
20053,6/1/19,2837,2755,82,2.9
20055,6/1/19,20729,20206,523,2.5
20057,6/1/19,16776,16354,422,2.5
20059,6/1/19,14197,13684,513,3.6
20061,6/1/19,11344,10793,551,4.9
20063,6/1/19,1479,1453,26,1.8
20065,6/1/19,1105,1073,32,2.9
20067,6/1/19,3240,3141,99,3.1
20069,6/1/19,3225,3163,62,1.9
20071,6/1/19,800,782,18,2.3
20073,6/1/19,3262,3153,109,3.3
20075,6/1/19,1571,1541,30,1.9
20077,6/1/19,2970,2896,74,2.5
20079,6/1/19,17108,16603,505,3
20081,6/1/19,2237,2181,56,2.5
20083,6/1/19,994,970,24,2.4
20085,6/1/19,7307,7100,207,2.8
20087,6/1/19,10272,9970,302,2.9
20089,6/1/19,1318,1282,36,2.7
20091,6/1/19,343911,334425,9486,2.8
20093,6/1/19,2076,2028,48,2.3
20095,6/1/19,3414,3307,107,3.1
20097,6/1/19,1283,1253,30,2.3
20099,6/1/19,10264,9733,531,5.2
20101,6/1/19,764,746,18,2.4
20103,6/1/19,36968,35756,1212,3.3
20105,6/1/19,1635,1599,36,2.2
20107,6/1/19,4460,4209,251,5.6
20109,6/1/19,1680,1648,32,1.9
20111,6/1/19,16910,16311,599,3.5
20113,6/1/19,17418,17028,390,2.2
20115,6/1/19,6045,5850,195,3.2
20117,6/1/19,5571,5408,163,2.9
20119,6/1/19,2179,2125,54,2.5
20121,6/1/19,17695,17144,551,3.1
20123,6/1/19,3404,3318,86,2.5
20125,6/1/19,15168,14513,655,4.3
20127,6/1/19,3038,2964,74,2.4
20129,6/1/19,1150,1118,32,2.8
20131,6/1/19,5442,5285,157,2.9
20133,6/1/19,6247,5913,334,5.3
20135,6/1/19,1353,1323,30,2.2
20137,6/1/19,2742,2680,62,2.3
20139,6/1/19,8083,7818,265,3.3
20141,6/1/19,2061,2023,38,1.8
20143,6/1/19,3031,2941,90,3
20145,6/1/19,2846,2764,82,2.9
20147,6/1/19,2710,2642,68,2.5
20149,6/1/19,11686,11338,348,3
20151,6/1/19,5007,4874,133,2.7
20153,6/1/19,1494,1462,32,2.1
20155,6/1/19,30158,29215,943,3.1
20157,6/1/19,2249,2191,58,2.6
20159,6/1/19,5306,5153,153,2.9
20161,6/1/19,33050,32041,1009,3.1
20163,6/1/19,2583,2470,113,4.4
20165,6/1/19,1636,1590,46,2.8
20167,6/1/19,3360,3255,105,3.1
20169,6/1/19,30134,29149,985,3.3
20171,6/1/19,2810,2754,56,2
20173,6/1/19,253688,244713,8975,3.5
20175,6/1/19,9418,9100,318,3.4
20177,6/1/19,92458,89454,3004,3.2
20179,6/1/19,1417,1389,28,2
20181,6/1/19,2859,2785,74,2.6
20183,6/1/19,2011,1955,56,2.8
20185,6/1/19,1996,1936,60,3
20187,6/1/19,1024,996,28,2.7
20189,6/1/19,2556,2492,64,2.5
20191,6/1/19,10985,10583,402,3.7
20193,6/1/19,4269,4166,103,2.4
20195,6/1/19,1422,1388,34,2.4
20197,6/1/19,3696,3573,123,3.3
20199,6/1/19,813,791,22,2.7
20201,6/1/19,2942,2858,84,2.9
20203,6/1/19,1671,1645,26,1.6
20205,6/1/19,4029,3862,167,4.1
20207,6/1/19,1689,1617,72,4.3
20209,6/1/19,78467,75077,3390,4.3
21001,6/1/19,7153,6724,429,6
21003,6/1/19,9286,8843,443,4.8
21005,6/1/19,12317,11814,503,4.1
21007,6/1/19,3564,3353,211,5.9
21009,6/1/19,19135,18175,960,5
21011,6/1/19,4735,4417,318,6.7
21013,6/1/19,8495,7887,608,7.2
21015,6/1/19,72265,69541,2724,3.8
21017,6/1/19,10303,9894,409,4
21019,6/1/19,17940,16793,1147,6.4
21021,6/1/19,12872,12162,710,5.5
21023,6/1/19,3900,3707,193,4.9
21025,6/1/19,3645,3357,288,7.9
21027,6/1/19,8209,7745,464,5.7
21029,6/1/19,43536,41512,2024,4.6
21031,6/1/19,5178,4880,298,5.8
21033,6/1/19,5586,5270,316,5.7
21035,6/1/19,18854,17945,909,4.8
21037,6/1/19,51694,49647,2047,4
21039,6/1/19,2288,2188,100,4.4
21041,6/1/19,5351,5113,238,4.4
21043,6/1/19,9923,9030,893,9
21045,6/1/19,6917,6602,315,4.6
21047,6/1/19,25232,23584,1648,6.5
21049,6/1/19,17537,16762,775,4.4
21051,6/1/19,5246,4820,426,8.1
21053,6/1/19,4130,3893,237,5.7
21055,6/1/19,3900,3698,202,5.2
21057,6/1/19,3274,3133,141,4.3
21059,6/1/19,47979,45867,2112,4.4
21061,6/1/19,4875,4613,262,5.4
21063,6/1/19,2071,1891,180,8.7
21065,6/1/19,5419,5128,291,5.4
21067,6/1/19,178859,171956,6903,3.9
21069,6/1/19,6451,6072,379,5.9
21071,6/1/19,11037,10246,791,7.2
21073,6/1/19,25832,24732,1100,4.3
21075,6/1/19,2100,1970,130,6.2
21077,6/1/19,4199,4014,185,4.4
21079,6/1/19,7836,7422,414,5.3
21081,6/1/19,11958,11427,531,4.4
21083,6/1/19,16221,15405,816,5
21085,6/1/19,11257,10632,625,5.6
21087,6/1/19,5164,4909,255,4.9
21089,6/1/19,13528,12538,990,7.3
21091,6/1/19,4031,3857,174,4.3
21093,6/1/19,50079,47769,2310,4.6
21095,6/1/19,6534,5961,573,8.8
21097,6/1/19,9027,8587,440,4.9
21099,6/1/19,8200,7805,395,4.8
21101,6/1/19,22422,21462,960,4.3
21103,6/1/19,8443,8103,340,4
21105,6/1/19,1872,1776,96,5.1
21107,6/1/19,18840,17847,993,5.3
21109,6/1/19,4193,3902,291,6.9
21111,6/1/19,406357,387795,18562,4.6
21113,6/1/19,27042,25914,1128,4.2
21115,6/1/19,6854,6346,508,7.4
21117,6/1/19,89420,85871,3549,4
21119,6/1/19,4632,4278,354,7.6
21121,6/1/19,10086,9394,692,6.9
21123,6/1/19,6108,5804,304,5
21125,6/1/19,24963,23577,1386,5.6
21127,6/1/19,5231,4828,403,7.7
21129,6/1/19,2077,1936,141,6.8
21131,6/1/19,2739,2528,211,7.7
21133,6/1/19,6362,5900,462,7.3
21135,6/1/19,4747,4310,437,9.2
21137,6/1/19,9550,9019,531,5.6
21139,6/1/19,3689,3481,208,5.6
21141,6/1/19,12851,12271,580,4.5
21143,6/1/19,3354,3190,164,4.9
21145,6/1/19,29444,27851,1593,5.4
21147,6/1/19,4733,4413,320,6.8
21149,6/1/19,4328,4115,213,4.9
21151,6/1/19,47853,45635,2218,4.6
21153,6/1/19,3078,2746,332,10.8
21155,6/1/19,9975,9536,439,4.4
21157,6/1/19,15485,14714,771,5
21159,6/1/19,2818,2602,216,7.7
21161,6/1/19,7190,6734,456,6.3
21163,6/1/19,12574,11941,633,5
21165,6/1/19,2348,2177,171,7.3
21167,6/1/19,10309,9789,520,5
21169,6/1/19,4204,3988,216,5.1
21171,6/1/19,4801,4588,213,4.4
21173,6/1/19,11857,11129,728,6.1
21175,6/1/19,4684,4416,268,5.7
21177,6/1/19,10762,10004,758,7
21179,6/1/19,23644,22496,1148,4.9
21181,6/1/19,3309,3145,164,5
21183,6/1/19,9994,9418,576,5.8
21185,6/1/19,33877,32608,1269,3.7
21187,6/1/19,5310,5041,269,5.1
21189,6/1/19,1156,1070,86,7.4
21191,6/1/19,7120,6819,301,4.2
21193,6/1/19,8442,7916,526,6.2
21195,6/1/19,19823,18553,1270,6.4
21197,6/1/19,5115,4822,293,5.7
21199,6/1/19,26840,25422,1418,5.3
21201,6/1/19,838,793,45,5.4
21203,6/1/19,6751,6388,363,5.4
21205,6/1/19,10479,9838,641,6.1
21207,6/1/19,6455,6071,384,5.9
21209,6/1/19,29817,28612,1205,4
21211,6/1/19,26096,25103,993,3.8
21213,6/1/19,9026,8586,440,4.9
21215,6/1/19,10347,9954,393,3.8
21217,6/1/19,12600,11959,641,5.1
21219,6/1/19,5571,5336,235,4.2
21221,6/1/19,6096,5784,312,5.1
21223,6/1/19,3970,3782,188,4.7
21225,6/1/19,6339,6026,313,4.9
21227,6/1/19,65797,62840,2957,4.5
21229,6/1/19,6404,6138,266,4.2
21231,6/1/19,7775,7296,479,6.2
21233,6/1/19,5994,5723,271,4.5
21235,6/1/19,13921,13096,825,5.9
21237,6/1/19,2006,1859,147,7.3
21239,6/1/19,15596,15070,526,3.4
22001,6/1/19,24132,22665,1467,6.1
22003,6/1/19,9016,8429,587,6.5
22005,6/1/19,64060,61055,3005,4.7
22007,6/1/19,8973,8372,601,6.7
22009,6/1/19,15338,14295,1043,6.8
22011,6/1/19,14741,13873,868,5.9
22013,6/1/19,5606,5249,357,6.4
22015,6/1/19,58238,55310,2928,5
22017,6/1/19,104692,98226,6466,6.2
22019,6/1/19,108475,103431,5044,4.6
22021,6/1/19,3803,3576,227,6
22023,6/1/19,4024,3847,177,4.4
22025,6/1/19,3432,3183,249,7.3
22027,6/1/19,5891,5534,357,6.1
22029,6/1/19,7078,6540,538,7.6
22031,6/1/19,10932,10224,708,6.5
22033,6/1/19,231435,219420,12015,5.2
22035,6/1/19,1909,1677,232,12.2
22037,6/1/19,8015,7591,424,5.3
22039,6/1/19,12223,11383,840,6.9
22041,6/1/19,7581,6994,587,7.7
22043,6/1/19,8304,7750,554,6.7
22045,6/1/19,28538,26773,1765,6.2
22047,6/1/19,14057,13127,930,6.6
22049,6/1/19,6888,6523,365,5.3
22051,6/1/19,215808,205439,10369,4.8
22053,6/1/19,13439,12710,729,5.4
22055,6/1/19,115147,109403,5744,5
22057,6/1/19,42413,40180,2233,5.3
22059,6/1/19,6879,6519,360,5.2
22061,6/1/19,21597,20157,1440,6.7
22063,6/1/19,69010,65706,3304,4.8
22065,6/1/19,3633,3290,343,9.4
22067,6/1/19,10049,9191,858,8.5
22069,6/1/19,16162,15023,1139,7
22071,6/1/19,181222,170849,10373,5.7
22073,6/1/19,70363,66143,4220,6
22075,6/1/19,10142,9639,503,5
22077,6/1/19,9925,9316,609,6.1
22079,6/1/19,55707,52505,3202,5.7
22081,6/1/19,3791,3572,219,5.8
22083,6/1/19,8391,7819,572,6.8
22085,6/1/19,9302,8785,517,5.6
22087,6/1/19,20100,18990,1110,5.5
22089,6/1/19,25413,24119,1294,5.1
22091,6/1/19,4312,3999,313,7.3
22093,6/1/19,9320,8676,644,6.9
22095,6/1/19,19834,18577,1257,6.3
22097,6/1/19,32548,30238,2310,7.1
22099,6/1/19,22418,21106,1312,5.9
22101,6/1/19,20127,18833,1294,6.4
22103,6/1/19,120763,114915,5848,4.8
22105,6/1/19,54574,51002,3572,6.5
22107,6/1/19,1435,1284,151,10.5
22109,6/1/19,46582,44129,2453,5.3
22111,6/1/19,9129,8538,591,6.5
22113,6/1/19,24471,23081,1390,5.7
22115,6/1/19,16132,15069,1063,6.6
22117,6/1/19,16936,15738,1198,7.1
22119,6/1/19,14673,13650,1023,7
22121,6/1/19,13713,12971,742,5.4
22123,6/1/19,3691,3324,367,9.9
22125,6/1/19,5385,5139,246,4.6
22127,6/1/19,4877,4532,345,7.1
23001,6/1/19,55328,53796,1532,2.8
23003,6/1/19,30348,28963,1385,4.6
23005,6/1/19,167436,163567,3869,2.3
23007,6/1/19,13897,13367,530,3.8
23009,6/1/19,30761,30012,749,2.4
23011,6/1/19,62229,60502,1727,2.8
23013,6/1/19,20982,20478,504,2.4
23015,6/1/19,17590,17157,433,2.5
23017,6/1/19,26482,25577,905,3.4
23019,6/1/19,76497,74204,2293,3
23021,6/1/19,7376,7138,238,3.2
23023,6/1/19,19591,19179,412,2.1
23025,6/1/19,22716,21825,891,3.9
23027,6/1/19,20813,20205,608,2.9
23029,6/1/19,13778,13207,571,4.1
23031,6/1/19,115302,112590,2712,2.4
24001,6/1/19,32496,30662,1834,5.6
24003,6/1/19,320643,309956,10687,3.3
24005,6/1/19,461962,443493,18469,4
24009,6/1/19,50598,48785,1813,3.6
24011,6/1/19,18328,17634,694,3.8
24013,6/1/19,96933,93827,3106,3.2
24015,6/1/19,53436,51161,2275,4.3
24017,6/1/19,88318,84934,3384,3.8
24019,6/1/19,16097,15266,831,5.2
24021,6/1/19,136742,131990,4752,3.5
24023,6/1/19,15841,15141,700,4.4
24025,6/1/19,143529,138316,5213,3.6
24027,6/1/19,190942,185081,5861,3.1
24029,6/1/19,10249,9833,416,4.1
24031,6/1/19,568944,550346,18598,3.3
24033,6/1/19,514658,494075,20583,4
24035,6/1/19,28001,27066,935,3.3
24037,6/1/19,57742,55678,2064,3.6
24039,6/1/19,9689,9066,623,6.4
24041,6/1/19,19380,18682,698,3.6
24043,6/1/19,75406,72319,3087,4.1
24045,6/1/19,54774,52250,2524,4.6
24047,6/1/19,26586,25172,1414,5.3
24510,6/1/19,294244,278182,16062,5.5
25001,6/1/19,123191,119389,3802,3.1
25003,6/1/19,67243,64910,2333,3.5
25005,6/1/19,305427,293661,11766,3.9
25007,6/1/19,11158,10851,307,2.8
25009,6/1/19,432801,418856,13945,3.2
25011,6/1/19,41426,40276,1150,2.8
25013,6/1/19,229665,219304,10361,4.5
25015,6/1/19,90736,87909,2827,3.1
25017,6/1/19,936739,912523,24216,2.6
25019,6/1/19,9213,9020,193,2.1
25021,6/1/19,398168,387016,11152,2.8
25023,6/1/19,288814,279671,9143,3.2
25025,6/1/19,465144,451000,14144,3
25027,6/1/19,451728,436468,15260,3.4
26001,6/1/19,4060,3817,243,6
26003,6/1/19,3464,3211,253,7.3
26005,6/1/19,63674,61590,2084,3.3
26007,6/1/19,13324,12690,634,4.8
26009,6/1/19,11075,10564,511,4.6
26011,6/1/19,6315,5924,391,6.2
26013,6/1/19,3310,3087,223,6.7
26015,6/1/19,32088,30995,1093,3.4
26017,6/1/19,50736,48263,2473,4.9
26019,6/1/19,9307,8878,429,4.6
26021,6/1/19,75435,72056,3379,4.5
26023,6/1/19,19720,18887,833,4.2
26025,6/1/19,63134,60310,2824,4.5
26027,6/1/19,24597,23393,1204,4.9
26029,6/1/19,13870,13285,585,4.2
26031,6/1/19,11154,10728,426,3.8
26033,6/1/19,16227,15206,1021,6.3
26035,6/1/19,11924,11192,732,6.1
26037,6/1/19,40665,39367,1298,3.2
26039,6/1/19,5807,5498,309,5.3
26041,6/1/19,17548,16655,893,5.1
26043,6/1/19,12549,12003,546,4.4
26045,6/1/19,56471,54420,2051,3.6
26047,6/1/19,19011,18137,874,4.6
26049,6/1/19,185201,175252,9949,5.4
26051,6/1/19,10148,9559,589,5.8
26053,6/1/19,6022,5668,354,5.9
26055,6/1/19,52352,50645,1707,3.3
26057,6/1/19,18172,17365,807,4.4
26059,6/1/19,20791,19874,917,4.4
26061,6/1/19,15725,14833,892,5.7
26063,6/1/19,15866,15170,696,4.4
26065,6/1/19,149489,143607,5882,3.9
26067,6/1/19,30659,29580,1079,3.5
26069,6/1/19,10624,10006,618,5.8
26071,6/1/19,5317,5026,291,5.5
26073,6/1/19,35001,33499,1502,4.3
26075,6/1/19,74817,71759,3058,4.1
26077,6/1/19,134354,129525,4829,3.6
26079,6/1/19,8311,7885,426,5.1
26081,6/1/19,364887,353191,11696,3.2
26083,6/1/19,870,798,72,8.3
26085,6/1/19,3772,3526,246,6.5
26087,6/1/19,41507,39298,2209,5.3
26089,6/1/19,11038,10675,363,3.3
26091,6/1/19,46655,44802,1853,4
26093,6/1/19,104271,100779,3492,3.3
26095,6/1/19,2391,2252,139,5.8
26097,6/1/19,5981,5785,196,3.3
26099,6/1/19,451365,431788,19577,4.3
26101,6/1/19,11067,10476,591,5.3
26103,6/1/19,32393,30659,1734,5.4
26105,6/1/19,14376,13706,670,4.7
26107,6/1/19,17762,16848,914,5.1
26109,6/1/19,11353,10929,424,3.7
26111,6/1/19,41049,39440,1609,3.9
26113,6/1/19,7172,6817,355,4.9
26115,6/1/19,76171,73132,3039,4
26117,6/1/19,28736,27501,1235,4.3
26119,6/1/19,3079,2856,223,7.2
26121,6/1/19,78937,75381,3556,4.5
26123,6/1/19,24144,23077,1067,4.4
26125,6/1/19,681473,656868,24605,3.6
26127,6/1/19,12872,12197,675,5.2
26129,6/1/19,8436,7916,520,6.2
26131,6/1/19,2128,1990,138,6.5
26133,6/1/19,11345,10855,490,4.3
26135,6/1/19,3228,3017,211,6.5
26137,6/1/19,12147,11546,601,4.9
26139,6/1/19,163485,158415,5070,3.1
26141,6/1/19,5150,4819,331,6.4
26143,6/1/19,8217,7638,579,7
26145,6/1/19,87792,83467,4325,4.9
26147,6/1/19,76192,72558,3634,4.8
26149,6/1/19,28514,27262,1252,4.4
26151,6/1/19,19996,19053,943,4.7
26153,6/1/19,3412,3199,213,6.2
26155,6/1/19,33720,32221,1499,4.4
26157,6/1/19,24307,23025,1282,5.3
26159,6/1/19,35443,33737,1706,4.8
26161,6/1/19,196456,189784,6672,3.4
26163,6/1/19,804409,762087,42322,5.3
26165,6/1/19,15307,14530,777,5.1
27001,6/1/19,7414,7090,324,4.4
27003,6/1/19,199916,193607,6309,3.2
27005,6/1/19,19456,18813,643,3.3
27007,6/1/19,24551,23569,982,4
27009,6/1/19,21824,21125,699,3.2
27011,6/1/19,2586,2507,79,3.1
27013,6/1/19,40417,39181,1236,3.1
27015,6/1/19,14588,14130,458,3.1
27017,6/1/19,17837,17124,713,4
27019,6/1/19,59372,57618,1754,3
27021,6/1/19,15282,14672,610,4
27023,6/1/19,7080,6827,253,3.6
27025,6/1/19,30180,29169,1011,3.3
27027,6/1/19,36118,34989,1129,3.1
27029,6/1/19,4445,4169,276,6.2
27031,6/1/19,3269,3162,107,3.3
27033,6/1/19,6159,5915,244,4
27035,6/1/19,33683,32541,1142,3.4
27037,6/1/19,244672,237151,7521,3.1
27039,6/1/19,12043,11653,390,3.2
27041,6/1/19,21813,21194,619,2.8
27043,6/1/19,7190,6901,289,4
27045,6/1/19,11729,11390,339,2.9
27047,6/1/19,16454,15898,556,3.4
27049,6/1/19,27495,26668,827,3
27051,6/1/19,3364,3238,126,3.7
27053,6/1/19,715771,693763,22008,3.1
27055,6/1/19,10355,10051,304,2.9
27057,6/1/19,10449,10025,424,4.1
27059,6/1/19,21368,20676,692,3.2
27061,6/1/19,22507,21305,1202,5.3
27063,6/1/19,5829,5570,259,4.4
27065,6/1/19,9123,8769,354,3.9
27067,6/1/19,24737,23959,778,3.1
27069,6/1/19,2449,2363,86,3.5
27071,6/1/19,6232,5832,400,6.4
27073,6/1/19,3684,3561,123,3.3
27075,6/1/19,5862,5656,206,3.5
27077,6/1/19,2535,2427,108,4.3
27079,6/1/19,16180,15644,536,3.3
27081,6/1/19,3402,3298,104,3.1
27083,6/1/19,14920,14435,485,3.3
27085,6/1/19,19622,18948,674,3.4
27087,6/1/19,2360,2264,96,4.1
27089,6/1/19,5522,5315,207,3.7
27091,6/1/19,10467,10009,458,4.4
27093,6/1/19,13502,13065,437,3.2
27095,6/1/19,12889,12382,507,3.9
27097,6/1/19,17755,17150,605,3.4
27099,6/1/19,20674,20034,640,3.1
27101,6/1/19,5048,4898,150,3
27103,6/1/19,20876,20295,581,2.8
27105,6/1/19,11391,11034,357,3.1
27107,6/1/19,3392,3230,162,4.8
27109,6/1/19,89685,87182,2503,2.8
27111,6/1/19,32711,31637,1074,3.3
27113,6/1/19,8790,8517,273,3.1
27115,6/1/19,15166,14547,619,4.1
27117,6/1/19,5067,4929,138,2.7
27119,6/1/19,16736,15985,751,4.5
27121,6/1/19,6694,6509,185,2.8
27123,6/1/19,293448,283835,9613,3.3
27125,6/1/19,2249,2154,95,4.2
27127,6/1/19,7887,7617,270,3.4
27129,6/1/19,8729,8369,360,4.1
27131,6/1/19,37896,36680,1216,3.2
27133,6/1/19,5833,5698,135,2.3
27135,6/1/19,7973,7678,295,3.7
27137,6/1/19,102296,98232,4064,4
27139,6/1/19,84519,82101,2418,2.9
27141,6/1/19,52839,51165,1674,3.2
27143,6/1/19,8708,8422,286,3.3
27145,6/1/19,90493,87675,2818,3.1
27147,6/1/19,21434,20739,695,3.2
27149,6/1/19,5605,5454,151,2.7
27151,6/1/19,5047,4883,164,3.2
27153,6/1/19,13655,13184,471,3.4
27155,6/1/19,1868,1807,61,3.3
27157,6/1/19,12511,12123,388,3.1
27159,6/1/19,5982,5696,286,4.8
27161,6/1/19,9265,8924,341,3.7
27163,6/1/19,145185,140804,4381,3
27165,6/1/19,6707,6455,252,3.8
27167,6/1/19,3609,3485,124,3.4
27169,6/1/19,28618,27667,951,3.3
27171,6/1/19,76302,74050,2252,3
27173,6/1/19,5510,5297,213,3.9
28001,6/1/19,11525,10588,937,8.1
28003,6/1/19,16165,15256,909,5.6
28005,6/1/19,4594,4235,359,7.8
28007,6/1/19,7241,6730,511,7.1
28009,6/1/19,3087,2854,233,7.5
28011,6/1/19,12661,11548,1113,8.8
28013,6/1/19,5897,5538,359,6.1
28015,6/1/19,3555,3306,249,7
28017,6/1/19,7027,6569,458,6.5
28019,6/1/19,3851,3625,226,5.9
28021,6/1/19,3130,2710,420,13.4
28023,6/1/19,5979,5545,434,7.3
28025,6/1/19,8008,7313,695,8.7
28027,6/1/19,8660,7878,782,9
28029,6/1/19,11494,10571,923,8
28031,6/1/19,8294,7824,470,5.7
28033,6/1/19,91549,86764,4785,5.2
28035,6/1/19,33124,31061,2063,6.2
28037,6/1/19,2925,2702,223,7.6
28039,6/1/19,9113,8369,744,8.2
28041,6/1/19,4468,4067,401,9
28043,6/1/19,9825,9239,586,6
28045,6/1/19,19060,17846,1214,6.4
28047,6/1/19,87934,82684,5250,6
28049,6/1/19,108244,101395,6849,6.3
28051,6/1/19,5827,5119,708,12.2
28053,6/1/19,2354,2104,250,10.6
28055,6/1/19,403,351,52,12.9
28057,6/1/19,10691,10085,606,5.7
28059,6/1/19,59592,55518,4074,6.8
28061,6/1/19,6349,5849,500,7.9
28063,6/1/19,2111,1720,391,18.5
28065,6/1/19,4163,3796,367,8.8
28067,6/1/19,26773,25063,1710,6.4
28069,6/1/19,3675,3312,363,9.9
28071,6/1/19,27692,25966,1726,6.2
28073,6/1/19,30414,28902,1512,5
28075,6/1/19,30681,28628,2053,6.7
28077,6/1/19,4758,4370,388,8.2
28079,6/1/19,8293,7769,524,6.3
28081,6/1/19,41465,39343,2122,5.1
28083,6/1/19,10238,9372,866,8.5
28085,6/1/19,14955,13996,959,6.4
28087,6/1/19,25383,23694,1689,6.7
28089,6/1/19,53818,50940,2878,5.3
28091,6/1/19,10075,9443,632,6.3
28093,6/1/19,14646,13607,1039,7.1
28095,6/1/19,15749,14758,991,6.3
28097,6/1/19,4092,3820,272,6.6
28099,6/1/19,10732,10002,730,6.8
28101,6/1/19,9043,8440,603,6.7
28103,6/1/19,3966,3629,337,8.5
28105,6/1/19,22440,20749,1691,7.5
28107,6/1/19,12858,11848,1010,7.9
28109,6/1/19,24095,22642,1453,6
28111,6/1/19,4289,3960,329,7.7
28113,6/1/19,14968,13804,1164,7.8
28115,6/1/19,14902,14147,755,5.1
28117,6/1/19,11501,10833,668,5.8
28119,6/1/19,2521,2268,253,10
28121,6/1/19,76686,73151,3535,4.6
28123,6/1/19,13168,12438,730,5.5
28125,6/1/19,1676,1526,150,8.9
28127,6/1/19,10935,10272,663,6.1
28129,6/1/19,7029,6614,415,5.9
28131,6/1/19,7022,6438,584,8.3
28133,6/1/19,8030,7310,720,9
28135,6/1/19,5458,5094,364,6.7
28137,6/1/19,12572,11709,863,6.9
28139,6/1/19,9538,8936,602,6.3
28141,6/1/19,8765,8258,507,5.8
28143,6/1/19,4564,4232,332,7.3
28145,6/1/19,14411,13727,684,4.7
28147,6/1/19,5086,4638,448,8.8
28149,6/1/19,20465,19045,1420,6.9
28151,6/1/19,17510,15996,1514,8.6
28153,6/1/19,7698,7149,549,7.1
28155,6/1/19,4008,3750,258,6.4
28157,6/1/19,2886,2541,345,12
28159,6/1/19,7603,7058,545,7.2
28161,6/1/19,4931,4572,359,7.3
28163,6/1/19,9720,8968,752,7.7
29001,6/1/19,10318,9817,501,4.9
29003,6/1/19,9845,9541,304,3.1
29005,6/1/19,2686,2546,140,5.2
29007,6/1/19,10711,10319,392,3.7
29009,6/1/19,15557,15071,486,3.1
29011,6/1/19,5206,4996,210,4
29013,6/1/19,7917,7564,353,4.5
29015,6/1/19,7306,6958,348,4.8
29017,6/1/19,5501,5254,247,4.5
29019,6/1/19,96112,93576,2536,2.6
29021,6/1/19,45171,43764,1407,3.1
29023,6/1/19,18287,17105,1182,6.5
29025,6/1/19,4349,4206,143,3.3
29027,6/1/19,21527,20848,679,3.2
29029,6/1/19,20392,19698,694,3.4
29031,6/1/19,41220,39927,1293,3.1
29033,6/1/19,4572,4413,159,3.5
29035,6/1/19,2613,2466,147,5.6
29037,6/1/19,55362,53663,1699,3.1
29039,6/1/19,5781,5547,234,4
29041,6/1/19,3707,3581,126,3.4
29043,6/1/19,44989,43786,1203,2.7
29045,6/1/19,3254,3123,131,4
29047,6/1/19,137948,134061,3887,2.8
29049,6/1/19,10776,10455,321,3
29051,6/1/19,39369,38289,1080,2.7
29053,6/1/19,7476,7205,271,3.6
29055,6/1/19,11201,10775,426,3.8
29057,6/1/19,3572,3456,116,3.2
29059,6/1/19,6986,6705,281,4
29061,6/1/19,4123,3998,125,3
29063,6/1/19,4838,4683,155,3.2
29065,6/1/19,6410,6166,244,3.8
29067,6/1/19,5067,4862,205,4
29069,6/1/19,11739,11023,716,6.1
29071,6/1/19,53541,51880,1661,3.1
29073,6/1/19,7767,7547,220,2.8
29075,6/1/19,3566,3452,114,3.2
29077,6/1/19,151710,147657,4053,2.7
29079,6/1/19,4315,4163,152,3.5
29081,6/1/19,3759,3653,106,2.8
29083,6/1/19,9860,9437,423,4.3
29085,6/1/19,3956,3802,154,3.9
29087,6/1/19,2597,2498,99,3.8
29089,6/1/19,4832,4672,160,3.3
29091,6/1/19,16583,15909,674,4.1
29093,6/1/19,3615,3439,176,4.9
29095,6/1/19,367535,353695,13840,3.8
29097,6/1/19,57128,55342,1786,3.1
29099,6/1/19,119201,115525,3676,3.1
29101,6/1/19,23196,22304,892,3.8
29103,6/1/19,1751,1693,58,3.3
29105,6/1/19,17178,16482,696,4.1
29107,6/1/19,16911,16374,537,3.2
29109,6/1/19,18071,17462,609,3.4
29111,6/1/19,5008,4851,157,3.1
29113,6/1/19,28627,27660,967,3.4
29115,6/1/19,5197,4931,266,5.1
29117,6/1/19,7411,7242,169,2.3
29119,6/1/19,10628,10205,423,4
29121,6/1/19,7558,7314,244,3.2
29123,6/1/19,5494,5296,198,3.6
29125,6/1/19,3905,3762,143,3.7
29127,6/1/19,14661,14173,488,3.3
29129,6/1/19,1819,1766,53,2.9
29131,6/1/19,12836,12418,418,3.3
29133,6/1/19,5828,5548,280,4.8
29135,6/1/19,7288,7056,232,3.2
29137,6/1/19,3892,3715,177,4.5
29139,6/1/19,5722,5529,193,3.4
29141,6/1/19,8457,8141,316,3.7
29143,6/1/19,8259,7862,397,4.8
29145,6/1/19,27288,26297,991,3.6
29147,6/1/19,10758,10361,397,3.7
29149,6/1/19,3863,3694,169,4.4
29151,6/1/19,7093,6914,179,2.5
29153,6/1/19,3513,3320,193,5.5
29155,6/1/19,6474,6106,368,5.7
29157,6/1/19,10113,9828,285,2.8
29159,6/1/19,20879,20072,807,3.9
29161,6/1/19,19743,19057,686,3.5
29163,6/1/19,7535,7248,287,3.8
29165,6/1/19,59390,57811,1579,2.7
29167,6/1/19,14483,13971,512,3.5
29169,6/1/19,14781,14223,558,3.8
29171,6/1/19,2244,2166,78,3.5
29173,6/1/19,5658,5487,171,3
29175,6/1/19,10371,9962,409,3.9
29177,6/1/19,11148,10708,440,3.9
29179,6/1/19,3230,3128,102,3.2
29181,6/1/19,5152,4761,391,7.6
29183,6/1/19,229219,223266,5953,2.6
29185,6/1/19,3759,3561,198,5.3
29186,6/1/19,9340,9076,264,2.8
29187,6/1/19,27160,26143,1017,3.7
29189,6/1/19,538570,521358,17212,3.2
29195,6/1/19,10790,10401,389,3.6
29197,6/1/19,1901,1807,94,4.9
29199,6/1/19,2354,2279,75,3.2
29201,6/1/19,20055,19269,786,3.9
29203,6/1/19,3289,3110,179,5.4
29205,6/1/19,3066,2989,77,2.5
29207,6/1/19,13039,12331,708,5.4
29209,6/1/19,15013,14469,544,3.6
29211,6/1/19,2642,2553,89,3.4
29213,6/1/19,29426,28442,984,3.3
29215,6/1/19,9043,8652,391,4.3
29217,6/1/19,9497,9135,362,3.8
29219,6/1/19,18064,17552,512,2.8
29221,6/1/19,10526,10048,478,4.5
29223,6/1/19,5420,5108,312,5.8
29225,6/1/19,17158,16590,568,3.3
29227,6/1/19,1194,1150,44,3.7
29229,6/1/19,7378,7062,316,4.3
29510,6/1/19,155046,148484,6562,4.2
30001,6/1/19,5062,4921,141,2.8
30003,6/1/19,4748,4388,360,7.6
30005,6/1/19,2399,2318,81,3.4
30007,6/1/19,2625,2518,107,4.1
30009,6/1/19,5460,5290,170,3.1
30011,6/1/19,612,592,20,3.3
30013,6/1/19,38463,37170,1293,3.4
30015,6/1/19,2461,2403,58,2.4
30017,6/1/19,6019,5849,170,2.8
30019,6/1/19,867,844,23,2.7
30021,6/1/19,4536,4423,113,2.5
30023,6/1/19,5115,4962,153,3
30025,6/1/19,1710,1686,24,1.4
30027,6/1/19,6227,6075,152,2.4
30029,6/1/19,49408,47352,2056,4.2
30031,6/1/19,69420,67918,1502,2.2
30033,6/1/19,694,679,15,2.2
30035,6/1/19,6062,5603,459,7.6
30037,6/1/19,362,348,14,3.9
30039,6/1/19,1708,1631,77,4.5
30041,6/1/19,7679,7376,303,3.9
30043,6/1/19,5717,5546,171,3
30045,6/1/19,885,861,24,2.7
30047,6/1/19,13690,13147,543,4
30049,6/1/19,36200,35127,1073,3
30051,6/1/19,914,890,24,2.6
30053,6/1/19,8264,7759,505,6.1
30055,6/1/19,939,919,20,2.1
30057,6/1/19,4470,4340,130,2.9
30059,6/1/19,896,868,28,3.1
30061,6/1/19,1836,1741,95,5.2
30063,6/1/19,64333,62426,1907,3
30065,6/1/19,2275,2192,83,3.6
30067,6/1/19,9316,9040,276,3
30069,6/1/19,270,262,8,3
30071,6/1/19,1854,1791,63,3.4
30073,6/1/19,2711,2604,107,3.9
30075,6/1/19,952,932,20,2.1
30077,6/1/19,3044,2946,98,3.2
30079,6/1/19,458,440,18,3.9
30081,6/1/19,20611,19836,775,3.8
30083,6/1/19,5840,5676,164,2.8
30085,6/1/19,4610,4405,205,4.4
30087,6/1/19,3818,3596,222,5.8
30089,6/1/19,4933,4671,262,5.3
30091,6/1/19,1751,1714,37,2.1
30093,6/1/19,17455,16808,647,3.7
30095,6/1/19,5055,4900,155,3.1
30097,6/1/19,1825,1774,51,2.8
30099,6/1/19,2776,2695,81,2.9
30101,6/1/19,2129,2078,51,2.4
30103,6/1/19,323,314,9,2.8
30105,6/1/19,4151,4032,119,2.9
30107,6/1/19,755,727,28,3.7
30109,6/1/19,467,453,14,3
30111,6/1/19,82501,79697,2804,3.4
31001,6/1/19,17209,16611,598,3.5
31003,6/1/19,3744,3650,94,2.5
31005,6/1/19,239,227,12,5
31007,6/1/19,380,365,15,3.9
31009,6/1/19,273,261,12,4.4
31011,6/1/19,3093,3009,84,2.7
31013,6/1/19,5522,5324,198,3.6
31015,6/1/19,1137,1101,36,3.2
31017,6/1/19,1455,1393,62,4.3
31019,6/1/19,27837,26975,862,3.1
31021,6/1/19,3618,3497,121,3.3
31023,6/1/19,4787,4650,137,2.9
31025,6/1/19,13717,13220,497,3.6
31027,6/1/19,4798,4668,130,2.7
31029,6/1/19,2386,2328,58,2.4
31031,6/1/19,3623,3526,97,2.7
31033,6/1/19,4569,4391,178,3.9
31035,6/1/19,3440,3336,104,3
31037,6/1/19,5691,5517,174,3.1
31039,6/1/19,4876,4741,135,2.8
31041,6/1/19,6714,6546,168,2.5
31043,6/1/19,10897,10446,451,4.1
31045,6/1/19,5146,4951,195,3.8
31047,6/1/19,13416,12995,421,3.1
31049,6/1/19,1021,990,31,3
31051,6/1/19,3105,3004,101,3.3
31053,6/1/19,19702,19058,644,3.3
31055,6/1/19,301528,291011,10517,3.5
31057,6/1/19,1237,1205,32,2.6
31059,6/1/19,3309,3224,85,2.6
31061,6/1/19,1533,1483,50,3.3
31063,6/1/19,1645,1590,55,3.3
31065,6/1/19,2729,2645,84,3.1
31067,6/1/19,11248,10872,376,3.3
31069,6/1/19,1189,1160,29,2.4
31071,6/1/19,1245,1202,43,3.5
31073,6/1/19,1205,1169,36,3
31075,6/1/19,439,427,12,2.7
31077,6/1/19,1313,1272,41,3.1
31079,6/1/19,32319,31220,1099,3.4
31081,6/1/19,4881,4729,152,3.1
31083,6/1/19,1909,1856,53,2.8
31085,6/1/19,637,623,14,2.2
31087,6/1/19,1312,1269,43,3.3
31089,6/1/19,6056,5897,159,2.6
31091,6/1/19,481,467,14,2.9
31093,6/1/19,3424,3315,109,3.2
31095,6/1/19,4275,4147,128,3
31097,6/1/19,2097,2023,74,3.5
31099,6/1/19,3877,3778,99,2.6
31101,6/1/19,4865,4727,138,2.8
31103,6/1/19,608,593,15,2.5
31105,6/1/19,2070,2002,68,3.3
31107,6/1/19,4874,4732,142,2.9
31109,6/1/19,175493,169936,5557,3.2
31111,6/1/19,18636,17932,704,3.8
31113,6/1/19,494,480,14,2.8
31115,6/1/19,436,421,15,3.4
31117,6/1/19,448,431,17,3.8
31119,6/1/19,20024,19390,634,3.2
31121,6/1/19,4097,3971,126,3.1
31123,6/1/19,2709,2637,72,2.7
31125,6/1/19,2036,1983,53,2.6
31127,6/1/19,3567,3396,171,4.8
31129,6/1/19,2511,2443,68,2.7
31131,6/1/19,8592,8262,330,3.8
31133,6/1/19,1516,1463,53,3.5
31135,6/1/19,1900,1852,48,2.5
31137,6/1/19,5133,4983,150,2.9
31139,6/1/19,4252,4136,116,2.7
31141,6/1/19,17992,17423,569,3.2
31143,6/1/19,3068,2984,84,2.7
31145,6/1/19,5993,5793,200,3.3
31147,6/1/19,4389,4230,159,3.6
31149,6/1/19,912,886,26,2.9
31151,6/1/19,7524,7257,267,3.5
31153,6/1/19,97231,94142,3089,3.2
31155,6/1/19,11334,10989,345,3
31157,6/1/19,18592,17874,718,3.9
31159,6/1/19,8991,8656,335,3.7
31161,6/1/19,2791,2694,97,3.5
31163,6/1/19,1739,1684,55,3.2
31165,6/1/19,787,765,22,2.8
31167,6/1/19,3595,3496,99,2.8
31169,6/1/19,2879,2804,75,2.6
31171,6/1/19,437,423,14,3.2
31173,6/1/19,3097,2941,156,5
31175,6/1/19,2221,2146,75,3.4
31177,6/1/19,11397,11035,362,3.2
31179,6/1/19,5692,5490,202,3.5
31181,6/1/19,1772,1698,74,4.2
31183,6/1/19,626,609,17,2.7
31185,6/1/19,7485,7254,231,3.1
32001,6/1/19,11087,10689,398,3.6
32003,6/1/19,1130891,1081514,49377,4.4
32005,6/1/19,23627,22716,911,3.9
32007,6/1/19,27769,26942,827,3
32009,6/1/19,393,378,15,3.8
32011,6/1/19,1056,1030,26,2.5
32013,6/1/19,8241,7996,245,3
32015,6/1/19,3214,3113,101,3.1
32017,6/1/19,2097,2013,84,4
32019,6/1/19,23858,22763,1095,4.6
32021,6/1/19,2054,1969,85,4.1
32023,6/1/19,17521,16626,895,5.1
32027,6/1/19,2553,2452,101,4
32029,6/1/19,2039,1964,75,3.7
32031,6/1/19,255987,247685,8302,3.2
32033,6/1/19,4701,4550,151,3.2
32510,6/1/19,26575,25517,1058,4
33001,6/1/19,32901,32114,787,2.4
33003,6/1/19,24900,24277,623,2.5
33005,6/1/19,40455,39399,1056,2.6
33007,6/1/19,15041,14606,435,2.9
33009,6/1/19,49648,48543,1105,2.2
33011,6/1/19,244122,237812,6310,2.6
33013,6/1/19,84162,82283,1879,2.2
33015,6/1/19,191875,186869,5006,2.6
33017,6/1/19,74659,72951,1708,2.3
33019,6/1/19,23312,22780,532,2.3
34001,6/1/19,122278,116865,5413,4.4
34003,6/1/19,480430,467228,13202,2.7
34005,6/1/19,230268,223370,6898,3
34007,6/1/19,252607,243096,9511,3.8
34009,6/1/19,53261,51001,2260,4.2
34011,6/1/19,65373,62255,3118,4.8
34013,6/1/19,369369,353665,15704,4.3
34015,6/1/19,149552,144444,5108,3.4
34017,6/1/19,360305,348959,11346,3.1
34019,6/1/19,64637,63025,1612,2.5
34021,6/1/19,203279,197221,6058,3
34023,6/1/19,443802,431040,12762,2.9
34025,6/1/19,331536,321981,9555,2.9
34027,6/1/19,257095,250416,6679,2.6
34029,6/1/19,276901,267923,8978,3.2
34031,6/1/19,241053,231574,9479,3.9
34033,6/1/19,28929,27641,1288,4.5
34035,6/1/19,171791,166935,4856,2.8
34037,6/1/19,73952,71713,2239,3
34039,6/1/19,276658,267312,9346,3.4
34041,6/1/19,55732,54026,1706,3.1
35001,6/1/19,334800,317741,17059,5.1
35003,6/1/19,1192,1119,73,6.1
35005,6/1/19,27155,25589,1566,5.8
35006,6/1/19,9085,8435,650,7.2
35007,6/1/19,6291,5997,294,4.7
35009,6/1/19,21463,20431,1032,4.8
35011,6/1/19,809,767,42,5.2
35013,6/1/19,96906,90689,6217,6.4
35015,6/1/19,34206,33001,1205,3.5
35017,6/1/19,12121,11472,649,5.4
35019,6/1/19,1616,1518,98,6.1
35021,6/1/19,278,263,15,5.4
35023,6/1/19,2160,2064,96,4.4
35025,6/1/19,30990,29548,1442,4.7
35027,6/1/19,9378,8924,454,4.8
35028,6/1/19,9620,9269,351,3.6
35029,6/1/19,10691,9550,1141,10.7
35031,6/1/19,24154,22142,2012,8.3
35033,6/1/19,2287,2151,136,5.9
35035,6/1/19,24961,23536,1425,5.7
35037,6/1/19,3258,3059,199,6.1
35039,6/1/19,17119,16144,975,5.7
35041,6/1/19,7716,7284,432,5.6
35043,6/1/19,66906,63150,3756,5.6
35045,6/1/19,52329,48999,3330,6.4
35047,6/1/19,10726,10019,707,6.6
35049,6/1/19,75847,72434,3413,4.5
35051,6/1/19,3974,3702,272,6.8
35053,6/1/19,6517,6064,453,7
35055,6/1/19,15189,14194,995,6.6
35057,6/1/19,5662,5247,415,7.3
35059,6/1/19,1880,1811,69,3.7
35061,6/1/19,30926,29005,1921,6.2
36001,6/1/19,158236,152554,5682,3.6
36003,6/1/19,18809,17868,941,5
36005,6/1/19,594675,563955,30720,5.2
36007,6/1/19,84333,80533,3800,4.5
36009,6/1/19,33390,31877,1513,4.5
36011,6/1/19,36166,34762,1404,3.9
36013,6/1/19,54622,52255,2367,4.3
36015,6/1/19,35272,33816,1456,4.1
36017,6/1/19,22230,21346,884,4
36019,6/1/19,36204,34692,1512,4.2
36021,6/1/19,31555,30583,972,3.1
36023,6/1/19,22218,21219,999,4.5
36025,6/1/19,19222,18363,859,4.5
36027,6/1/19,144524,139370,5154,3.6
36029,6/1/19,442850,425191,17659,4
36031,6/1/19,17201,16505,696,4
36033,6/1/19,19601,18747,854,4.4
36035,6/1/19,22940,21910,1030,4.5
36037,6/1/19,30246,29236,1010,3.3
36039,6/1/19,20438,19603,835,4.1
36041,6/1/19,2333,2246,87,3.7
36043,6/1/19,28322,26766,1556,5.5
36045,6/1/19,44858,42816,2042,4.6
36047,6/1/19,1194038,1145881,48157,4
36049,6/1/19,11877,11368,509,4.3
36051,6/1/19,30749,29550,1199,3.9
36053,6/1/19,32772,31436,1336,4.1
36055,6/1/19,362903,348433,14470,4
36057,6/1/19,22470,21480,990,4.4
36059,6/1/19,717695,693683,24012,3.3
36061,6/1/19,908891,876886,32005,3.5
36063,6/1/19,98760,94450,4310,4.4
36065,6/1/19,101823,97681,4142,4.1
36067,6/1/19,221445,213175,8270,3.7
36069,6/1/19,55510,53492,2018,3.6
36071,6/1/19,186740,179869,6871,3.7
36073,6/1/19,17550,16806,744,4.2
36075,6/1/19,53034,50363,2671,5
36077,6/1/19,28435,27335,1100,3.9
36079,6/1/19,51363,49540,1823,3.5
36081,6/1/19,1135700,1096611,39089,3.4
36083,6/1/19,81388,78448,2940,3.6
36085,6/1/19,221573,213173,8400,3.8
36087,6/1/19,156705,151301,5404,3.4
36089,6/1/19,42674,40424,2250,5.3
36091,6/1/19,119284,115486,3798,3.2
36093,6/1/19,76346,73511,2835,3.7
36095,6/1/19,14590,13999,591,4.1
36097,6/1/19,8195,7883,312,3.8
36099,6/1/19,16148,15581,567,3.5
36101,6/1/19,42860,41124,1736,4.1
36103,6/1/19,787206,760302,26904,3.4
36105,6/1/19,37185,35844,1341,3.6
36107,6/1/19,22932,22027,905,3.9
36109,6/1/19,47722,45911,1811,3.8
36111,6/1/19,88443,85206,3237,3.7
36113,6/1/19,32284,31079,1205,3.7
36115,6/1/19,28681,27689,992,3.5
36117,6/1/19,43857,42268,1589,3.6
36119,6/1/19,488845,471000,17845,3.7
36121,6/1/19,18251,17617,634,3.5
36123,6/1/19,11805,11416,389,3.3
37001,6/1/19,82450,78976,3474,4.2
37003,6/1/19,18223,17557,666,3.7
37005,6/1/19,4462,4238,224,5
37007,6/1/19,10753,10286,467,4.3
37009,6/1/19,12727,12215,512,4
37011,6/1/19,7737,7433,304,3.9
37013,6/1/19,19617,18634,983,5
37015,6/1/19,7664,7260,404,5.3
37017,6/1/19,14501,13765,736,5.1
37019,6/1/19,56911,53943,2968,5.2
37021,6/1/19,142644,138002,4642,3.3
37023,6/1/19,41542,39858,1684,4.1
37025,6/1/19,110419,106249,4170,3.8
37027,6/1/19,37091,35452,1639,4.4
37029,6/1/19,4641,4444,197,4.2
37031,6/1/19,33554,32124,1430,4.3
37033,6/1/19,9861,9380,481,4.9
37035,6/1/19,80005,76894,3111,3.9
37037,6/1/19,35736,34381,1355,3.8
37039,6/1/19,11279,10736,543,4.8
37041,6/1/19,5584,5295,289,5.2
37043,6/1/19,4179,3968,211,5
37045,6/1/19,48652,46564,2088,4.3
37047,6/1/19,22841,21655,1186,5.2
37049,6/1/19,42775,40890,1885,4.4
37051,6/1/19,129667,122649,7018,5.4
37053,6/1/19,14286,13758,528,3.7
37055,6/1/19,22934,22071,863,3.8
37057,6/1/19,81962,78721,3241,4
37059,6/1/19,20909,20131,778,3.7
37061,6/1/19,25030,23911,1119,4.5
37063,6/1/19,171559,165113,6446,3.8
37065,6/1/19,21178,19832,1346,6.4
37067,6/1/19,190530,182735,7795,4.1
37069,6/1/19,31625,30246,1379,4.4
37071,6/1/19,112581,107932,4649,4.1
37073,6/1/19,5419,5180,239,4.4
37075,6/1/19,3359,3173,186,5.5
37077,6/1/19,30134,29027,1107,3.7
37079,6/1/19,9443,9027,416,4.4
37081,6/1/19,264926,253072,11854,4.5
37083,6/1/19,20630,19410,1220,5.9
37085,6/1/19,53836,51115,2721,5.1
37087,6/1/19,30424,29299,1125,3.7
37089,6/1/19,55947,53898,2049,3.7
37091,6/1/19,9183,8647,536,5.8
37093,6/1/19,20409,19330,1079,5.3
37095,6/1/19,2193,2059,134,6.1
37097,6/1/19,90623,87149,3474,3.8
37099,6/1/19,19916,19003,913,4.6
37101,6/1/19,100022,96049,3973,4
37103,6/1/19,4448,4263,185,4.2
37105,6/1/19,26155,24876,1279,4.9
37107,6/1/19,28181,27029,1152,4.1
37109,6/1/19,44045,42373,1672,3.8
37111,6/1/19,20938,20103,835,4
37113,6/1/19,16028,15371,657,4.1
37115,6/1/19,10333,9917,416,4
37117,6/1/19,8857,8352,505,5.7
37119,6/1/19,630348,605842,24506,3.9
37121,6/1/19,6026,5723,303,5
37123,6/1/19,11784,11276,508,4.3
37125,6/1/19,43357,41561,1796,4.1
37127,6/1/19,43155,40861,2294,5.3
37129,6/1/19,126056,121222,4834,3.8
37131,6/1/19,7828,7398,430,5.5
37133,6/1/19,65496,62245,3251,5
37135,6/1/19,79133,76191,2942,3.7
37137,6/1/19,5451,5226,225,4.1
37139,6/1/19,16764,15947,817,4.9
37141,6/1/19,29261,28038,1223,4.2
37143,6/1/19,4960,4691,269,5.4
37145,6/1/19,18468,17611,857,4.6
37147,6/1/19,89437,85042,4395,4.9
37149,6/1/19,9273,8890,383,4.1
37151,6/1/19,66748,63991,2757,4.1
37153,6/1/19,16645,15728,917,5.5
37155,6/1/19,50561,47647,2914,5.8
37157,6/1/19,40433,38533,1900,4.7
37159,6/1/19,67033,64205,2828,4.2
37161,6/1/19,25425,24099,1326,5.2
37163,6/1/19,28901,27650,1251,4.3
37165,6/1/19,11479,10693,786,6.8
37167,6/1/19,30627,29418,1209,3.9
37169,6/1/19,21993,21139,854,3.9
37171,6/1/19,34237,32908,1329,3.9
37173,6/1/19,7306,7016,290,4
37175,6/1/19,15252,14645,607,4
37177,6/1/19,1651,1566,85,5.1
37179,6/1/19,125444,120746,4698,3.7
37181,6/1/19,17705,16615,1090,6.2
37183,6/1/19,602050,580091,21959,3.6
37185,6/1/19,6749,6330,419,6.2
37187,6/1/19,4557,4284,273,6
37189,6/1/19,29364,28194,1170,4
37191,6/1/19,52481,50137,2344,4.5
37193,6/1/19,29189,27871,1318,4.5
37195,6/1/19,34953,32718,2235,6.4
37197,6/1/19,17921,17247,674,3.8
37199,6/1/19,8455,8106,349,4.1
38001,6/1/19,1078,1056,22,2
38003,6/1/19,5287,5047,240,4.5
38005,6/1/19,2218,2111,107,4.8
38007,6/1/19,554,544,10,1.8
38009,6/1/19,3100,2994,106,3.4
38011,6/1/19,1807,1779,28,1.5
38013,6/1/19,1069,1042,27,2.5
38015,6/1/19,50180,48920,1260,2.5
38017,6/1/19,103211,100966,2245,2.2
38019,6/1/19,1947,1890,57,2.9
38021,6/1/19,2389,2338,51,2.1
38023,6/1/19,1486,1465,21,1.4
38025,6/1/19,3336,3278,58,1.7
38027,6/1/19,1319,1259,60,4.5
38029,6/1/19,1473,1419,54,3.7
38031,6/1/19,1553,1507,46,3
38033,6/1/19,877,861,16,1.8
38035,6/1/19,37500,36545,955,2.5
38037,6/1/19,1203,1178,25,2.1
38039,6/1/19,1039,1008,31,3
38041,6/1/19,1414,1387,27,1.9
38043,6/1/19,1318,1266,52,3.9
38045,6/1/19,2095,2046,49,2.3
38047,6/1/19,863,841,22,2.5
38049,6/1/19,3096,2993,103,3.3
38051,6/1/19,1164,1125,39,3.4
38053,6/1/19,10651,10468,183,1.7
38055,6/1/19,4921,4762,159,3.2
38057,6/1/19,3789,3633,156,4.1
38059,6/1/19,16509,16014,495,3
38061,6/1/19,7484,7368,116,1.5
38063,6/1/19,1437,1386,51,3.5
38065,6/1/19,884,848,36,4.1
38067,6/1/19,3423,3265,158,4.6
38069,6/1/19,1783,1719,64,3.6
38071,6/1/19,5699,5522,177,3.1
38073,6/1/19,2873,2818,55,1.9
38075,6/1/19,1188,1157,31,2.6
38077,6/1/19,8761,8524,237,2.7
38079,6/1/19,4868,4267,601,12.3
38081,6/1/19,2747,2692,55,2
38083,6/1/19,701,679,22,3.1
38085,6/1/19,1270,1210,60,4.7
38087,6/1/19,406,396,10,2.5
38089,6/1/19,19123,18697,426,2.2
38091,6/1/19,999,971,28,2.8
38093,6/1/19,10412,10144,268,2.6
38095,6/1/19,1195,1158,37,3.1
38097,6/1/19,4415,4250,165,3.7
38099,6/1/19,5416,5193,223,4.1
38101,6/1/19,32216,31392,824,2.6
38103,6/1/19,1944,1887,57,2.9
38105,6/1/19,24984,24481,503,2
39001,6/1/19,10810,10102,708,6.5
39003,6/1/19,48341,46275,2066,4.3
39005,6/1/19,26963,25861,1102,4.1
39007,6/1/19,45020,42922,2098,4.7
39009,6/1/19,25121,23493,1628,6.5
39011,6/1/19,25278,24466,812,3.2
39013,6/1/19,30443,28906,1537,5
39015,6/1/19,19746,18763,983,5
39017,6/1/19,197696,189347,8349,4.2
39019,6/1/19,12972,12364,608,4.7
39021,6/1/19,20131,19373,758,3.8
39023,6/1/19,63496,60702,2794,4.4
39025,6/1/19,108143,103738,4405,4.1
39027,6/1/19,17710,16836,874,4.9
39029,6/1/19,47719,45340,2379,5
39031,6/1/19,14545,13685,860,5.9
39033,6/1/19,18509,17622,887,4.8
39035,6/1/19,620557,591254,29303,4.7
39037,6/1/19,26138,25166,972,3.7
39039,6/1/19,18158,17344,814,4.5
39041,6/1/19,110875,107035,3840,3.5
39043,6/1/19,39383,37733,1650,4.2
39045,6/1/19,78250,75164,3086,3.9
39047,6/1/19,13903,13325,578,4.2
39049,6/1/19,700851,674059,26792,3.8
39051,6/1/19,22436,21541,895,4
39053,6/1/19,11952,11302,650,5.4
39055,6/1/19,49652,47731,1921,3.9
39057,6/1/19,83714,80258,3456,4.1
39059,6/1/19,18797,17853,944,5
39061,6/1/19,421382,403937,17445,4.1
39063,6/1/19,42158,40710,1448,3.4
39065,6/1/19,13611,12954,657,4.8
39067,6/1/19,6905,6562,343,5
39069,6/1/19,13302,12737,565,4.2
39071,6/1/19,16972,16070,902,5.3
39073,6/1/19,13068,12504,564,4.3
39075,6/1/19,21070,20378,692,3.3
39077,6/1/19,28419,27031,1388,4.9
39079,6/1/19,12672,11904,768,6.1
39081,6/1/19,27922,26277,1645,5.9
39083,6/1/19,31419,30082,1337,4.3
39085,6/1/19,127788,122485,5303,4.1
39087,6/1/19,23827,22519,1308,5.5
39089,6/1/19,90849,87234,3615,4
39091,6/1/19,22998,22147,851,3.7
39093,6/1/19,155363,148071,7292,4.7
39095,6/1/19,210712,201037,9675,4.6
39097,6/1/19,20814,20064,750,3.6
39099,6/1/19,104106,98004,6102,5.9
39101,6/1/19,28596,27363,1233,4.3
39103,6/1/19,98656,94826,3830,3.9
39105,6/1/19,8888,8280,608,6.8
39107,6/1/19,23939,23266,673,2.8
39109,6/1/19,54270,52193,2077,3.8
39111,6/1/19,5298,4892,406,7.7
39113,6/1/19,253849,242475,11374,4.5
39115,6/1/19,6775,6402,373,5.5
39117,6/1/19,16834,16135,699,4.2
39119,6/1/19,39704,37811,1893,4.8
39121,6/1/19,4729,4418,311,6.6
39123,6/1/19,22391,21452,939,4.2
39125,6/1/19,8637,8276,361,4.2
39127,6/1/19,15879,15091,788,5
39129,6/1/19,26500,25404,1096,4.1
39131,6/1/19,10906,10244,662,6.1
39133,6/1/19,87588,83796,3792,4.3
39135,6/1/19,21283,20462,821,3.9
39137,6/1/19,19084,18482,602,3.2
39139,6/1/19,52970,50577,2393,4.5
39141,6/1/19,35546,34012,1534,4.3
39143,6/1/19,30841,29619,1222,4
39145,6/1/19,28798,26988,1810,6.3
39147,6/1/19,27477,26325,1152,4.2
39149,6/1/19,24589,23673,916,3.7
39151,6/1/19,186606,178259,8347,4.5
39153,6/1/19,273467,261277,12190,4.5
39155,6/1/19,87620,82145,5475,6.2
39157,6/1/19,45811,43889,1922,4.2
39159,6/1/19,29021,28028,993,3.4
39161,6/1/19,15239,14716,523,3.4
39163,6/1/19,5541,5263,278,5
39165,6/1/19,120607,115995,4612,3.8
39167,6/1/19,27736,26287,1449,5.2
39169,6/1/19,62355,60205,2150,3.4
39171,6/1/19,19205,18553,652,3.4
39173,6/1/19,71554,68732,2822,3.9
39175,6/1/19,13069,12663,406,3.1
40001,6/1/19,8010,7648,362,4.5
40003,6/1/19,2771,2715,56,2
40005,6/1/19,4904,4667,237,4.8
40007,6/1/19,2855,2795,60,2.1
40009,6/1/19,10641,10330,311,2.9
40011,6/1/19,4870,4760,110,2.3
40013,6/1/19,22013,21277,736,3.3
40015,6/1/19,11488,11034,454,4
40017,6/1/19,74420,72148,2272,3.1
40019,6/1/19,22015,21229,786,3.6
40021,6/1/19,18823,17935,888,4.7
40023,6/1/19,5397,5113,284,5.3
40025,6/1/19,1277,1251,26,2
40027,6/1/19,143547,139056,4491,3.1
40029,6/1/19,2472,2368,104,4.2
40031,6/1/19,48776,46885,1891,3.9
40033,6/1/19,2733,2642,91,3.3
40035,6/1/19,6047,5827,220,3.6
40037,6/1/19,32002,30763,1239,3.9
40039,6/1/19,15895,15461,434,2.7
40041,6/1/19,18465,17747,718,3.9
40043,6/1/19,2931,2862,69,2.4
40045,6/1/19,2151,2097,54,2.5
40047,6/1/19,27237,26375,862,3.2
40049,6/1/19,12492,12083,409,3.3
40051,6/1/19,26494,25648,846,3.2
40053,6/1/19,2649,2585,64,2.4
40055,6/1/19,1852,1768,84,4.5
40057,6/1/19,1199,1161,38,3.2
40059,6/1/19,1647,1591,56,3.4
40061,6/1/19,4220,3990,230,5.5
40063,6/1/19,5205,4902,303,5.8
40065,6/1/19,10796,10460,336,3.1
40067,6/1/19,2487,2395,92,3.7
40069,6/1/19,3836,3666,170,4.4
40071,6/1/19,18558,17690,868,4.7
40073,6/1/19,9285,9074,211,2.3
40075,6/1/19,3386,3250,136,4
40077,6/1/19,3191,2987,204,6.4
40079,6/1/19,19284,18286,998,5.2
40081,6/1/19,15832,15237,595,3.8
40083,6/1/19,22151,21447,704,3.2
40085,6/1/19,6188,6034,154,2.5
40087,6/1/19,19648,19082,566,2.9
40089,6/1/19,14288,13395,893,6.3
40091,6/1/19,7158,6723,435,6.1
40093,6/1/19,3857,3773,84,2.2
40095,6/1/19,7069,6820,249,3.5
40097,6/1/19,19541,18848,693,3.5
40099,6/1/19,6514,6326,188,2.9
40101,6/1/19,29814,28505,1309,4.4
40103,6/1/19,5734,5583,151,2.6
40105,6/1/19,4655,4485,170,3.7
40107,6/1/19,4671,4434,237,5.1
40109,6/1/19,386512,373465,13047,3.4
40111,6/1/19,15889,15055,834,5.2
40113,6/1/19,20902,20062,840,4
40115,6/1/19,14150,13609,541,3.8
40117,6/1/19,7442,7131,311,4.2
40119,6/1/19,37929,36630,1299,3.4
40121,6/1/19,17139,16403,736,4.3
40123,6/1/19,18903,18304,599,3.2
40125,6/1/19,32595,31332,1263,3.9
40127,6/1/19,4126,3894,232,5.6
40129,6/1/19,1828,1774,54,3
40131,6/1/19,45637,44127,1510,3.3
40133,6/1/19,9420,8933,487,5.2
40135,6/1/19,16341,15642,699,4.3
40137,6/1/19,18789,17959,830,4.4
40139,6/1/19,11151,10903,248,2.2
40141,6/1/19,2898,2795,103,3.6
40143,6/1/19,327477,316630,10847,3.3
40145,6/1/19,38387,37151,1236,3.2
40147,6/1/19,22631,21787,844,3.7
40149,6/1/19,5183,5012,171,3.3
40151,6/1/19,4525,4419,106,2.3
40153,6/1/19,9154,8900,254,2.8
41001,6/1/19,7131,6821,310,4.3
41003,6/1/19,49120,47477,1643,3.3
41005,6/1/19,219038,210926,8112,3.7
41007,6/1/19,19754,19002,752,3.8
41009,6/1/19,24367,23217,1150,4.7
41011,6/1/19,26340,24988,1352,5.1
41013,6/1/19,9751,9257,494,5.1
41015,6/1/19,9034,8569,465,5.1
41017,6/1/19,97100,93317,3783,3.9
41019,6/1/19,46356,44006,2350,5.1
41021,6/1/19,1006,971,35,3.5
41023,6/1/19,3324,3166,158,4.8
41025,6/1/19,3597,3439,158,4.4
41027,6/1/19,14539,14065,474,3.3
41029,6/1/19,103596,98781,4815,4.6
41031,6/1/19,10410,9940,470,4.5
41033,6/1/19,36143,34309,1834,5.1
41035,6/1/19,29637,28006,1631,5.5
41037,6/1/19,3656,3480,176,4.8
41039,6/1/19,181181,173266,7915,4.4
41041,6/1/19,21539,20583,956,4.4
41043,6/1/19,58902,56215,2687,4.6
41045,6/1/19,12469,11941,528,4.2
41047,6/1/19,163663,156829,6834,4.2
41049,6/1/19,5828,5587,241,4.1
41051,6/1/19,453924,437777,16147,3.6
41053,6/1/19,40093,38336,1757,4.4
41055,6/1/19,942,911,31,3.3
41057,6/1/19,12094,11610,484,4
41059,6/1/19,37683,36089,1594,4.2
41061,6/1/19,12077,11522,555,4.6
41063,6/1/19,3534,3363,171,4.8
41065,6/1/19,15604,15044,560,3.6
41067,6/1/19,324809,313746,11063,3.4
41069,6/1/19,726,690,36,5
41071,6/1/19,54976,52931,2045,3.7
42001,6/1/19,55868,53961,1907,3.4
42003,6/1/19,652083,624380,27703,4.2
42005,6/1/19,32395,30858,1537,4.7
42007,6/1/19,84481,80618,3863,4.6
42009,6/1/19,24089,23060,1029,4.3
42011,6/1/19,217595,207923,9672,4.4
42013,6/1/19,60402,57582,2820,4.7
42015,6/1/19,29582,28369,1213,4.1
42017,6/1/19,346920,334069,12851,3.7
42019,6/1/19,100429,96501,3928,3.9
42021,6/1/19,58485,55066,3419,5.8
42023,6/1/19,2140,2036,104,4.9
42025,6/1/19,32351,30680,1671,5.2
42027,6/1/19,76322,73570,2752,3.6
42029,6/1/19,291026,281578,9448,3.2
42031,6/1/19,17065,16271,794,4.7
42033,6/1/19,35935,34180,1755,4.9
42035,6/1/19,18323,17370,953,5.2
42037,6/1/19,33319,31677,1642,4.9
42039,6/1/19,39331,37442,1889,4.8
42041,6/1/19,133902,129121,4781,3.6
42043,6/1/19,145902,139768,6134,4.2
42045,6/1/19,299286,287011,12275,4.1
42047,6/1/19,16003,15240,763,4.8
42049,6/1/19,129310,123285,6025,4.7
42051,6/1/19,57390,54099,3291,5.7
42053,6/1/19,1871,1739,132,7.1
42055,6/1/19,78317,75320,2997,3.8
42057,6/1/19,8086,7778,308,3.8
42059,6/1/19,16542,15662,880,5.3
42061,6/1/19,20105,19077,1028,5.1
42063,6/1/19,38553,36460,2093,5.4
42065,6/1/19,20887,19965,922,4.4
42067,6/1/19,12939,12395,544,4.2
42069,6/1/19,104990,99846,5144,4.9
42071,6/1/19,288734,278302,10432,3.6
42073,6/1/19,41142,39183,1959,4.8
42075,6/1/19,73742,70822,2920,4
42077,6/1/19,194013,185385,8628,4.4
42079,6/1/19,157176,148420,8756,5.6
42081,6/1/19,56896,54268,2628,4.6
42083,6/1/19,17591,16698,893,5.1
42085,6/1/19,49835,47339,2496,5
42087,6/1/19,21323,20348,975,4.6
42089,6/1/19,83661,79212,4449,5.3
42091,6/1/19,458829,442818,16011,3.5
42093,6/1/19,9054,8721,333,3.7
42095,6/1/19,162604,155257,7347,4.5
42097,6/1/19,43865,41511,2354,5.4
42099,6/1/19,24968,24025,943,3.8
42101,6/1/19,716485,675677,40808,5.7
42103,6/1/19,25612,24285,1327,5.2
42105,6/1/19,7340,6989,351,4.8
42107,6/1/19,67491,63850,3641,5.4
42109,6/1/19,20160,18772,1388,6.9
42111,6/1/19,33944,32234,1710,5
42113,6/1/19,2767,2638,129,4.7
42115,6/1/19,20876,20072,804,3.9
42117,6/1/19,19376,18414,962,5
42119,6/1/19,19514,18627,887,4.5
42121,6/1/19,22857,21748,1109,4.9
42123,6/1/19,19233,18394,839,4.4
42125,6/1/19,107642,102833,4809,4.5
42127,6/1/19,22649,21731,918,4.1
42129,6/1/19,182415,173866,8549,4.7
42131,6/1/19,13644,13008,636,4.7
42133,6/1/19,237121,227435,9686,4.1
44001,6/1/19,26095,25364,731,2.8
44003,6/1/19,91005,88293,2712,3
44005,6/1/19,44286,43139,1147,2.6
44007,6/1/19,326786,314632,12154,3.7
44009,6/1/19,69587,67685,1902,2.7
45001,6/1/19,10100,9727,373,3.7
45003,6/1/19,75459,72971,2488,3.3
45005,6/1/19,2686,2535,151,5.6
45007,6/1/19,92161,89343,2818,3.1
45009,6/1/19,4972,4653,319,6.4
45011,6/1/19,8319,7937,382,4.6
45013,6/1/19,79798,77422,2376,3
45015,6/1/19,105576,102625,2951,2.8
45017,6/1/19,6623,6362,261,3.9
45019,6/1/19,214938,209468,5470,2.5
45021,6/1/19,25453,24566,887,3.5
45023,6/1/19,13560,12934,626,4.6
45025,6/1/19,22266,21562,704,3.2
45027,6/1/19,12874,12322,552,4.3
45029,6/1/19,17030,16432,598,3.5
45031,6/1/19,30849,29652,1197,3.9
45033,6/1/19,13136,12590,546,4.2
45035,6/1/19,79315,77133,2182,2.8
45037,6/1/19,10798,10459,339,3.1
45039,6/1/19,9629,9180,449,4.7
45041,6/1/19,67867,65673,2194,3.2
45043,6/1/19,26658,25673,985,3.7
45045,6/1/19,257323,250340,6983,2.7
45047,6/1/19,31488,30385,1103,3.5
45049,6/1/19,8496,8219,277,3.3
45051,6/1/19,155817,150374,5443,3.5
45053,6/1/19,13054,12672,382,2.9
45055,6/1/19,29367,28391,976,3.3
45057,6/1/19,41636,40139,1497,3.6
45059,6/1/19,30490,29497,993,3.3
45061,6/1/19,6607,6319,288,4.4
45063,6/1/19,150546,146559,3987,2.6
45065,6/1/19,3427,3321,106,3.1
45067,6/1/19,13208,12619,589,4.5
45069,6/1/19,9197,8750,447,4.9
45071,6/1/19,19296,18740,556,2.9
45073,6/1/19,35304,34181,1123,3.2
45075,6/1/19,35014,33310,1704,4.9
45077,6/1/19,58131,56250,1881,3.2
45079,6/1/19,199511,193156,6355,3.2
45081,6/1/19,8922,8655,267,3
45083,6/1/19,154298,149693,4605,3
45085,6/1/19,44112,42449,1663,3.8
45087,6/1/19,11735,11289,446,3.8
45089,6/1/19,12264,11674,590,4.8
45091,6/1/19,141589,137287,4302,3
46003,6/1/19,1569,1530,39,2.5
46005,6/1/19,9919,9639,280,2.8
46007,6/1/19,1076,1015,61,5.7
46009,6/1/19,2943,2855,88,3
46011,6/1/19,18879,18221,658,3.5
46013,6/1/19,21026,20391,635,3
46015,6/1/19,2544,2461,83,3.3
46017,6/1/19,697,639,58,8.3
46019,6/1/19,5122,4961,161,3.1
46021,6/1/19,788,759,29,3.7
46023,6/1/19,3892,3741,151,3.9
46025,6/1/19,1984,1908,76,3.8
46027,6/1/19,7017,6755,262,3.7
46029,6/1/19,15652,15188,464,3
46031,6/1/19,1367,1272,95,6.9
46033,6/1/19,4081,3921,160,3.9
46035,6/1/19,11286,10978,308,2.7
46037,6/1/19,2841,2741,100,3.5
46039,6/1/19,2235,2152,83,3.7
46041,6/1/19,2302,2054,248,10.8
46043,6/1/19,1605,1566,39,2.4
46045,6/1/19,2050,1987,63,3.1
46047,6/1/19,3178,3049,129,4.1
46049,6/1/19,1085,1049,36,3.3
46051,6/1/19,4508,4384,124,2.8
46053,6/1/19,2085,2020,65,3.1
46055,6/1/19,1058,1029,29,2.7
46057,6/1/19,3395,3296,99,2.9
46059,6/1/19,1802,1754,48,2.7
46061,6/1/19,1757,1684,73,4.2
46063,6/1/19,729,709,20,2.7
46065,6/1/19,10367,10105,262,2.5
46067,6/1/19,3639,3542,97,2.7
46069,6/1/19,676,654,22,3.3
46071,6/1/19,1392,1327,65,4.7
46073,6/1/19,1134,1103,31,2.7
46075,6/1/19,573,558,15,2.6
46077,6/1/19,2758,2678,80,2.9
46079,6/1/19,6669,6436,233,3.5
46081,6/1/19,13694,13264,430,3.1
46083,6/1/19,34927,34049,878,2.5
46085,6/1/19,1752,1665,87,5
46087,6/1/19,3078,3002,76,2.5
46089,6/1/19,998,961,37,3.7
46091,6/1/19,2478,2395,83,3.3
46093,6/1/19,14573,14082,491,3.4
46095,6/1/19,735,693,42,5.7
46097,6/1/19,1190,1156,34,2.9
46099,6/1/19,114080,111003,3077,2.7
46101,6/1/19,4152,3967,185,4.5
46102,6/1/19,3583,3179,404,11.3
46103,6/1/19,58645,56745,1900,3.2
46105,6/1/19,1443,1397,46,3.2
46107,6/1/19,1084,1052,32,3
46109,6/1/19,4875,4690,185,3.8
46111,6/1/19,1175,1138,37,3.1
46115,6/1/19,3261,3162,99,3
46117,6/1/19,1890,1842,48,2.5
46119,6/1/19,808,786,22,2.7
46121,6/1/19,3144,2915,229,7.3
46123,6/1/19,3100,3017,83,2.7
46125,6/1/19,4712,4579,133,2.8
46127,6/1/19,8496,8205,291,3.4
46129,6/1/19,2181,2067,114,5.2
46135,6/1/19,12213,11877,336,2.8
46137,6/1/19,951,881,70,7.4
47001,6/1/19,35271,33774,1497,4.2
47003,6/1/19,21393,20446,947,4.4
47005,6/1/19,6957,6580,377,5.4
47007,6/1/19,4235,3971,264,6.2
47009,6/1/19,64508,62136,2372,3.7
47011,6/1/19,52261,50115,2146,4.1
47013,6/1/19,15101,14304,797,5.3
47015,6/1/19,6763,6506,257,3.8
47017,6/1/19,12208,11497,711,5.8
47019,6/1/19,24039,22916,1123,4.7
47021,6/1/19,22394,21694,700,3.1
47023,6/1/19,8758,8402,356,4.1
47025,6/1/19,13240,12576,664,5
47027,6/1/19,2709,2519,190,7
47029,6/1/19,15468,14732,736,4.8
47031,6/1/19,26195,25197,998,3.8
47033,6/1/19,7101,6833,268,3.8
47035,6/1/19,23605,22488,1117,4.7
47037,6/1/19,413898,401887,12011,2.9
47039,6/1/19,4636,4376,260,5.6
47041,6/1/19,7946,7569,377,4.7
47043,6/1/19,27676,26734,942,3.4
47045,6/1/19,16431,15509,922,5.6
47047,6/1/19,19467,18681,786,4
47049,6/1/19,7487,7124,363,4.8
47051,6/1/19,20421,19619,802,3.9
47053,6/1/19,22288,21257,1031,4.6
47055,6/1/19,15179,14538,641,4.2
47057,6/1/19,9661,9207,454,4.7
47059,6/1/19,30177,28669,1508,5
47061,6/1/19,4895,4658,237,4.8
47063,6/1/19,28519,27256,1263,4.4
47065,6/1/19,188207,181134,7073,3.8
47067,6/1/19,2081,1930,151,7.3
47069,6/1/19,9636,9151,485,5
47071,6/1/19,10588,10055,533,5
47073,6/1/19,24272,23137,1135,4.7
47075,6/1/19,7685,7270,415,5.4
47077,6/1/19,12416,11842,574,4.6
47079,6/1/19,14389,13750,639,4.4
47081,6/1/19,11691,11281,410,3.5
47083,6/1/19,3237,3067,170,5.3
47085,6/1/19,8954,8566,388,4.3
47087,6/1/19,4670,4430,240,5.1
47089,6/1/19,24904,23850,1054,4.2
47091,6/1/19,7670,7378,292,3.8
47093,6/1/19,248268,239537,8731,3.5
47095,6/1/19,1772,1664,108,6.1
47097,6/1/19,9789,9201,588,6
47099,6/1/19,19442,18548,894,4.6
47101,6/1/19,5179,4953,226,4.4
47103,6/1/19,16982,16369,613,3.6
47105,6/1/19,23815,22871,944,4
47107,6/1/19,24199,23142,1057,4.4
47109,6/1/19,8457,7978,479,5.7
47111,6/1/19,11493,11061,432,3.8
47113,6/1/19,50232,48175,2057,4.1
47115,6/1/19,12787,12169,618,4.8
47117,6/1/19,15883,15289,594,3.7
47119,6/1/19,50432,48830,1602,3.2
47121,6/1/19,5225,4949,276,5.3
47123,6/1/19,20527,19630,897,4.4
47125,6/1/19,86436,82637,3799,4.4
47127,6/1/19,3619,3497,122,3.4
47129,6/1/19,8035,7636,399,5
47131,6/1/19,12646,11983,663,5.2
47133,6/1/19,10089,9655,434,4.3
47135,6/1/19,3165,3006,159,5
47137,6/1/19,2447,2336,111,4.5
47139,6/1/19,7549,7189,360,4.8
47141,6/1/19,35136,33645,1491,4.2
47143,6/1/19,13228,12353,875,6.6
47145,6/1/19,23825,22691,1134,4.8
47147,6/1/19,38879,37570,1309,3.4
47149,6/1/19,188820,183023,5797,3.1
47151,6/1/19,8593,8144,449,5.2
47153,6/1/19,6329,6031,298,4.7
47155,6/1/19,57240,55512,1728,3
47157,6/1/19,455281,434222,21059,4.6
47159,6/1/19,9673,9331,342,3.5
47161,6/1/19,5553,5283,270,4.9
47163,6/1/19,71899,68775,3124,4.3
47165,6/1/19,104784,101580,3204,3.1
47167,6/1/19,28749,27464,1285,4.5
47169,6/1/19,5560,5356,204,3.7
47171,6/1/19,7082,6691,391,5.5
47173,6/1/19,7780,7389,391,5
47175,6/1/19,2080,1969,111,5.3
47177,6/1/19,16947,16105,842,5
47179,6/1/19,60478,58012,2466,4.1
47181,6/1/19,6304,5995,309,4.9
47183,6/1/19,15919,15149,770,4.8
47185,6/1/19,12317,11805,512,4.2
47187,6/1/19,131490,127678,3812,2.9
47189,6/1/19,78503,76032,2471,3.1
48001,6/1/19,23816,23095,721,3
48003,6/1/19,9923,9682,241,2.4
48005,6/1/19,35743,34230,1513,4.2
48007,6/1/19,9409,8986,423,4.5
48009,6/1/19,4147,4021,126,3
48011,6/1/19,927,901,26,2.8
48013,6/1/19,21671,20844,827,3.8
48015,6/1/19,14073,13556,517,3.7
48017,6/1/19,2601,2487,114,4.4
48019,6/1/19,10027,9700,327,3.3
48021,6/1/19,42906,41468,1438,3.4
48023,6/1/19,1780,1740,40,2.2
48025,6/1/19,9804,9365,439,4.5
48027,6/1/19,143150,137350,5800,4.1
48029,6/1/19,947725,916137,31588,3.3
48031,6/1/19,6492,6321,171,2.6
48033,6/1/19,384,375,9,2.3
48035,6/1/19,8388,8089,299,3.6
48037,6/1/19,40175,38301,1874,4.7
48039,6/1/19,179125,171317,7808,4.4
48041,6/1/19,114860,111258,3602,3.1
48043,6/1/19,4167,4029,138,3.3
48045,6/1/19,595,574,21,3.5
48047,6/1/19,2586,2435,151,5.8
48049,6/1/19,15535,14898,637,4.1
48051,6/1/19,8063,7798,265,3.3
48053,6/1/19,23623,22955,668,2.8
48055,6/1/19,19667,18947,720,3.7
48057,6/1/19,12282,11859,423,3.4
48059,6/1/19,6071,5869,202,3.3
48061,6/1/19,167285,157622,9663,5.8
48063,6/1/19,4995,4782,213,4.3
48065,6/1/19,3004,2922,82,2.7
48067,6/1/19,12425,11864,561,4.5
48069,6/1/19,3484,3375,109,3.1
48071,6/1/19,19482,18528,954,4.9
48073,6/1/19,20866,20057,809,3.9
48075,6/1/19,2986,2904,82,2.7
48077,6/1/19,4947,4780,167,3.4
48079,6/1/19,1134,1090,44,3.9
48081,6/1/19,1471,1418,53,3.6
48083,6/1/19,2901,2779,122,4.2
48085,6/1/19,562303,543933,18370,3.3
48087,6/1/19,1205,1167,38,3.2
48089,6/1/19,10002,9684,318,3.2
48091,6/1/19,73169,70845,2324,3.2
48093,6/1/19,5605,5420,185,3.3
48095,6/1/19,1250,1205,45,3.6
48097,6/1/19,19962,19376,586,2.9
48099,6/1/19,24018,23002,1016,4.2
48101,6/1/19,557,535,22,3.9
48103,6/1/19,1594,1527,67,4.2
48105,6/1/19,1660,1614,46,2.8
48107,6/1/19,2502,2391,111,4.4
48109,6/1/19,1060,1011,49,4.6
48111,6/1/19,3925,3838,87,2.2
48113,6/1/19,1361272,1311628,49644,3.6
48115,6/1/19,4599,4412,187,4.1
48117,6/1/19,8505,8240,265,3.1
48119,6/1/19,2429,2348,81,3.3
48121,6/1/19,493353,477944,15409,3.1
48123,6/1/19,9742,9467,275,2.8
48125,6/1/19,704,674,30,4.3
48127,6/1/19,7390,7173,217,2.9
48129,6/1/19,1487,1430,57,3.8
48131,6/1/19,4995,4763,232,4.6
48133,6/1/19,8285,7977,308,3.7
48135,6/1/19,87649,85252,2397,2.7
48137,6/1/19,1051,1026,25,2.4
48139,6/1/19,92544,89425,3119,3.4
48141,6/1/19,358241,343708,14533,4.1
48143,6/1/19,20476,19764,712,3.5
48145,6/1/19,6568,6339,229,3.5
48147,6/1/19,17318,16826,492,2.8
48149,6/1/19,12545,12185,360,2.9
48151,6/1/19,1660,1602,58,3.5
48153,6/1/19,2605,2493,112,4.3
48155,6/1/19,568,549,19,3.3
48157,6/1/19,391307,377071,14236,3.6
48159,6/1/19,4735,4559,176,3.7
48161,6/1/19,6415,6099,316,4.9
48163,6/1/19,10476,10162,314,3
48165,6/1/19,9844,9585,259,2.6
48167,6/1/19,165031,158148,6883,4.2
48169,6/1/19,2180,2116,64,2.9
48171,6/1/19,13736,13387,349,2.5
48173,6/1/19,814,794,20,2.5
48175,6/1/19,3256,3145,111,3.4
48177,6/1/19,9562,9295,267,2.8
48179,6/1/19,8127,7832,295,3.6
48181,6/1/19,64188,62126,2062,3.2
48183,6/1/19,58138,55894,2244,3.9
48185,6/1/19,11207,10716,491,4.4
48187,6/1/19,81344,78787,2557,3.1
48189,6/1/19,12243,11591,652,5.3
48191,6/1/19,1089,1043,46,4.2
48193,6/1/19,3705,3590,115,3.1
48195,6/1/19,2820,2747,73,2.6
48197,6/1/19,1734,1681,53,3.1
48199,6/1/19,25239,23990,1249,4.9
48201,6/1/19,2311453,2219138,92315,4
48203,6/1/19,29302,28100,1202,4.1
48205,6/1/19,2808,2759,49,1.7
48207,6/1/19,2288,2210,78,3.4
48209,6/1/19,119688,116183,3505,2.9
48211,6/1/19,2023,1965,58,2.9
48213,6/1/19,36691,35317,1374,3.7
48215,6/1/19,351385,328474,22911,6.5
48217,6/1/19,16330,15753,577,3.5
48219,6/1/19,11247,10876,371,3.3
48221,6/1/19,27462,26475,987,3.6
48223,6/1/19,17535,16986,549,3.1
48225,6/1/19,10439,10079,360,3.4
48227,6/1/19,14059,13595,464,3.3
48229,6/1/19,1807,1726,81,4.5
48231,6/1/19,43331,41685,1646,3.8
48233,6/1/19,8837,8433,404,4.6
48235,6/1/19,757,738,19,2.5
48237,6/1/19,3505,3396,109,3.1
48239,6/1/19,7607,7362,245,3.2
48241,6/1/19,12853,12042,811,6.3
48243,6/1/19,1062,1034,28,2.6
48245,6/1/19,106609,100036,6573,6.2
48247,6/1/19,1855,1761,94,5.1
48249,6/1/19,16974,16132,842,5
48251,6/1/19,81925,79106,2819,3.4
48253,6/1/19,5702,5447,255,4.5
48255,6/1/19,7170,6981,189,2.6
48257,6/1/19,64463,62219,2244,3.5
48259,6/1/19,22075,21440,635,2.9
48261,6/1/19,235,227,8,3.4
48263,6/1/19,488,476,12,2.5
48265,6/1/19,22332,21645,687,3.1
48267,6/1/19,1914,1852,62,3.2
48269,6/1/19,231,226,5,2.2
48271,6/1/19,1390,1341,49,3.5
48273,6/1/19,13321,12692,629,4.7
48275,6/1/19,1460,1412,48,3.3
48277,6/1/19,23784,22952,832,3.5
48279,6/1/19,5330,5116,214,4
48281,6/1/19,9162,8843,319,3.5
48283,6/1/19,4335,4229,106,2.4
48285,6/1/19,8695,8413,282,3.2
48287,6/1/19,10166,9880,286,2.8
48289,6/1/19,6339,6047,292,4.6
48291,6/1/19,33081,31302,1779,5.4
48293,6/1/19,8608,8255,353,4.1
48295,6/1/19,1656,1607,49,3
48297,6/1/19,5566,5379,187,3.4
48299,6/1/19,8764,8457,307,3.5
48301,6/1/19,584,580,4,0.7
48303,6/1/19,157835,152715,5120,3.2
48305,6/1/19,2769,2679,90,3.3
48307,6/1/19,3433,3221,212,6.2
48309,6/1/19,119667,115288,4379,3.7
48311,6/1/19,784,773,11,1.4
48313,6/1/19,4548,4320,228,5
48315,6/1/19,4217,4041,176,4.2
48317,6/1/19,2883,2806,77,2.7
48319,6/1/19,1816,1755,61,3.4
48321,6/1/19,16747,15743,1004,6
48323,6/1/19,23888,22080,1808,7.6
48325,6/1/19,21777,21062,715,3.3
48327,6/1/19,867,835,32,3.7
48329,6/1/19,107232,104944,2288,2.1
48331,6/1/19,9850,9344,506,5.1
48333,6/1/19,1880,1818,62,3.3
48335,6/1/19,2334,2244,90,3.9
48337,6/1/19,9403,9129,274,2.9
48339,6/1/19,283353,273228,10125,3.6
48341,6/1/19,11050,10773,277,2.5
48343,6/1/19,4834,4569,265,5.5
48345,6/1/19,490,470,20,4.1
48347,6/1/19,27947,26741,1206,4.3
48349,6/1/19,23822,23017,805,3.4
48351,6/1/19,5164,4824,340,6.6
48353,6/1/19,7093,6873,220,3.1
48355,6/1/19,167157,159955,7202,4.3
48357,6/1/19,4300,4178,122,2.8
48359,6/1/19,916,887,29,3.2
48361,6/1/19,36238,34276,1962,5.4
48363,6/1/19,13719,13261,458,3.3
48365,6/1/19,10088,9665,423,4.2
48367,6/1/19,67092,65018,2074,3.1
48369,6/1/19,4937,4818,119,2.4
48371,6/1/19,6487,6277,210,3.2
48373,6/1/19,17902,17041,861,4.8
48375,6/1/19,55084,53440,1644,3
48377,6/1/19,3132,2932,200,6.4
48379,6/1/19,6021,5833,188,3.1
48381,6/1/19,71923,70043,1880,2.6
48383,6/1/19,1955,1903,52,2.7
48385,6/1/19,1226,1174,52,4.2
48387,6/1/19,5080,4843,237,4.7
48389,6/1/19,11572,11366,206,1.8
48391,6/1/19,3175,3052,123,3.9
48393,6/1/19,432,417,15,3.5
48395,6/1/19,7396,7110,286,3.9
48397,6/1/19,51948,50255,1693,3.3
48399,6/1/19,4656,4518,138,3
48401,6/1/19,22996,22138,858,3.7
48403,6/1/19,3813,3543,270,7.1
48405,6/1/19,3343,3186,157,4.7
48407,6/1/19,11761,11208,553,4.7
48409,6/1/19,29885,28185,1700,5.7
48411,6/1/19,2517,2439,78,3.1
48413,6/1/19,1327,1289,38,2.9
48415,6/1/19,6845,6587,258,3.8
48417,6/1/19,1940,1896,44,2.3
48419,6/1/19,11299,10844,455,4
48421,6/1/19,1396,1360,36,2.6
48423,6/1/19,107044,103249,3795,3.5
48425,6/1/19,4350,4185,165,3.8
48427,6/1/19,24817,22356,2461,9.9
48429,6/1/19,4083,3947,136,3.3
48431,6/1/19,591,574,17,2.9
48433,6/1/19,614,597,17,2.8
48435,6/1/19,1533,1477,56,3.7
48437,6/1/19,2634,2533,101,3.8
48439,6/1/19,1078738,1041255,37483,3.5
48441,6/1/19,66501,64405,2096,3.2
48443,6/1/19,400,388,12,3
48445,6/1/19,5023,4826,197,3.9
48447,6/1/19,668,640,28,4.2
48449,6/1/19,13025,12443,582,4.5
48451,6/1/19,54391,52606,1785,3.3
48453,6/1/19,739439,719531,19908,2.7
48455,6/1/19,5313,5067,246,4.6
48457,6/1/19,7189,6755,434,6
48459,6/1/19,17824,17164,660,3.7
48461,6/1/19,1715,1662,53,3.1
48463,6/1/19,11724,11252,472,4
48465,6/1/19,23154,22365,789,3.4
48467,6/1/19,26420,25527,893,3.4
48469,6/1/19,42698,41163,1535,3.6
48471,6/1/19,23963,22915,1048,4.4
48473,6/1/19,23488,22507,981,4.2
48475,6/1/19,7477,7298,179,2.4
48477,6/1/19,15116,14551,565,3.7
48479,6/1/19,118663,113933,4730,4
48481,6/1/19,21791,21001,790,3.6
48483,6/1/19,2286,2219,67,2.9
48485,6/1/19,56465,54485,1980,3.5
48487,6/1/19,4970,4779,191,3.8
48489,6/1/19,6525,5923,602,9.2
48491,6/1/19,313294,304149,9145,2.9
48493,6/1/19,24840,24078,762,3.1
48495,6/1/19,3977,3859,118,3
48497,6/1/19,31860,30698,1162,3.6
48499,6/1/19,17727,17034,693,3.9
48501,6/1/19,3868,3746,122,3.2
48503,6/1/19,8074,7824,250,3.1
48505,6/1/19,5111,4846,265,5.2
48507,6/1/19,3298,3000,298,9
49001,6/1/19,2915,2802,113,3.9
49003,6/1/19,26101,25332,769,2.9
49005,6/1/19,63871,62226,1645,2.6
49007,6/1/19,8625,8257,368,4.3
49009,6/1/19,458,444,14,3.1
49011,6/1/19,175134,170230,4904,2.8
49013,6/1/19,7968,7621,347,4.4
49015,6/1/19,4489,4299,190,4.2
49017,6/1/19,3275,3139,136,4.2
49019,6/1/19,6811,6630,181,2.7
49021,6/1/19,23247,22416,831,3.6
49023,6/1/19,5671,5507,164,2.9
49025,6/1/19,4075,3962,113,2.8
49027,6/1/19,6180,5995,185,3
49029,6/1/19,5613,5449,164,2.9
49031,6/1/19,491,468,23,4.7
49033,6/1/19,1446,1411,35,2.4
49035,6/1/19,638198,619745,18453,2.9
49037,6/1/19,6090,5799,291,4.8
49039,6/1/19,12750,12260,490,3.8
49041,6/1/19,9947,9602,345,3.5
49043,6/1/19,24358,23638,720,3
49045,6/1/19,34212,33071,1141,3.3
49047,6/1/19,14027,13365,662,4.7
49049,6/1/19,305224,296591,8633,2.8
49051,6/1/19,16343,15839,504,3.1
49053,6/1/19,75145,72576,2569,3.4
49055,6/1/19,1534,1470,64,4.2
49057,6/1/19,128320,124268,4052,3.2
50001,6/1/19,21024,20520,504,2.4
50003,6/1/19,18304,17768,536,2.9
50005,6/1/19,14722,14278,444,3
50007,6/1/19,97588,95495,2093,2.1
50009,6/1/19,2761,2684,77,2.8
50011,6/1/19,27837,27222,615,2.2
50013,6/1/19,4043,3958,85,2.1
50015,6/1/19,14023,13622,401,2.9
50017,6/1/19,16226,15858,368,2.3
50019,6/1/19,13378,12892,486,3.6
50021,6/1/19,30963,30039,924,3
50023,6/1/19,34538,33780,758,2.2
50025,6/1/19,22301,21686,615,2.8
50027,6/1/19,29245,28577,668,2.3
51001,6/1/19,17300,16743,557,3.2
51003,6/1/19,58064,56462,1602,2.8
51005,6/1/19,6935,6702,233,3.4
51007,6/1/19,6408,6199,209,3.3
51009,6/1/19,15142,14596,546,3.6
51011,6/1/19,7229,6955,274,3.8
51013,6/1/19,156605,153475,3130,2
51015,6/1/19,37937,36954,983,2.6
51017,6/1/19,2641,2581,60,2.3
51019,6/1/19,38661,37483,1178,3
51021,6/1/19,2851,2767,84,2.9
51023,6/1/19,17456,16994,462,2.6
51025,6/1/19,6172,5883,289,4.7
51027,6/1/19,6804,6468,336,4.9
51029,6/1/19,6534,6254,280,4.3
51031,6/1/19,26090,25220,870,3.3
51033,6/1/19,15439,14923,516,3.3
51035,6/1/19,13577,13122,455,3.4
51036,6/1/19,3736,3600,136,3.6
51037,6/1/19,5391,5184,207,3.8
51041,6/1/19,189383,183892,5491,2.9
51043,6/1/19,7808,7606,202,2.6
51045,6/1/19,2318,2238,80,3.5
51047,6/1/19,25174,24494,680,2.7
51049,6/1/19,4709,4562,147,3.1
51051,6/1/19,4789,4547,242,5.1
51053,6/1/19,13919,13426,493,3.5
51057,6/1/19,5587,5404,183,3.3
51059,6/1/19,645532,629898,15634,2.4
51061,6/1/19,38163,37177,986,2.6
51063,6/1/19,8182,7963,219,2.7
51065,6/1/19,14061,13709,352,2.5
51067,6/1/19,26579,25771,808,3
51069,6/1/19,48540,47289,1251,2.6
51071,6/1/19,7760,7494,266,3.4
51073,6/1/19,19951,19418,533,2.7
51075,6/1/19,11403,11069,334,2.9
51077,6/1/19,8258,8035,223,2.7
51079,6/1/19,10636,10373,263,2.5
51081,6/1/19,4290,4150,140,3.3
51083,6/1/19,15892,15232,660,4.2
51085,6/1/19,59918,58387,1531,2.6
51087,6/1/19,183667,178284,5383,2.9
51089,6/1/19,23855,23005,850,3.6
51091,6/1/19,1370,1340,30,2.2
51093,6/1/19,19848,19256,592,3
51095,6/1/19,37219,36166,1053,2.8
51097,6/1/19,3917,3806,111,2.8
51099,6/1/19,13597,13237,360,2.6
51101,6/1/19,9290,9041,249,2.7
51103,6/1/19,5545,5355,190,3.4
51105,6/1/19,8355,8036,319,3.8
51107,6/1/19,226050,220546,5504,2.4
51109,6/1/19,20129,19582,547,2.7
51111,6/1/19,5381,5202,179,3.3
51113,6/1/19,7604,7424,180,2.4
51115,6/1/19,4213,4090,123,2.9
51117,6/1/19,12864,12311,553,4.3
51119,6/1/19,5492,5349,143,2.6
51121,6/1/19,49029,47442,1587,3.2
51125,6/1/19,7659,7416,243,3.2
51127,6/1/19,12650,12320,330,2.6
51131,6/1/19,5859,5633,226,3.9
51133,6/1/19,5895,5692,203,3.4
51135,6/1/19,7315,7102,213,2.9
51137,6/1/19,17811,17242,569,3.2
51139,6/1/19,12362,11956,406,3.3
51141,6/1/19,7554,7291,263,3.5
51143,6/1/19,30465,29349,1116,3.7
51145,6/1/19,14306,13937,369,2.6
51147,6/1/19,10656,10184,472,4.4
51149,6/1/19,15250,14705,545,3.6
51153,6/1/19,249170,242598,6572,2.6
51155,6/1/19,15671,15139,532,3.4
51157,6/1/19,3817,3721,96,2.5
51159,6/1/19,4162,4042,120,2.9
51161,6/1/19,49393,48042,1351,2.7
51163,6/1/19,10824,10510,314,2.9
51165,6/1/19,41775,40652,1123,2.7
51167,6/1/19,11357,10894,463,4.1
51169,6/1/19,9142,8842,300,3.3
51171,6/1/19,22595,22000,595,2.6
51173,6/1/19,13878,13373,505,3.6
51175,6/1/19,9285,9039,246,2.6
51177,6/1/19,68190,66079,2111,3.1
51179,6/1/19,73042,70952,2090,2.9
51181,6/1/19,3712,3572,140,3.8
51183,6/1/19,3945,3765,180,4.6
51185,6/1/19,16027,15351,676,4.2
51187,6/1/19,20804,20205,599,2.9
51191,6/1/19,26738,25805,933,3.5
51193,6/1/19,9807,9494,313,3.2
51195,6/1/19,13387,12750,637,4.8
51197,6/1/19,13816,13340,476,3.4
51199,6/1/19,33220,32302,918,2.8
51510,6/1/19,102791,100561,2230,2.2
51520,6/1/19,7206,6914,292,4.1
51530,6/1/19,3285,3179,106,3.2
51540,6/1/19,26690,25964,726,2.7
51550,6/1/19,124381,120662,3719,3
51570,6/1/19,8896,8594,302,3.4
51580,6/1/19,2393,2287,106,4.4
51590,6/1/19,19144,18076,1068,5.6
51595,6/1/19,2310,2196,114,4.9
51600,6/1/19,13660,13361,299,2.2
51610,6/1/19,8738,8546,192,2.2
51620,6/1/19,3613,3461,152,4.2
51630,6/1/19,14358,13845,513,3.6
51640,6/1/19,2993,2886,107,3.6
51650,6/1/19,65227,62696,2531,3.9
51660,6/1/19,24708,23772,936,3.8
51670,6/1/19,9760,9328,432,4.4
51678,6/1/19,2060,1949,111,5.4
51680,6/1/19,36535,34963,1572,4.3
51683,6/1/19,22370,21798,572,2.6
51685,6/1/19,9535,9289,246,2.6
51690,6/1/19,5501,5249,252,4.6
51700,6/1/19,89936,86729,3207,3.6
51710,6/1/19,113114,109010,4104,3.6
51720,6/1/19,1685,1621,64,3.8
51730,6/1/19,13153,12390,763,5.8
51735,6/1/19,6511,6349,162,2.5
51740,6/1/19,44826,43054,1772,4
51750,6/1/19,8439,8089,350,4.1
51760,6/1/19,119520,115416,4104,3.4
51770,6/1/19,49277,47580,1697,3.4
51775,6/1/19,12952,12570,382,2.9
51790,6/1/19,12299,11947,352,2.9
51800,6/1/19,45257,43819,1438,3.2
51810,6/1/19,236312,229727,6585,2.8
51820,6/1/19,10714,10398,316,2.9
51830,6/1/19,6805,6513,292,4.3
51840,6/1/19,14966,14531,435,2.9
53001,6/1/19,11077,10596,481,4.3
53003,6/1/19,10278,9864,414,4
53005,6/1/19,106329,101209,5120,4.8
53007,6/1/19,47914,45937,1977,4.1
53009,6/1/19,28865,26997,1868,6.5
53011,6/1/19,239487,227714,11773,4.9
53013,6/1/19,1864,1770,94,5
53015,6/1/19,47638,44672,2966,6.2
53017,6/1/19,22802,21712,1090,4.8
53019,6/1/19,2573,2317,256,9.9
53021,6/1/19,45874,43347,2527,5.5
53023,6/1/19,936,893,43,4.6
53025,6/1/19,49963,47202,2761,5.5
53027,6/1/19,29054,27060,1994,6.9
53029,6/1/19,35965,34088,1877,5.2
53031,6/1/19,12947,12210,737,5.7
53033,6/1/19,1287036,1250770,36266,2.8
53035,6/1/19,127845,121693,6152,4.8
53037,6/1/19,23477,22222,1255,5.3
53039,6/1/19,11075,10472,603,5.4
53041,6/1/19,34884,32797,2087,6
53043,6/1/19,5110,4872,238,4.7
53045,6/1/19,24910,23300,1610,6.5
53047,6/1/19,21218,20022,1196,5.6
53049,6/1/19,8644,8062,582,6.7
53051,6/1/19,4994,4659,335,6.7
53053,6/1/19,438243,415121,23122,5.3
53055,6/1/19,9188,8869,319,3.5
53057,6/1/19,63521,60058,3463,5.5
53059,6/1/19,5495,5196,299,5.4
53061,6/1/19,438192,424926,13266,3
53063,6/1/19,253127,240047,13080,5.2
53065,6/1/19,18865,17693,1172,6.2
53067,6/1/19,141189,134142,7047,5
53069,6/1/19,1348,1267,81,6
53071,6/1/19,30500,29007,1493,4.9
53073,6/1/19,115468,109588,5880,5.1
53075,6/1/19,21528,20426,1102,5.1
53077,6/1/19,140204,132028,8176,5.8
54001,6/1/19,7036,6599,437,6.2
54003,6/1/19,59487,57242,2245,3.8
54005,6/1/19,7620,7182,438,5.7
54007,6/1/19,5350,5024,326,6.1
54009,6/1/19,10158,9610,548,5.4
54011,6/1/19,42099,40149,1950,4.6
54013,6/1/19,2472,2231,241,9.7
54015,6/1/19,3166,2941,225,7.1
54017,6/1/19,4097,3927,170,4.1
54019,6/1/19,16592,15694,898,5.4
54021,6/1/19,2305,2152,153,6.6
54023,6/1/19,6129,5795,334,5.4
54025,6/1/19,16444,15742,702,4.3
54027,6/1/19,10938,10491,447,4.1
54029,6/1/19,13253,12575,678,5.1
54031,6/1/19,5913,5622,291,4.9
54033,6/1/19,35357,33866,1491,4.2
54035,6/1/19,14181,13531,650,4.6
54037,6/1/19,31459,30425,1034,3.3
54039,6/1/19,84155,80317,3838,4.6
54041,6/1/19,6973,6574,399,5.7
54043,6/1/19,7272,6812,460,6.3
54045,6/1/19,11378,10710,668,5.9
54047,6/1/19,4536,4106,430,9.5
54049,6/1/19,25557,24223,1334,5.2
54051,6/1/19,14533,13685,848,5.8
54053,6/1/19,10441,9800,641,6.1
54055,6/1/19,21537,20224,1313,6.1
54057,6/1/19,12788,12002,786,6.1
54059,6/1/19,7089,6582,507,7.2
54061,6/1/19,53360,51147,2213,4.1
54063,6/1/19,6047,5793,254,4.2
54065,6/1/19,8371,8036,335,4
54067,6/1/19,9656,9109,547,5.7
54069,6/1/19,21883,20890,993,4.5
54071,6/1/19,3791,3647,144,3.8
54073,6/1/19,2975,2792,183,6.2
54075,6/1/19,3830,3652,178,4.6
54077,6/1/19,15235,14534,701,4.6
54079,6/1/19,26971,25745,1226,4.5
54081,6/1/19,31143,29674,1469,4.7
54083,6/1/19,12471,11772,699,5.6
54085,6/1/19,4428,4212,216,4.9
54087,6/1/19,5071,4664,407,8
54089,6/1/19,4520,4289,231,5.1
54091,6/1/19,8013,7632,381,4.8
54093,6/1/19,3459,3295,164,4.7
54095,6/1/19,3185,2947,238,7.5
54097,6/1/19,9588,8999,589,6.1
54099,6/1/19,15941,15064,877,5.5
54101,6/1/19,3352,3162,190,5.7
54103,6/1/19,6665,6234,431,6.5
54105,6/1/19,2302,2139,163,7.1
54107,6/1/19,37325,35436,1889,5.1
54109,6/1/19,6846,6353,493,7.2
55001,6/1/19,8471,8061,410,4.8
55003,6/1/19,8205,7819,386,4.7
55005,6/1/19,25101,24186,915,3.6
55007,6/1/19,7809,7433,376,4.8
55009,6/1/19,143903,138671,5232,3.6
55011,6/1/19,6740,6457,283,4.2
55013,6/1/19,7385,7018,367,5
55015,6/1/19,28255,27335,920,3.3
55017,6/1/19,33107,31900,1207,3.6
55019,6/1/19,18636,18009,627,3.4
55021,6/1/19,31945,30856,1089,3.4
55023,6/1/19,7817,7510,307,3.9
55025,6/1/19,324180,314369,9811,3
55027,6/1/19,48794,47179,1615,3.3
55029,6/1/19,17002,16435,567,3.3
55031,6/1/19,23067,22049,1018,4.4
55033,6/1/19,23466,22541,925,3.9
55035,6/1/19,58827,56686,2141,3.6
55037,6/1/19,2284,2185,99,4.3
55039,6/1/19,58938,56962,1976,3.4
55041,6/1/19,4177,3962,215,5.1
55043,6/1/19,27820,26797,1023,3.7
55045,6/1/19,21430,20740,690,3.2
55047,6/1/19,9911,9530,381,3.8
55049,6/1/19,14040,13611,429,3.1
55051,6/1/19,2585,2442,143,5.5
55053,6/1/19,10705,10326,379,3.5
55055,6/1/19,46637,44964,1673,3.6
55057,6/1/19,13989,13537,452,3.2
55059,6/1/19,90934,86959,3975,4.4
55061,6/1/19,11354,10973,381,3.4
55063,6/1/19,66067,63707,2360,3.6
55065,6/1/19,10550,10249,301,2.9
55067,6/1/19,9633,9239,394,4.1
55069,6/1/19,15272,14720,552,3.6
55071,6/1/19,41820,40290,1530,3.7
55073,6/1/19,74620,72161,2459,3.3
55075,6/1/19,19890,19009,881,4.4
55077,6/1/19,7895,7613,282,3.6
55078,6/1/19,1710,1556,154,9
55079,6/1/19,470607,449000,21607,4.6
55081,6/1/19,23994,23203,791,3.3
55083,6/1/19,20905,20143,762,3.6
55085,6/1/19,18670,17900,770,4.1
55087,6/1/19,105025,101460,3565,3.4
55089,6/1/19,49520,47785,1735,3.5
55091,6/1/19,4359,4197,162,3.7
55093,6/1/19,25684,24765,919,3.6
55095,6/1/19,24959,24086,873,3.5
55097,6/1/19,38218,36741,1477,3.9
55099,6/1/19,6743,6453,290,4.3
55101,6/1/19,99883,95498,4385,4.4
55103,6/1/19,9545,9227,318,3.3
55105,6/1/19,86443,82849,3594,4.2
55107,6/1/19,6734,6415,319,4.7
55109,6/1/19,50786,49049,1737,3.4
55111,6/1/19,37217,36046,1171,3.1
55113,6/1/19,8412,8065,347,4.1
55115,6/1/19,21790,21039,751,3.4
55117,6/1/19,63844,61783,2061,3.2
55119,6/1/19,11345,10959,386,3.4
55121,6/1/19,16376,15789,587,3.6
55123,6/1/19,15895,15369,526,3.3
55125,6/1/19,10976,10564,412,3.8
55127,6/1/19,58655,56456,2199,3.7
55129,6/1/19,8272,7963,309,3.7
55131,6/1/19,77885,75273,2612,3.4
55133,6/1/19,226330,218472,7858,3.5
55135,6/1/19,26826,25889,937,3.5
55137,6/1/19,11763,11281,482,4.1
55139,6/1/19,92133,88865,3268,3.5
55141,6/1/19,35920,34491,1429,4
56001,6/1/19,19308,18556,752,3.9
56003,6/1/19,5555,5323,232,4.2
56005,6/1/19,23369,22541,828,3.5
56007,6/1/19,8290,8029,261,3.1
56009,6/1/19,8752,8502,250,2.9
56011,6/1/19,3909,3796,113,2.9
56013,6/1/19,18767,17920,847,4.5
56015,6/1/19,6720,6452,268,4
56017,6/1/19,2232,2152,80,3.6
56019,6/1/19,4453,4308,145,3.3
56021,6/1/19,48383,46635,1748,3.6
56023,6/1/19,9342,9034,308,3.3
56025,6/1/19,39460,37860,1600,4.1
56027,6/1/19,1279,1239,40,3.1
56029,6/1/19,16952,16370,582,3.4
56031,6/1/19,4786,4616,170,3.6
56033,6/1/19,16060,15502,558,3.5
56035,6/1/19,4309,4127,182,4.2
56037,6/1/19,21386,20544,842,3.9
56039,6/1/19,16961,16586,375,2.2
56041,6/1/19,9221,8843,378,4.1
56043,6/1/19,4015,3849,166,4.1
56045,6/1/19,3899,3784,115,2.9
72001,6/1/19,4124,3550,574,13.9
72003,6/1/19,12155,10935,1220,10
72005,6/1/19,14894,13313,1581,10.6
72007,6/1/19,6658,6066,592,8.9
72009,6/1/19,6565,5896,669,10.2
72011,6/1/19,8986,8247,739,8.2
72013,6/1/19,24308,22088,2220,9.1
72015,6/1/19,4774,4140,634,13.3
72017,6/1/19,5995,5347,648,10.8
72019,6/1/19,7428,6803,625,8.4
72021,6/1/19,66528,62478,4050,6.1
72023,6/1/19,13799,12633,1166,8.4
72025,6/1/19,48681,45435,3246,6.7
72027,6/1/19,9678,8874,804,8.3
72029,6/1/19,16329,15284,1045,6.4
72031,6/1/19,62674,59036,3638,5.8
72033,6/1/19,7987,7432,555,6.9
72035,6/1/19,16449,15316,1133,6.9
72037,6/1/19,3803,3414,389,10.2
72039,6/1/19,3773,3349,424,11.2
72041,6/1/19,15808,14726,1082,6.8
72043,6/1/19,10036,8861,1175,11.7
72045,6/1/19,4938,4537,401,8.1
72047,6/1/19,9068,8240,828,9.1
72049,6/1/19,933,907,26,2.8
72051,6/1/19,13398,12668,730,5.4
72053,6/1/19,11233,10025,1208,10.8
72054,6/1/19,3357,3012,345,10.3
72055,6/1/19,3983,3435,548,13.8
72057,6/1/19,11331,9979,1352,11.9
72059,6/1/19,5289,4627,662,12.5
72061,6/1/19,38387,36895,1492,3.9
72063,6/1/19,18371,17364,1007,5.5
72065,6/1/19,13573,12144,1429,10.5
72067,6/1/19,5553,5070,483,8.7
72069,6/1/19,17536,15780,1756,10
72071,6/1/19,12502,11336,1166,9.3
72073,6/1/19,4280,3664,616,14.4
72075,6/1/19,15361,13852,1509,9.8
72077,6/1/19,12440,11435,1005,8.1
72079,6/1/19,5245,4590,655,12.5
72081,6/1/19,6853,5899,954,13.9
72083,6/1/19,2660,2390,270,10.2
72085,6/1/19,11521,10476,1045,9.1
72087,6/1/19,8540,7920,620,7.3
72089,6/1/19,6317,5734,583,9.2
72091,6/1/19,11636,10710,926,8
72093,6/1/19,1925,1643,282,14.6
72095,6/1/19,3012,2557,455,15.1
72097,6/1/19,22445,20153,2292,10.2
72099,6/1/19,10730,9562,1168,10.9
72101,6/1/19,8096,7361,735,9.1
72103,6/1/19,8246,7565,681,8.3
72105,6/1/19,7166,6574,592,8.3
72107,6/1/19,4989,4527,462,9.3
72109,6/1/19,4385,3734,651,14.8
72111,6/1/19,6045,5192,853,14.1
72113,6/1/19,46631,42280,4351,9.3
72115,6/1/19,6188,5495,693,11.2
72117,6/1/19,4703,4192,511,10.9
72119,6/1/19,17165,15962,1203,7
72121,6/1/19,6272,5416,856,13.6
72123,6/1/19,7179,6162,1017,14.2
72125,6/1/19,9926,8809,1117,11.3
72127,6/1/19,137084,129779,7305,5.3
72129,6/1/19,11898,10858,1040,8.7
72131,6/1/19,10358,9010,1348,13
72133,6/1/19,9023,8144,879,9.7
72135,6/1/19,27552,26046,1506,5.5
72137,6/1/19,29696,28029,1667,5.6
72139,6/1/19,27570,26267,1303,4.7
72141,6/1/19,6715,5980,735,10.9
72143,6/1/19,9859,9085,774,7.9
72145,6/1/19,13479,12176,1303,9.7
72147,6/1/19,2648,2480,168,6.3
72149,6/1/19,7522,6466,1056,14
72151,6/1/19,8996,7828,1168,13
72153,6/1/19,9986,8545,1441,14.4
1001,7/1/19,26279,25552,727,2.8
1003,7/1/19,99665,97121,2544,2.6
1005,7/1/19,8625,8271,354,4.1
1007,7/1/19,8713,8444,269,3.1
1009,7/1/19,25535,24859,676,2.6
1011,7/1/19,4926,4733,193,3.9
1013,7/1/19,9319,8954,365,3.9
1015,7/1/19,46131,44470,1661,3.6
1017,7/1/19,15789,15266,523,3.3
1019,7/1/19,11633,11291,342,2.9
1021,7/1/19,19978,19425,553,2.8
1023,7/1/19,4559,4320,239,5.2
1025,7/1/19,7547,7059,488,6.5
1027,7/1/19,6097,5896,201,3.3
1029,7/1/19,5860,5684,176,3
1031,7/1/19,21455,20853,602,2.8
1033,7/1/19,23692,22713,979,4.1
1035,7/1/19,4622,4435,187,4
1037,7/1/19,4589,4443,146,3.2
1039,7/1/19,15778,15235,543,3.4
1041,7/1/19,6597,6398,199,3
1043,7/1/19,38527,37511,1016,2.6
1045,7/1/19,20775,20128,647,3.1
1047,7/1/19,14934,13981,953,6.4
1049,7/1/19,31758,30877,881,2.8
1051,7/1/19,37641,36661,980,2.6
1053,7/1/19,14852,14318,534,3.6
1055,7/1/19,42549,41065,1484,3.5
1057,7/1/19,6542,6323,219,3.3
1059,7/1/19,14743,14328,415,2.8
1061,7/1/19,11266,10967,299,2.7
1063,7/1/19,2929,2724,205,7
1065,7/1/19,6186,5902,284,4.6
1067,7/1/19,7047,6796,251,3.6
1069,7/1/19,46538,45113,1425,3.1
1071,7/1/19,23515,22708,807,3.4
1073,7/1/19,319233,309785,9448,3
1075,7/1/19,5903,5715,188,3.2
1077,7/1/19,42651,41149,1502,3.5
1079,7/1/19,14376,13910,466,3.2
1081,7/1/19,76138,74009,2129,2.8
1083,7/1/19,43911,42724,1187,2.7
1085,7/1/19,3625,3406,219,6
1087,7/1/19,7869,7495,374,4.8
1089,7/1/19,185041,180133,4908,2.7
1091,7/1/19,7711,7428,283,3.7
1093,7/1/19,13067,12603,464,3.6
1095,7/1/19,44488,43408,1080,2.4
1097,7/1/19,188081,180694,7387,3.9
1099,7/1/19,7435,7062,373,5
1101,7/1/19,105847,102506,3341,3.2
1103,7/1/19,58199,56657,1542,2.6
1105,7/1/19,3443,3206,237,6.9
1107,7/1/19,7915,7588,327,4.1
1109,7/1/19,15273,14773,500,3.3
1111,7/1/19,9695,9396,299,3.1
1113,7/1/19,23650,22950,700,3
1115,7/1/19,40654,39546,1108,2.7
1117,7/1/19,116011,113517,2494,2.1
1119,7/1/19,4905,4624,281,5.7
1121,7/1/19,35817,34538,1279,3.6
1123,7/1/19,18909,18303,606,3.2
1125,7/1/19,103307,100190,3117,3
1127,7/1/19,25465,24632,833,3.3
1129,7/1/19,6750,6417,333,4.9
1131,7/1/19,2800,2592,208,7.4
1133,7/1/19,10114,9777,337,3.3
2013,7/1/19,3696,3632,64,1.7
2016,7/1/19,3927,3820,107,2.7
2020,7/1/19,146936,139805,7131,4.9
2050,7/1/19,6832,5885,947,13.9
2060,7/1/19,1245,1224,21,1.7
2068,7/1/19,1758,1697,61,3.5
2070,7/1/19,2732,2569,163,6
2090,7/1/19,45041,42821,2220,4.9
2100,7/1/19,1462,1394,68,4.7
2105,7/1/19,1438,1340,98,6.8
2110,7/1/19,17849,17157,692,3.9
2122,7/1/19,27934,26406,1528,5.5
2130,7/1/19,7847,7468,379,4.8
2150,7/1/19,6529,6265,264,4
2158,7/1/19,2363,1821,542,22.9
2164,7/1/19,970,900,70,7.2
2170,7/1/19,46840,43727,3113,6.6
2180,7/1/19,3841,3356,485,12.6
2185,7/1/19,3350,3115,235,7
2188,7/1/19,2989,2528,461,15.4
2195,7/1/19,1621,1522,99,6.1
2198,7/1/19,2839,2569,270,9.5
2220,7/1/19,5012,4843,169,3.4
2230,7/1/19,1116,1086,30,2.7
2240,7/1/19,2892,2656,236,8.2
2261,7/1/19,6293,6007,286,4.5
2275,7/1/19,1073,1006,67,6.2
2282,7/1/19,272,258,14,5.1
2290,7/1/19,2416,2085,331,13.7
4001,7/1/19,19923,17700,2223,11.2
4003,7/1/19,49803,46760,3043,6.1
4005,7/1/19,77592,72957,4635,6
4007,7/1/19,21462,20240,1222,5.7
4009,7/1/19,14124,13315,809,5.7
4011,7/1/19,4588,4389,199,4.3
4012,7/1/19,8870,8323,547,6.2
4013,7/1/19,2316300,2216877,99423,4.3
4015,7/1/19,88808,83593,5215,5.9
4017,7/1/19,39585,36434,3151,8
4019,7/1/19,498093,474345,23748,4.8
4021,7/1/19,186085,176432,9653,5.2
4023,7/1/19,18718,16883,1835,9.8
4025,7/1/19,107835,102792,5043,4.7
4027,7/1/19,98365,78268,20097,20.4
5001,7/1/19,9602,9301,301,3.1
5003,7/1/19,7784,7289,495,6.4
5005,7/1/19,16313,15643,670,4.1
5007,7/1/19,139305,135164,4141,3
5009,7/1/19,15919,15352,567,3.6
5011,7/1/19,4417,4219,198,4.5
5013,7/1/19,2462,2351,111,4.5
5015,7/1/19,13255,12861,394,3
5017,7/1/19,3340,3071,269,8.1
5019,7/1/19,9575,9071,504,5.3
5021,7/1/19,5792,5492,300,5.2
5023,7/1/19,9301,8869,432,4.6
5025,7/1/19,3272,3134,138,4.2
5027,7/1/19,8824,8310,514,5.8
5029,7/1/19,8280,7856,424,5.1
5031,7/1/19,56703,54808,1895,3.3
5033,7/1/19,27365,26320,1045,3.8
5035,7/1/19,22068,20924,1144,5.2
5037,7/1/19,7413,7061,352,4.7
5039,7/1/19,2850,2704,146,5.1
5041,7/1/19,5347,5064,283,5.3
5043,7/1/19,7757,7288,469,6
5045,7/1/19,63605,61465,2140,3.4
5047,7/1/19,7510,7213,297,4
5049,7/1/19,5021,4789,232,4.6
5051,7/1/19,42818,40992,1826,4.3
5053,7/1/19,8574,8260,314,3.7
5055,7/1/19,20290,19447,843,4.2
5057,7/1/19,9907,9469,438,4.4
5059,7/1/19,14330,13704,626,4.4
5061,7/1/19,5661,5439,222,3.9
5063,7/1/19,16311,15540,771,4.7
5065,7/1/19,4814,4526,288,6
5067,7/1/19,5805,5373,432,7.4
5069,7/1/19,28110,26314,1796,6.4
5071,7/1/19,10096,9523,573,5.7
5073,7/1/19,2435,2306,129,5.3
5075,7/1/19,6597,6262,335,5.1
5077,7/1/19,2893,2762,131,4.5
5079,7/1/19,4036,3838,198,4.9
5081,7/1/19,5606,5337,269,4.8
5083,7/1/19,8645,8192,453,5.2
5085,7/1/19,35424,33923,1501,4.2
5087,7/1/19,7619,7404,215,2.8
5089,7/1/19,6724,6441,283,4.2
5091,7/1/19,20122,19200,922,4.6
5093,7/1/19,17592,16327,1265,7.2
5095,7/1/19,2785,2639,146,5.2
5097,7/1/19,3033,2885,148,4.9
5099,7/1/19,3658,3467,191,5.2
5101,7/1/19,3336,3211,125,3.7
5103,7/1/19,9814,9275,539,5.5
5105,7/1/19,4384,4184,200,4.6
5107,7/1/19,6269,5830,439,7
5109,7/1/19,4206,4012,194,4.6
5111,7/1/19,10532,10120,412,3.9
5113,7/1/19,8107,7741,366,4.5
5115,7/1/19,28613,27029,1584,5.5
5117,7/1/19,3599,3396,203,5.6
5119,7/1/19,193905,186276,7629,3.9
5121,7/1/19,7311,6975,336,4.6
5123,7/1/19,8260,7777,483,5.8
5125,7/1/19,60169,58247,1922,3.2
5127,7/1/19,4273,4100,173,4
5129,7/1/19,2956,2811,145,4.9
5131,7/1/19,57526,55386,2140,3.7
5133,7/1/19,5594,5291,303,5.4
5135,7/1/19,5683,5361,322,5.7
5137,7/1/19,4810,4583,227,4.7
5139,7/1/19,15654,14686,968,6.2
5141,7/1/19,5750,5435,315,5.5
5143,7/1/19,127088,123397,3691,2.9
5145,7/1/19,33340,31651,1689,5.1
5147,7/1/19,2748,2595,153,5.6
5149,7/1/19,8387,7986,401,4.8
6001,7/1/19,849110,821164,27946,3.3
6003,7/1/19,482,447,35,7.3
6005,7/1/19,15029,14434,595,4
6007,7/1/19,97842,92381,5461,5.6
6009,7/1/19,21841,21002,839,3.8
6011,7/1/19,11012,9888,1124,10.2
6013,7/1/19,564917,545585,19332,3.4
6015,7/1/19,9664,9092,572,5.9
6017,7/1/19,92256,88809,3447,3.7
6019,7/1/19,451656,418960,32696,7.2
6021,7/1/19,12866,12037,829,6.4
6023,7/1/19,61421,58946,2475,4
6025,7/1/19,70275,56051,14224,20.2
6027,7/1/19,8947,8628,319,3.6
6029,7/1/19,384070,351552,32518,8.5
6031,7/1/19,57888,53389,4499,7.8
6033,7/1/19,28851,27378,1473,5.1
6035,7/1/19,9693,9234,459,4.7
6037,7/1/19,5130244,4874249,255995,5
6039,7/1/19,61042,56629,4413,7.2
6041,7/1/19,141379,137782,3597,2.5
6043,7/1/19,8130,7809,321,3.9
6045,7/1/19,39120,37568,1552,4
6047,7/1/19,112782,103357,9425,8.4
6049,7/1/19,3275,3077,198,6
6051,7/1/19,8677,8351,326,3.8
6053,7/1/19,231408,220536,10872,4.7
6055,7/1/19,75942,73708,2234,2.9
6057,7/1/19,48453,46738,1715,3.5
6059,7/1/19,1626509,1575770,50739,3.1
6061,7/1/19,188478,182077,6401,3.4
6063,7/1/19,8512,7990,522,6.1
6065,7/1/19,1105813,1053713,52100,4.7
6067,7/1/19,715527,686469,29058,4.1
6069,7/1/19,31740,30170,1570,4.9
6071,7/1/19,968630,925942,42688,4.4
6073,7/1/19,1595803,1539067,56736,3.6
6075,7/1/19,587789,573583,14206,2.4
6077,7/1/19,327810,307642,20168,6.2
6079,7/1/19,140314,135791,4523,3.2
6081,7/1/19,463724,453125,10599,2.3
6083,7/1/19,220335,212333,8002,3.6
6085,7/1/19,1061057,1031795,29262,2.8
6087,7/1/19,144340,138125,6215,4.3
6089,7/1/19,73839,70308,3531,4.8
6091,7/1/19,1386,1320,66,4.8
6093,7/1/19,17892,16861,1031,5.8
6095,7/1/19,209831,201267,8564,4.1
6097,7/1/19,260892,253210,7682,2.9
6099,7/1/19,244386,228601,15785,6.5
6101,7/1/19,46490,43312,3178,6.8
6103,7/1/19,25526,24004,1522,6
6105,7/1/19,4882,4644,238,4.9
6107,7/1/19,202033,181949,20084,9.9
6109,7/1/19,21551,20569,982,4.6
6111,7/1/19,422938,406550,16388,3.9
6113,7/1/19,109565,104954,4611,4.2
6115,7/1/19,29756,27924,1832,6.2
8001,7/1/19,277317,269330,7987,2.9
8003,7/1/19,8761,8434,327,3.7
8005,7/1/19,371069,361069,10000,2.7
8007,7/1/19,7339,7122,217,3
8009,7/1/19,2325,2292,33,1.4
8011,7/1/19,2019,1957,62,3.1
8013,7/1/19,196219,191613,4606,2.3
8014,7/1/19,40713,39740,973,2.4
8015,7/1/19,10810,10591,219,2
8017,7/1/19,1240,1221,19,1.5
8019,7/1/19,6180,6013,167,2.7
8021,7/1/19,4236,4086,150,3.5
8023,7/1/19,1973,1902,71,3.6
8025,7/1/19,1533,1466,67,4.4
8027,7/1/19,2192,2127,65,3
8029,7/1/19,15078,14634,444,2.9
8031,7/1/19,424017,412794,11223,2.6
8033,7/1/19,1233,1202,31,2.5
8035,7/1/19,197497,192859,4638,2.3
8037,7/1/19,37971,37248,723,1.9
8039,7/1/19,15616,15299,317,2
8041,7/1/19,343653,332041,11612,3.4
8043,7/1/19,15730,15010,720,4.6
8045,7/1/19,33943,33163,780,2.3
8047,7/1/19,3858,3767,91,2.4
8049,7/1/19,10573,10377,196,1.9
8051,7/1/19,12078,11878,200,1.7
8053,7/1/19,570,553,17,3
8055,7/1/19,2688,2550,138,5.1
8057,7/1/19,1102,1078,24,2.2
8059,7/1/19,341086,332691,8395,2.5
8061,7/1/19,1004,990,14,1.4
8063,7/1/19,4648,4576,72,1.5
8065,7/1/19,4965,4860,105,2.1
8067,7/1/19,33254,32553,701,2.1
8069,7/1/19,206484,201906,4578,2.2
8071,7/1/19,6692,6406,286,4.3
8073,7/1/19,2540,2492,48,1.9
8075,7/1/19,11198,10916,282,2.5
8077,7/1/19,76401,73737,2664,3.5
8079,7/1/19,550,540,10,1.8
8081,7/1/19,7532,7306,226,3
8083,7/1/19,13533,13083,450,3.3
8085,7/1/19,22549,21926,623,2.8
8087,7/1/19,16998,16550,448,2.6
8089,7/1/19,8653,8296,357,4.1
8091,7/1/19,2791,2724,67,2.4
8093,7/1/19,11461,11192,269,2.3
8095,7/1/19,2880,2839,41,1.4
8097,7/1/19,11707,11443,264,2.3
8099,7/1/19,6627,6446,181,2.7
8101,7/1/19,75745,72483,3262,4.3
8103,7/1/19,3102,2992,110,3.5
8105,7/1/19,5888,5657,231,3.9
8107,7/1/19,17038,16709,329,1.9
8109,7/1/19,3761,3615,146,3.9
8111,7/1/19,741,727,14,1.9
8113,7/1/19,6170,6051,119,1.9
8115,7/1/19,1271,1243,28,2.2
8117,7/1/19,22404,22027,377,1.7
8119,7/1/19,12881,12490,391,3
8121,7/1/19,3108,3049,59,1.9
8123,7/1/19,170232,165880,4352,2.6
8125,7/1/19,6414,6319,95,1.5
9001,7/1/19,492238,473724,18514,3.8
9003,7/1/19,488531,468363,20168,4.1
9005,7/1/19,107600,103921,3679,3.4
9007,7/1/19,94503,91535,2968,3.1
9009,7/1/19,467585,448102,19483,4.2
9011,7/1/19,141326,136068,5258,3.7
9013,7/1/19,87864,84905,2959,3.4
9015,7/1/19,65421,62674,2747,4.2
10001,7/1/19,79191,75275,3916,4.9
10003,7/1/19,299148,286785,12363,4.1
10005,7/1/19,114601,110637,3964,3.5
11001,7/1/19,416468,392330,24138,5.8
12001,7/1/19,137640,132965,4675,3.4
12003,7/1/19,11994,11575,419,3.5
12005,7/1/19,86508,83303,3205,3.7
12007,7/1/19,11124,10745,379,3.4
12009,7/1/19,287648,277903,9745,3.4
12011,7/1/19,1046699,1012468,34231,3.3
12013,7/1/19,4720,4511,209,4.4
12015,7/1/19,71184,68436,2748,3.9
12017,7/1/19,46672,44217,2455,5.3
12019,7/1/19,108860,105296,3564,3.3
12021,7/1/19,175679,169419,6260,3.6
12023,7/1/19,29316,28237,1079,3.7
12027,7/1/19,13689,13154,535,3.9
12029,7/1/19,5556,5306,250,4.5
12031,7/1/19,498056,479695,18361,3.7
12033,7/1/19,148131,143005,5126,3.5
12035,7/1/19,47294,45374,1920,4.1
12037,7/1/19,4729,4565,164,3.5
12039,7/1/19,18686,17833,853,4.6
12041,7/1/19,7071,6800,271,3.8
12043,7/1/19,4818,4575,243,5
12045,7/1/19,5919,5648,271,4.6
12047,7/1/19,4228,4035,193,4.6
12049,7/1/19,7828,7319,509,6.5
12051,7/1/19,14654,13429,1225,8.4
12053,7/1/19,72495,69264,3231,4.5
12055,7/1/19,35501,33681,1820,5.1
12057,7/1/19,753312,727872,25440,3.4
12059,7/1/19,6787,6519,268,3.9
12061,7/1/19,65378,62578,2800,4.3
12063,7/1/19,16607,15933,674,4.1
12065,7/1/19,5582,5378,204,3.7
12067,7/1/19,2761,2660,101,3.7
12069,7/1/19,160398,154838,5560,3.5
12071,7/1/19,345699,333879,11820,3.4
12073,7/1/19,154671,149135,5536,3.6
12075,7/1/19,16321,15654,667,4.1
12077,7/1/19,2591,2492,99,3.8
12079,7/1/19,7495,7175,320,4.3
12081,7/1/19,179241,173097,6144,3.4
12083,7/1/19,138538,132849,5689,4.1
12085,7/1/19,74122,71540,2582,3.5
12086,7/1/19,1384625,1349121,35504,2.6
12087,7/1/19,46569,45572,997,2.1
12089,7/1/19,41648,40314,1334,3.2
12091,7/1/19,100695,97893,2802,2.8
12093,7/1/19,17087,16380,707,4.1
12095,7/1/19,769813,745361,24452,3.2
12097,7/1/19,186151,179445,6706,3.6
12099,7/1/19,733996,707456,26540,3.6
12101,7/1/19,239631,230657,8974,3.7
12103,7/1/19,497493,481850,15643,3.1
12105,7/1/19,306720,294118,12602,4.1
12107,7/1/19,26071,24828,1243,4.8
12109,7/1/19,133704,129860,3844,2.9
12111,7/1/19,145234,138910,6324,4.4
12113,7/1/19,84266,81481,2785,3.3
12115,7/1/19,188569,182317,6252,3.3
12117,7/1/19,257777,249660,8117,3.1
12119,7/1/19,32201,30649,1552,4.8
12121,7/1/19,17725,17048,677,3.8
12123,7/1/19,8286,7956,330,4
12125,7/1/19,4518,4364,154,3.4
12127,7/1/19,255926,246484,9442,3.7
12129,7/1/19,14817,14334,483,3.3
12131,7/1/19,32764,31816,948,2.9
12133,7/1/19,9665,9318,347,3.6
13001,7/1/19,9179,8714,465,5.1
13003,7/1/19,4760,4481,279,5.9
13005,7/1/19,4905,4698,207,4.2
13007,7/1/19,1136,1073,63,5.5
13009,7/1/19,17080,16263,817,4.8
13011,7/1/19,9450,9144,306,3.2
13013,7/1/19,40538,39290,1248,3.1
13015,7/1/19,50733,48915,1818,3.6
13017,7/1/19,5413,5040,373,6.9
13019,7/1/19,7315,6988,327,4.5
13021,7/1/19,68073,65104,2969,4.4
13023,7/1/19,4422,4160,262,5.9
13025,7/1/19,7355,7025,330,4.5
13027,7/1/19,6806,6547,259,3.8
13029,7/1/19,18437,17811,626,3.4
13031,7/1/19,35876,34219,1657,4.6
13033,7/1/19,9175,8609,566,6.2
13035,7/1/19,10765,10381,384,3.6
13037,7/1/19,2148,2055,93,4.3
13039,7/1/19,20871,20048,823,3.9
13043,7/1/19,5471,5258,213,3.9
13045,7/1/19,55482,53373,2109,3.8
13047,7/1/19,33555,32463,1092,3.3
13049,7/1/19,4760,4567,193,4.1
13051,7/1/19,140719,135675,5044,3.6
13053,7/1/19,1990,1888,102,5.1
13055,7/1/19,10169,9701,468,4.6
13057,7/1/19,136465,132380,4085,3
13059,7/1/19,58613,56221,2392,4.1
13061,7/1/19,877,807,70,8
13063,7/1/19,138658,132154,6504,4.7
13065,7/1/19,2639,2513,126,4.8
13067,7/1/19,427191,413401,13790,3.2
13069,7/1/19,18828,17917,911,4.8
13071,7/1/19,21179,20352,827,3.9
13073,7/1/19,75154,72584,2570,3.4
13075,7/1/19,7924,7621,303,3.8
13077,7/1/19,74960,72502,2458,3.3
13079,7/1/19,5606,5371,235,4.2
13081,7/1/19,9505,9118,387,4.1
13083,7/1/19,8228,7936,292,3.5
13085,7/1/19,12366,11981,385,3.1
13087,7/1/19,11392,10929,463,4.1
13089,7/1/19,401528,386463,15065,3.8
13091,7/1/19,7092,6594,498,7
13093,7/1/19,5021,4816,205,4.1
13095,7/1/19,38340,36332,2008,5.2
13097,7/1/19,73615,70778,2837,3.9
13099,7/1/19,4331,4148,183,4.2
13101,7/1/19,1862,1804,58,3.1
13103,7/1/19,31102,30122,980,3.2
13105,7/1/19,7692,7340,352,4.6
13107,7/1/19,8309,7636,673,8.1
13109,7/1/19,4871,4688,183,3.8
13111,7/1/19,11667,11208,459,3.9
13113,7/1/19,58248,56348,1900,3.3
13115,7/1/19,44436,42353,2083,4.7
13117,7/1/19,122616,118906,3710,3
13119,7/1/19,9842,9451,391,4
13121,7/1/19,559994,538503,21491,3.8
13123,7/1/19,11855,11399,456,3.8
13125,7/1/19,1251,1196,55,4.4
13127,7/1/19,40005,38623,1382,3.5
13129,7/1/19,28255,27088,1167,4.1
13131,7/1/19,10281,9881,400,3.9
13133,7/1/19,7150,6859,291,4.1
13135,7/1/19,492279,475847,16432,3.3
13137,7/1/19,18888,18079,809,4.3
13139,7/1/19,102131,98941,3190,3.1
13141,7/1/19,2386,2229,157,6.6
13143,7/1/19,12626,12164,462,3.7
13145,7/1/19,16613,16032,581,3.5
13147,7/1/19,11489,11018,471,4.1
13149,7/1/19,5271,5070,201,3.8
13151,7/1/19,116104,111554,4550,3.9
13153,7/1/19,70481,67924,2557,3.6
13155,7/1/19,3304,3117,187,5.7
13157,7/1/19,36050,34982,1068,3
13159,7/1/19,6945,6720,225,3.2
13161,7/1/19,6128,5786,342,5.6
13163,7/1/19,6581,6178,403,6.1
13165,7/1/19,3153,2949,204,6.5
13167,7/1/19,3978,3797,181,4.6
13169,7/1/19,13683,13208,475,3.5
13171,7/1/19,8276,7931,345,4.2
13173,7/1/19,3738,3575,163,4.4
13175,7/1/19,19036,17896,1140,6
13177,7/1/19,14671,14193,478,3.3
13179,7/1/19,26193,25069,1124,4.3
13181,7/1/19,3519,3378,141,4
13183,7/1/19,8135,7787,348,4.3
13185,7/1/19,51091,49098,1993,3.9
13187,7/1/19,16479,15893,586,3.6
13189,7/1/19,8917,8363,554,6.2
13191,7/1/19,6229,5991,238,3.8
13193,7/1/19,4590,4358,232,5.1
13195,7/1/19,13139,12706,433,3.3
13197,7/1/19,3298,3142,156,4.7
13199,7/1/19,8980,8503,477,5.3
13201,7/1/19,2723,2629,94,3.5
13205,7/1/19,8333,7894,439,5.3
13207,7/1/19,12982,12526,456,3.5
13209,7/1/19,3812,3553,259,6.8
13211,7/1/19,9244,8928,316,3.4
13213,7/1/19,15544,14730,814,5.2
13215,7/1/19,77592,73625,3967,5.1
13217,7/1/19,52453,50235,2218,4.2
13219,7/1/19,19313,18762,551,2.9
13221,7/1/19,6839,6586,253,3.7
13223,7/1/19,86293,83495,2798,3.2
13225,7/1/19,11825,11281,544,4.6
13227,7/1/19,15349,14841,508,3.3
13229,7/1/19,8749,8434,315,3.6
13231,7/1/19,8933,8635,298,3.3
13233,7/1/19,18535,17799,736,4
13235,7/1/19,4050,3872,178,4.4
13237,7/1/19,8215,7833,382,4.7
13239,7/1/19,803,758,45,5.6
13241,7/1/19,7474,7201,273,3.7
13243,7/1/19,2459,2314,145,5.9
13245,7/1/19,85315,80909,4406,5.2
13247,7/1/19,44975,43138,1837,4.1
13249,7/1/19,2188,2091,97,4.4
13251,7/1/19,5060,4720,340,6.7
13253,7/1/19,2999,2855,144,4.8
13255,7/1/19,28776,27558,1218,4.2
13257,7/1/19,10678,10210,468,4.4
13259,7/1/19,2392,2284,108,4.5
13261,7/1/19,12585,11917,668,5.3
13263,7/1/19,2816,2677,139,4.9
13265,7/1/19,577,547,30,5.2
13267,7/1/19,9532,9109,423,4.4
13269,7/1/19,3137,3001,136,4.3
13271,7/1/19,4167,3629,538,12.9
13273,7/1/19,3523,3310,213,6
13275,7/1/19,16275,15524,751,4.6
13277,7/1/19,19716,18989,727,3.7
13279,7/1/19,11696,10923,773,6.6
13281,7/1/19,3950,3736,214,5.4
13283,7/1/19,2706,2489,217,8
13285,7/1/19,37853,36330,1523,4
13287,7/1/19,3115,2995,120,3.9
13289,7/1/19,2892,2708,184,6.4
13291,7/1/19,10193,9848,345,3.4
13293,7/1/19,11350,10921,429,3.8
13295,7/1/19,31300,30160,1140,3.6
13297,7/1/19,46206,44653,1553,3.4
13299,7/1/19,15655,15051,604,3.9
13301,7/1/19,2874,2688,186,6.5
13303,7/1/19,7006,6687,319,4.6
13305,7/1/19,11476,10963,513,4.5
13307,7/1/19,987,932,55,5.6
13309,7/1/19,1607,1447,160,10
13311,7/1/19,16324,15856,468,2.9
13313,7/1/19,43767,41718,2049,4.7
13315,7/1/19,2610,2477,133,5.1
13317,7/1/19,3873,3687,186,4.8
13319,7/1/19,4006,3826,180,4.5
13321,7/1/19,8812,8466,346,3.9
15001,7/1/19,91668,88240,3428,3.7
15003,7/1/19,450177,438428,11749,2.6
15007,7/1/19,37583,36595,988,2.6
15009,7/1/19,87789,85525,2264,2.6
16001,7/1/19,256223,249912,6311,2.5
16003,7/1/19,1816,1726,90,5
16005,7/1/19,42646,41276,1370,3.2
16007,7/1/19,3054,2988,66,2.2
16009,7/1/19,4186,4038,148,3.5
16011,7/1/19,23972,23332,640,2.7
16013,7/1/19,13121,12841,280,2.1
16015,7/1/19,3525,3393,132,3.7
16017,7/1/19,20723,20063,660,3.2
16019,7/1/19,57921,56652,1269,2.2
16021,7/1/19,5566,5389,177,3.2
16023,7/1/19,1422,1391,31,2.2
16025,7/1/19,725,711,14,1.9
16027,7/1/19,106166,102741,3425,3.2
16029,7/1/19,4158,4064,94,2.3
16031,7/1/19,12459,12168,291,2.3
16033,7/1/19,392,378,14,3.6
16035,7/1/19,2981,2813,168,5.6
16037,7/1/19,2574,2507,67,2.6
16039,7/1/19,11871,11491,380,3.2
16041,7/1/19,6771,6624,147,2.2
16043,7/1/19,7997,7851,146,1.8
16045,7/1/19,8393,8139,254,3
16047,7/1/19,8294,8105,189,2.3
16049,7/1/19,6792,6533,259,3.8
16051,7/1/19,14288,13995,293,2.1
16053,7/1/19,12297,12018,279,2.3
16055,7/1/19,82244,79865,2379,2.9
16057,7/1/19,19385,18857,528,2.7
16059,7/1/19,3830,3703,127,3.3
16061,7/1/19,1729,1645,84,4.9
16063,7/1/19,2831,2755,76,2.7
16065,7/1/19,22573,22163,410,1.8
16067,7/1/19,11594,11321,273,2.4
16069,7/1/19,21128,20572,556,2.6
16071,7/1/19,2359,2314,45,1.9
16073,7/1/19,5830,5656,174,3
16075,7/1/19,11700,11283,417,3.6
16077,7/1/19,4070,3927,143,3.5
16079,7/1/19,5210,4966,244,4.7
16081,7/1/19,7531,7415,116,1.5
16083,7/1/19,41878,40757,1121,2.7
16085,7/1/19,6139,5986,153,2.5
16087,7/1/19,4663,4485,178,3.8
17001,7/1/19,32844,31695,1149,3.5
17003,7/1/19,2019,1867,152,7.5
17005,7/1/19,7963,7663,300,3.8
17007,7/1/19,27053,25163,1890,7
17009,7/1/19,3058,2979,79,2.6
17011,7/1/19,17739,17013,726,4.1
17013,7/1/19,2370,2256,114,4.8
17015,7/1/19,7635,7367,268,3.5
17017,7/1/19,6233,5981,252,4
17019,7/1/19,106052,101580,4472,4.2
17021,7/1/19,14874,14148,726,4.9
17023,7/1/19,7743,7407,336,4.3
17025,7/1/19,6573,6265,308,4.7
17027,7/1/19,20819,20181,638,3.1
17029,7/1/19,22873,21811,1062,4.6
17031,7/1/19,2634510,2523036,111474,4.2
17033,7/1/19,8726,8366,360,4.1
17035,7/1/19,6066,5863,203,3.3
17037,7/1/19,56561,53964,2597,4.6
17039,7/1/19,7451,7128,323,4.3
17041,7/1/19,10311,9903,408,4
17043,7/1/19,515291,498352,16939,3.3
17045,7/1/19,9143,8746,397,4.3
17047,7/1/19,2794,2688,106,3.8
17049,7/1/19,19649,19015,634,3.2
17051,7/1/19,10106,9688,418,4.1
17053,7/1/19,6390,6109,281,4.4
17055,7/1/19,16477,15584,893,5.4
17057,7/1/19,15473,14578,895,5.8
17059,7/1/19,2377,2257,120,5
17061,7/1/19,6080,5807,273,4.5
17063,7/1/19,25851,24618,1233,4.8
17065,7/1/19,4375,4201,174,4
17067,7/1/19,8661,8211,450,5.2
17069,7/1/19,1306,1208,98,7.5
17071,7/1/19,3729,3565,164,4.4
17073,7/1/19,25785,24667,1118,4.3
17075,7/1/19,14799,14243,556,3.8
17077,7/1/19,27940,26791,1149,4.1
17079,7/1/19,4683,4472,211,4.5
17081,7/1/19,17717,16831,886,5
17083,7/1/19,11157,10659,498,4.5
17085,7/1/19,11224,10847,377,3.4
17087,7/1/19,4035,3799,236,5.8
17089,7/1/19,277864,266080,11784,4.2
17091,7/1/19,56811,54164,2647,4.7
17093,7/1/19,69867,67271,2596,3.7
17095,7/1/19,22155,21082,1073,4.8
17097,7/1/19,387122,372238,14884,3.8
17099,7/1/19,55411,52601,2810,5.1
17101,7/1/19,5925,5613,312,5.3
17103,7/1/19,18086,17384,702,3.9
17105,7/1/19,16921,16239,682,4
17107,7/1/19,12732,12126,606,4.8
17109,7/1/19,12616,11647,969,7.7
17111,7/1/19,167835,161935,5900,3.5
17113,7/1/19,87773,84188,3585,4.1
17115,7/1/19,49761,46994,2767,5.6
17117,7/1/19,23390,22419,971,4.2
17119,7/1/19,136614,130903,5711,4.2
17121,7/1/19,17808,16998,810,4.5
17123,7/1/19,5467,5231,236,4.3
17125,7/1/19,6456,6119,337,5.2
17127,7/1/19,5752,5401,351,6.1
17129,7/1/19,6599,6382,217,3.3
17131,7/1/19,8329,7990,339,4.1
17133,7/1/19,19133,18507,626,3.3
17135,7/1/19,11884,11294,590,5
17137,7/1/19,16715,16047,668,4
17139,7/1/19,7816,7532,284,3.6
17141,7/1/19,25324,24116,1208,4.8
17143,7/1/19,87057,82656,4401,5.1
17145,7/1/19,8437,7978,459,5.4
17147,7/1/19,8429,8115,314,3.7
17149,7/1/19,7208,6919,289,4
17151,7/1/19,1678,1580,98,5.8
17153,7/1/19,1946,1821,125,6.4
17155,7/1/19,3096,2961,135,4.4
17157,7/1/19,14494,13960,534,3.7
17159,7/1/19,7376,7073,303,4.1
17161,7/1/19,73285,69906,3379,4.6
17163,7/1/19,128900,122729,6171,4.8
17165,7/1/19,9585,9066,519,5.4
17167,7/1/19,102774,98562,4212,4.1
17169,7/1/19,3346,3199,147,4.4
17171,7/1/19,2565,2463,102,4
17173,7/1/19,10859,10430,429,4
17175,7/1/19,2617,2483,134,5.1
17177,7/1/19,22292,21309,983,4.4
17179,7/1/19,65468,62635,2833,4.3
17181,7/1/19,7457,7062,395,5.3
17183,7/1/19,33538,31719,1819,5.4
17185,7/1/19,5975,5732,243,4.1
17187,7/1/19,8656,8274,382,4.4
17189,7/1/19,10577,10312,265,2.5
17191,7/1/19,7095,6756,339,4.8
17193,7/1/19,6654,6404,250,3.8
17195,7/1/19,29226,27985,1241,4.2
17197,7/1/19,363232,348073,15159,4.2
17199,7/1/19,31901,30482,1419,4.4
17201,7/1/19,143053,133481,9572,6.7
17203,7/1/19,19250,18566,684,3.6
18001,7/1/19,17374,16802,572,3.3
18003,7/1/19,188704,182227,6477,3.4
18005,7/1/19,45627,44453,1174,2.6
18007,7/1/19,4596,4438,158,3.4
18009,7/1/19,5068,4877,191,3.8
18011,7/1/19,37148,36179,969,2.6
18013,7/1/19,7891,7655,236,3
18015,7/1/19,10204,9891,313,3.1
18017,7/1/19,17974,17355,619,3.4
18019,7/1/19,62933,60669,2264,3.6
18021,7/1/19,12112,11684,428,3.5
18023,7/1/19,17415,16930,485,2.8
18025,7/1/19,4903,4712,191,3.9
18027,7/1/19,17163,16696,467,2.7
18029,7/1/19,26482,25503,979,3.7
18031,7/1/19,15330,14898,432,2.8
18033,7/1/19,23244,22537,707,3
18035,7/1/19,52618,50405,2213,4.2
18037,7/1/19,23783,23172,611,2.6
18039,7/1/19,110236,106100,4136,3.8
18041,7/1/19,8698,8250,448,5.2
18043,7/1/19,42454,41057,1397,3.3
18045,7/1/19,8213,7927,286,3.5
18047,7/1/19,11674,11269,405,3.5
18049,7/1/19,10301,9999,302,2.9
18051,7/1/19,19724,19216,508,2.6
18053,7/1/19,31032,29800,1232,4
18055,7/1/19,13429,12888,541,4
18057,7/1/19,187609,182562,5047,2.7
18059,7/1/19,41201,39948,1253,3
18061,7/1/19,20748,20032,716,3.5
18063,7/1/19,91788,89166,2622,2.9
18065,7/1/19,22323,21558,765,3.4
18067,7/1/19,36999,35565,1434,3.9
18069,7/1/19,18517,17904,613,3.3
18071,7/1/19,23354,22679,675,2.9
18073,7/1/19,16674,16069,605,3.6
18075,7/1/19,9701,9419,282,2.9
18077,7/1/19,14998,14449,549,3.7
18079,7/1/19,13769,13323,446,3.2
18081,7/1/19,84733,82356,2377,2.8
18083,7/1/19,18742,18119,623,3.3
18085,7/1/19,43042,41676,1366,3.2
18087,7/1/19,19797,19127,670,3.4
18089,7/1/19,233882,222404,11478,4.9
18091,7/1/19,48620,46594,2026,4.2
18093,7/1/19,20813,20048,765,3.7
18095,7/1/19,60406,58172,2234,3.7
18097,7/1/19,500782,483288,17494,3.5
18099,7/1/19,23949,23161,788,3.3
18101,7/1/19,5587,5441,146,2.6
18103,7/1/19,15529,14898,631,4.1
18105,7/1/19,66723,64208,2515,3.8
18107,7/1/19,19177,18533,644,3.4
18109,7/1/19,37147,35983,1164,3.1
18111,7/1/19,7172,6870,302,4.2
18113,7/1/19,24374,23465,909,3.7
18115,7/1/19,3256,3145,111,3.4
18117,7/1/19,8687,8368,319,3.7
18119,7/1/19,8980,8606,374,4.2
18121,7/1/19,7342,7064,278,3.8
18123,7/1/19,9476,9143,333,3.5
18125,7/1/19,6265,6051,214,3.4
18127,7/1/19,88209,84844,3365,3.8
18129,7/1/19,13894,13493,401,2.9
18131,7/1/19,6780,6570,210,3.1
18133,7/1/19,17191,16582,609,3.5
18135,7/1/19,11334,10912,422,3.7
18137,7/1/19,14708,14221,487,3.3
18139,7/1/19,9264,9005,259,2.8
18141,7/1/19,135395,130043,5352,4
18143,7/1/19,10777,10370,407,3.8
18145,7/1/19,23713,22977,736,3.1
18147,7/1/19,11601,11239,362,3.1
18149,7/1/19,10088,9654,434,4.3
18151,7/1/19,21342,20748,594,2.8
18153,7/1/19,8468,8106,362,4.3
18155,7/1/19,5112,4937,175,3.4
18157,7/1/19,97004,93890,3114,3.2
18159,7/1/19,9493,9232,261,2.7
18161,7/1/19,3666,3543,123,3.4
18163,7/1/19,95824,92710,3114,3.2
18165,7/1/19,7058,6694,364,5.2
18167,7/1/19,48330,46179,2151,4.5
18169,7/1/19,15204,14708,496,3.3
18171,7/1/19,4264,4134,130,3
18173,7/1/19,33563,32510,1053,3.1
18175,7/1/19,14124,13649,475,3.4
18177,7/1/19,30713,29522,1191,3.9
18179,7/1/19,14725,14324,401,2.7
18181,7/1/19,13826,13448,378,2.7
18183,7/1/19,18080,17523,557,3.1
19001,7/1/19,4362,4270,92,2.1
19003,7/1/19,2270,2230,40,1.8
19005,7/1/19,7472,7262,210,2.8
19007,7/1/19,6207,5975,232,3.7
19009,7/1/19,3182,3104,78,2.5
19011,7/1/19,13866,13465,401,2.9
19013,7/1/19,70814,68229,2585,3.7
19015,7/1/19,15260,14872,388,2.5
19017,7/1/19,14129,13768,361,2.6
19019,7/1/19,11725,11423,302,2.6
19021,7/1/19,11601,11291,310,2.7
19023,7/1/19,8015,7772,243,3
19025,7/1/19,4277,4166,111,2.6
19027,7/1/19,11414,11171,243,2.1
19029,7/1/19,7084,6898,186,2.6
19031,7/1/19,10989,10716,273,2.5
19033,7/1/19,24555,23869,686,2.8
19035,7/1/19,6300,6124,176,2.8
19037,7/1/19,6495,6320,175,2.7
19039,7/1/19,5037,4907,130,2.6
19041,7/1/19,8713,8477,236,2.7
19043,7/1/19,10447,10173,274,2.6
19045,7/1/19,23570,22734,836,3.5
19047,7/1/19,8224,7970,254,3.1
19049,7/1/19,51580,50475,1105,2.1
19051,7/1/19,4286,4167,119,2.8
19053,7/1/19,4303,4193,110,2.6
19055,7/1/19,10893,10645,248,2.3
19057,7/1/19,20208,19443,765,3.8
19059,7/1/19,11623,11344,279,2.4
19061,7/1/19,57512,56067,1445,2.5
19063,7/1/19,5524,5335,189,3.4
19065,7/1/19,10334,9962,372,3.6
19067,7/1/19,9158,8885,273,3
19069,7/1/19,5878,5744,134,2.3
19071,7/1/19,3749,3627,122,3.3
19073,7/1/19,5566,5395,171,3.1
19075,7/1/19,6618,6416,202,3.1
19077,7/1/19,5766,5616,150,2.6
19079,7/1/19,7043,6840,203,2.9
19081,7/1/19,6045,5901,144,2.4
19083,7/1/19,8211,7956,255,3.1
19085,7/1/19,7594,7413,181,2.4
19087,7/1/19,9905,9609,296,3
19089,7/1/19,5290,5167,123,2.3
19091,7/1/19,5178,5051,127,2.5
19093,7/1/19,4199,4118,81,1.9
19095,7/1/19,10815,10595,220,2
19097,7/1/19,11364,11052,312,2.7
19099,7/1/19,20328,19763,565,2.8
19101,7/1/19,10141,9878,263,2.6
19103,7/1/19,89040,86967,2073,2.3
19105,7/1/19,10916,10625,291,2.7
19107,7/1/19,5299,5145,154,2.9
19109,7/1/19,8576,8406,170,2
19111,7/1/19,16628,15936,692,4.2
19113,7/1/19,126263,122488,3775,3
19115,7/1/19,6234,6049,185,3
19117,7/1/19,4820,4710,110,2.3
19119,7/1/19,7298,7182,116,1.6
19121,7/1/19,8850,8574,276,3.1
19123,7/1/19,12195,11860,335,2.7
19125,7/1/19,19034,18616,418,2.2
19127,7/1/19,18463,17783,680,3.7
19129,7/1/19,7648,7462,186,2.4
19131,7/1/19,7391,7274,117,1.6
19133,7/1/19,4533,4390,143,3.2
19135,7/1/19,4120,4006,114,2.8
19137,7/1/19,5141,4994,147,2.9
19139,7/1/19,22882,22260,622,2.7
19141,7/1/19,8488,8297,191,2.3
19143,7/1/19,3608,3531,77,2.1
19145,7/1/19,6566,6383,183,2.8
19147,7/1/19,4860,4749,111,2.3
19149,7/1/19,15244,14893,351,2.3
19151,7/1/19,4662,4573,89,1.9
19153,7/1/19,280036,272155,7881,2.8
19155,7/1/19,50388,49153,1235,2.5
19157,7/1/19,10298,10022,276,2.7
19159,7/1/19,2509,2433,76,3
19161,7/1/19,5437,5304,133,2.4
19163,7/1/19,93568,90551,3017,3.2
19165,7/1/19,6998,6856,142,2
19167,7/1/19,21017,20615,402,1.9
19169,7/1/19,56843,55535,1308,2.3
19171,7/1/19,9788,9526,262,2.7
19173,7/1/19,3281,3211,70,2.1
19175,7/1/19,6464,6261,203,3.1
19177,7/1/19,3842,3741,101,2.6
19179,7/1/19,18364,17667,697,3.8
19181,7/1/19,29464,28728,736,2.5
19183,7/1/19,12295,12007,288,2.3
19185,7/1/19,2861,2784,77,2.7
19187,7/1/19,20141,19474,667,3.3
19189,7/1/19,5232,5085,147,2.8
19191,7/1/19,11581,11296,285,2.5
19193,7/1/19,57489,55950,1539,2.7
19195,7/1/19,4364,4253,111,2.5
19197,7/1/19,7229,7040,189,2.6
20001,7/1/19,6332,6047,285,4.5
20003,7/1/19,4363,4188,175,4
20005,7/1/19,7086,6602,484,6.8
20007,7/1/19,2366,2298,68,2.9
20009,7/1/19,13744,13272,472,3.4
20011,7/1/19,6741,6416,325,4.8
20013,7/1/19,5440,5237,203,3.7
20015,7/1/19,33200,31938,1262,3.8
20017,7/1/19,1640,1594,46,2.8
20019,7/1/19,1461,1397,64,4.4
20021,7/1/19,10341,9873,468,4.5
20023,7/1/19,1310,1270,40,3.1
20025,7/1/19,1076,1046,30,2.8
20027,7/1/19,3698,3543,155,4.2
20029,7/1/19,3855,3700,155,4
20031,7/1/19,3938,3737,201,5.1
20033,7/1/19,866,840,26,3
20035,7/1/19,16197,15500,697,4.3
20037,7/1/19,18981,18073,908,4.8
20039,7/1/19,1275,1231,44,3.5
20041,7/1/19,8829,8491,338,3.8
20043,7/1/19,4260,4091,169,4
20045,7/1/19,63017,60715,2302,3.7
20047,7/1/19,1453,1405,48,3.3
20049,7/1/19,1051,997,54,5.1
20051,7/1/19,17123,16645,478,2.8
20053,7/1/19,2793,2683,110,3.9
20055,7/1/19,20704,20103,601,2.9
20057,7/1/19,17151,16647,504,2.9
20059,7/1/19,14187,13614,573,4
20061,7/1/19,11075,10510,565,5.1
20063,7/1/19,1469,1433,36,2.5
20065,7/1/19,1134,1092,42,3.7
20067,7/1/19,3222,3107,115,3.6
20069,7/1/19,3045,2971,74,2.4
20071,7/1/19,786,764,22,2.8
20073,7/1/19,3076,2943,133,4.3
20075,7/1/19,1588,1550,38,2.4
20077,7/1/19,2786,2696,90,3.2
20079,7/1/19,17352,16755,597,3.4
20081,7/1/19,2211,2151,60,2.7
20083,7/1/19,1023,991,32,3.1
20085,7/1/19,7388,7143,245,3.3
20087,7/1/19,10390,10046,344,3.3
20089,7/1/19,1293,1251,42,3.2
20091,7/1/19,348267,336795,11472,3.3
20093,7/1/19,2028,1970,58,2.9
20095,7/1/19,3495,3374,121,3.5
20097,7/1/19,1244,1206,38,3.1
20099,7/1/19,10075,9601,474,4.7
20101,7/1/19,755,733,22,2.9
20103,7/1/19,37518,36005,1513,4
20105,7/1/19,1639,1595,44,2.7
20107,7/1/19,4545,4266,279,6.1
20109,7/1/19,1505,1467,38,2.5
20111,7/1/19,16620,15935,685,4.1
20113,7/1/19,17268,16788,480,2.8
20115,7/1/19,5926,5699,227,3.8
20117,7/1/19,5623,5442,181,3.2
20119,7/1/19,2169,2109,60,2.8
20121,7/1/19,17916,17273,643,3.6
20123,7/1/19,3431,3335,96,2.8
20125,7/1/19,14992,14269,723,4.8
20127,7/1/19,2954,2862,92,3.1
20129,7/1/19,1101,1059,42,3.8
20131,7/1/19,5423,5238,185,3.4
20133,7/1/19,6252,5902,350,5.6
20135,7/1/19,1368,1328,40,2.9
20137,7/1/19,2768,2692,76,2.7
20139,7/1/19,8199,7890,309,3.8
20141,7/1/19,2036,1986,50,2.5
20143,7/1/19,3054,2958,96,3.1
20145,7/1/19,2979,2889,90,3
20147,7/1/19,2566,2482,84,3.3
20149,7/1/19,11908,11506,402,3.4
20151,7/1/19,4880,4729,151,3.1
20153,7/1/19,1539,1497,42,2.7
20155,7/1/19,29856,28759,1097,3.7
20157,7/1/19,2296,2222,74,3.2
20159,7/1/19,5402,5227,175,3.2
20161,7/1/19,33609,32408,1201,3.6
20163,7/1/19,2530,2422,108,4.3
20165,7/1/19,1671,1619,52,3.1
20167,7/1/19,3312,3202,110,3.3
20169,7/1/19,30632,29603,1029,3.4
20171,7/1/19,2955,2885,70,2.4
20173,7/1/19,256515,246335,10180,4
20175,7/1/19,9599,9229,370,3.9
20177,7/1/19,93251,89765,3486,3.7
20179,7/1/19,1394,1360,34,2.4
20181,7/1/19,2906,2808,98,3.4
20183,7/1/19,1918,1854,64,3.3
20185,7/1/19,1959,1889,70,3.6
20187,7/1/19,990,960,30,3
20189,7/1/19,2543,2465,78,3.1
20191,7/1/19,11140,10700,440,3.9
20193,7/1/19,4358,4237,121,2.8
20195,7/1/19,1434,1388,46,3.2
20197,7/1/19,3746,3617,129,3.4
20199,7/1/19,814,786,28,3.4
20201,7/1/19,2924,2830,94,3.2
20203,7/1/19,1220,1186,34,2.8
20205,7/1/19,3946,3761,185,4.7
20207,7/1/19,1611,1527,84,5.2
20209,7/1/19,79896,75561,4335,5.4
21001,7/1/19,7038,6633,405,5.8
21003,7/1/19,9054,8628,426,4.7
21005,7/1/19,12214,11679,535,4.4
21007,7/1/19,3569,3347,222,6.2
21009,7/1/19,18958,18032,926,4.9
21011,7/1/19,4644,4342,302,6.5
21013,7/1/19,8402,7781,621,7.4
21015,7/1/19,72403,69752,2651,3.7
21017,7/1/19,10074,9671,403,4
21019,7/1/19,17929,16814,1115,6.2
21021,7/1/19,12526,11840,686,5.5
21023,7/1/19,3888,3696,192,4.9
21025,7/1/19,3398,3115,283,8.3
21027,7/1/19,8141,7679,462,5.7
21029,7/1/19,43741,41621,2120,4.8
21031,7/1/19,5061,4775,286,5.7
21033,7/1/19,5463,5166,297,5.4
21035,7/1/19,18795,17907,888,4.7
21037,7/1/19,51806,49791,2015,3.9
21039,7/1/19,2211,2111,100,4.5
21041,7/1/19,5385,5152,233,4.3
21043,7/1/19,9755,8853,902,9.2
21045,7/1/19,6769,6450,319,4.7
21047,7/1/19,25326,23738,1588,6.3
21049,7/1/19,17354,16604,750,4.3
21051,7/1/19,5122,4714,408,8
21053,7/1/19,4100,3873,227,5.5
21055,7/1/19,3766,3574,192,5.1
21057,7/1/19,3234,3109,125,3.9
21059,7/1/19,48294,46260,2034,4.2
21061,7/1/19,4787,4528,259,5.4
21063,7/1/19,2035,1860,175,8.6
21065,7/1/19,5304,5024,280,5.3
21067,7/1/19,177166,170515,6651,3.8
21069,7/1/19,6276,5908,368,5.9
21071,7/1/19,10963,10193,770,7
21073,7/1/19,25537,24449,1088,4.3
21075,7/1/19,2119,1973,146,6.9
21077,7/1/19,4184,4006,178,4.3
21079,7/1/19,7630,7238,392,5.1
21081,7/1/19,11940,11435,505,4.2
21083,7/1/19,15934,15138,796,5
21085,7/1/19,11049,10336,713,6.5
21087,7/1/19,5156,4888,268,5.2
21089,7/1/19,13531,12542,989,7.3
21091,7/1/19,4058,3890,168,4.1
21093,7/1/19,50370,48034,2336,4.6
21095,7/1/19,6756,5894,862,12.8
21097,7/1/19,8894,8476,418,4.7
21099,7/1/19,7908,7514,394,5
21101,7/1/19,22233,21313,920,4.1
21103,7/1/19,8423,8069,354,4.2
21105,7/1/19,1819,1727,92,5.1
21107,7/1/19,18872,17933,939,5
21109,7/1/19,4076,3789,287,7
21111,7/1/19,408252,388786,19466,4.8
21113,7/1/19,26797,25685,1112,4.1
21115,7/1/19,6835,6363,472,6.9
21117,7/1/19,89613,86149,3464,3.9
21119,7/1/19,4544,4182,362,8
21121,7/1/19,9943,9265,678,6.8
21123,7/1/19,6111,5797,314,5.1
21125,7/1/19,24635,23258,1377,5.6
21127,7/1/19,5171,4790,381,7.4
21129,7/1/19,2090,1952,138,6.6
21131,7/1/19,2775,2470,305,11
21133,7/1/19,6248,5718,530,8.5
21135,7/1/19,4668,4228,440,9.4
21137,7/1/19,9299,8778,521,5.6
21139,7/1/19,3697,3489,208,5.6
21141,7/1/19,12621,12064,557,4.4
21143,7/1/19,3375,3211,164,4.9
21145,7/1/19,29512,27929,1583,5.4
21147,7/1/19,4827,4520,307,6.4
21149,7/1/19,4323,4121,202,4.7
21151,7/1/19,47067,44963,2104,4.5
21153,7/1/19,3052,2725,327,10.7
21155,7/1/19,9876,9455,421,4.3
21157,7/1/19,15417,14647,770,5
21159,7/1/19,2748,2534,214,7.8
21161,7/1/19,7191,6737,454,6.3
21163,7/1/19,12634,11989,645,5.1
21165,7/1/19,2315,2158,157,6.8
21167,7/1/19,10114,9599,515,5.1
21169,7/1/19,4164,3929,235,5.6
21171,7/1/19,4719,4519,200,4.2
21173,7/1/19,11716,11022,694,5.9
21175,7/1/19,4586,4322,264,5.8
21177,7/1/19,10396,9672,724,7
21179,7/1/19,23428,22259,1169,5
21181,7/1/19,3310,3148,162,4.9
21183,7/1/19,9955,9396,559,5.6
21185,7/1/19,33939,32640,1299,3.8
21187,7/1/19,5157,4898,259,5
21189,7/1/19,1155,1069,86,7.4
21191,7/1/19,7103,6812,291,4.1
21193,7/1/19,8302,7746,556,6.7
21195,7/1/19,20168,18897,1271,6.3
21197,7/1/19,5117,4834,283,5.5
21199,7/1/19,26945,25594,1351,5
21201,7/1/19,822,773,49,6
21203,7/1/19,6656,6291,365,5.5
21205,7/1/19,10288,9685,603,5.9
21207,7/1/19,6381,6024,357,5.6
21209,7/1/19,29518,28363,1155,3.9
21211,7/1/19,26075,25054,1021,3.9
21213,7/1/19,8921,8486,435,4.9
21215,7/1/19,10403,9966,437,4.2
21217,7/1/19,12616,11944,672,5.3
21219,7/1/19,5512,5285,227,4.1
21221,7/1/19,6107,5797,310,5.1
21223,7/1/19,3965,3774,191,4.8
21225,7/1/19,6207,5907,300,4.8
21227,7/1/19,64631,61785,2846,4.4
21229,7/1/19,6350,6083,267,4.2
21231,7/1/19,7707,7259,448,5.8
21233,7/1/19,5926,5670,256,4.3
21235,7/1/19,13734,12935,799,5.8
21237,7/1/19,1941,1776,165,8.5
21239,7/1/19,15289,14755,534,3.5
22001,7/1/19,24168,22756,1412,5.8
22003,7/1/19,8636,8069,567,6.6
22005,7/1/19,63906,60964,2942,4.6
22007,7/1/19,8991,8395,596,6.6
22009,7/1/19,15299,14229,1070,7
22011,7/1/19,14690,13824,866,5.9
22013,7/1/19,5649,5292,357,6.3
22015,7/1/19,58550,55704,2846,4.9
22017,7/1/19,105226,98930,6296,6
22019,7/1/19,107127,102152,4975,4.6
22021,7/1/19,3744,3514,230,6.1
22023,7/1/19,3969,3799,170,4.3
22025,7/1/19,3480,3220,260,7.5
22027,7/1/19,5920,5563,357,6
22029,7/1/19,7107,6564,543,7.6
22031,7/1/19,11023,10295,728,6.6
22033,7/1/19,230923,219103,11820,5.1
22035,7/1/19,1924,1698,226,11.7
22037,7/1/19,8010,7581,429,5.4
22039,7/1/19,11882,11032,850,7.2
22041,7/1/19,7589,6990,599,7.9
22043,7/1/19,8367,7786,581,6.9
22045,7/1/19,28595,26891,1704,6
22047,7/1/19,14008,13105,903,6.4
22049,7/1/19,6886,6513,373,5.4
22051,7/1/19,215383,205178,10205,4.7
22053,7/1/19,13521,12789,732,5.4
22055,7/1/19,115480,109896,5584,4.8
22057,7/1/19,42940,40796,2144,5
22059,7/1/19,6853,6493,360,5.3
22061,7/1/19,21237,19894,1343,6.3
22063,7/1/19,68827,65620,3207,4.7
22065,7/1/19,3633,3294,339,9.3
22067,7/1/19,9849,8938,911,9.2
22069,7/1/19,16245,15074,1171,7.2
22071,7/1/19,180896,170658,10238,5.7
22073,7/1/19,70868,66728,4140,5.8
22075,7/1/19,10120,9624,496,4.9
22077,7/1/19,9923,9305,618,6.2
22079,7/1/19,55939,52741,3198,5.7
22081,7/1/19,3819,3586,233,6.1
22083,7/1/19,8292,7733,559,6.7
22085,7/1/19,9406,8881,525,5.6
22087,7/1/19,20055,18971,1084,5.4
22089,7/1/19,25350,24088,1262,5
22091,7/1/19,4311,3993,318,7.4
22093,7/1/19,9286,8660,626,6.7
22095,7/1/19,19762,18549,1213,6.1
22097,7/1/19,32672,30416,2256,6.9
22099,7/1/19,22492,21191,1301,5.8
22101,7/1/19,20083,18781,1302,6.5
22103,7/1/19,120484,114799,5685,4.7
22105,7/1/19,54975,51447,3528,6.4
22107,7/1/19,1432,1275,157,11
22109,7/1/19,47170,44800,2370,5
22111,7/1/19,9178,8608,570,6.2
22113,7/1/19,24553,23188,1365,5.6
22115,7/1/19,16252,15068,1184,7.3
22117,7/1/19,16749,15604,1145,6.8
22119,7/1/19,14747,13746,1001,6.8
22121,7/1/19,13672,12951,721,5.3
22123,7/1/19,3597,3242,355,9.9
22125,7/1/19,5383,5132,251,4.7
22127,7/1/19,5002,4647,355,7.1
23001,7/1/19,54759,53209,1550,2.8
23003,7/1/19,30639,29416,1223,4
23005,7/1/19,168497,164846,3651,2.2
23007,7/1/19,14135,13606,529,3.7
23009,7/1/19,32022,31290,732,2.3
23011,7/1/19,62851,61168,1683,2.7
23013,7/1/19,21605,21125,480,2.2
23015,7/1/19,18221,17804,417,2.3
23017,7/1/19,27103,26234,869,3.2
23019,7/1/19,76501,74195,2306,3
23021,7/1/19,7433,7205,228,3.1
23023,7/1/19,19768,19386,382,1.9
23025,7/1/19,23199,22222,977,4.2
23027,7/1/19,21356,20741,615,2.9
23029,7/1/19,14159,13561,598,4.2
23031,7/1/19,116541,113896,2645,2.3
24001,7/1/19,32782,30903,1879,5.7
24003,7/1/19,322394,311348,11046,3.4
24005,7/1/19,463977,445482,18495,4
24009,7/1/19,51430,49548,1882,3.7
24011,7/1/19,18382,17669,713,3.9
24013,7/1/19,97447,94194,3253,3.3
24015,7/1/19,54108,51693,2415,4.5
24017,7/1/19,89848,86195,3653,4.1
24019,7/1/19,15980,15224,756,4.7
24021,7/1/19,138315,133519,4796,3.5
24023,7/1/19,16332,15592,740,4.5
24025,7/1/19,144389,138827,5562,3.9
24027,7/1/19,191908,185950,5958,3.1
24029,7/1/19,10354,9949,405,3.9
24031,7/1/19,576387,558021,18366,3.2
24033,7/1/19,522224,501652,20572,3.9
24035,7/1/19,28124,27161,963,3.4
24037,7/1/19,58397,56072,2325,4
24039,7/1/19,9776,9169,607,6.2
24041,7/1/19,19617,18918,699,3.6
24043,7/1/19,75776,72695,3081,4.1
24045,7/1/19,55579,53102,2477,4.5
24047,7/1/19,26928,25589,1339,5
24510,7/1/19,295652,279307,16345,5.5
25001,7/1/19,130016,126407,3609,2.8
25003,7/1/19,68184,65961,2223,3.3
25005,7/1/19,304687,292829,11858,3.9
25007,7/1/19,12627,12363,264,2.1
25009,7/1/19,433536,419799,13737,3.2
25011,7/1/19,41507,40390,1117,2.7
25013,7/1/19,228837,218327,10510,4.6
25015,7/1/19,90435,87528,2907,3.2
25017,7/1/19,938772,914353,24419,2.6
25019,7/1/19,10360,10197,163,1.6
25021,7/1/19,399417,388169,11248,2.8
25023,7/1/19,290466,281010,9456,3.3
25025,7/1/19,466599,452475,14124,3
25027,7/1/19,449820,434316,15504,3.4
26001,7/1/19,4091,3825,266,6.5
26003,7/1/19,3490,3242,248,7.1
26005,7/1/19,63356,60898,2458,3.9
26007,7/1/19,13215,12453,762,5.8
26009,7/1/19,11550,10985,565,4.9
26011,7/1/19,6320,5915,405,6.4
26013,7/1/19,3338,3107,231,6.9
26015,7/1/19,31888,30588,1300,4.1
26017,7/1/19,50485,47755,2730,5.4
26019,7/1/19,9505,9057,448,4.7
26021,7/1/19,75001,71284,3717,5
26023,7/1/19,19726,18722,1004,5.1
26025,7/1/19,62631,59368,3263,5.2
26027,7/1/19,24260,22920,1340,5.5
26029,7/1/19,14164,13555,609,4.3
26031,7/1/19,11523,11025,498,4.3
26033,7/1/19,16190,15143,1047,6.5
26035,7/1/19,11807,11014,793,6.7
26037,7/1/19,40385,38841,1544,3.8
26039,7/1/19,5775,5430,345,6
26041,7/1/19,17567,16566,1001,5.7
26043,7/1/19,12623,11829,794,6.3
26045,7/1/19,56058,53478,2580,4.6
26047,7/1/19,19445,18570,875,4.5
26049,7/1/19,184551,173328,11223,6.1
26051,7/1/19,10169,9507,662,6.5
26053,7/1/19,5975,5595,380,6.4
26055,7/1/19,53567,51597,1970,3.7
26057,7/1/19,17835,16735,1100,6.2
26059,7/1/19,20820,19730,1090,5.2
26061,7/1/19,15798,14827,971,6.1
26063,7/1/19,15985,15141,844,5.3
26065,7/1/19,148271,141110,7161,4.8
26067,7/1/19,30731,29224,1507,4.9
26069,7/1/19,10746,10078,668,6.2
26071,7/1/19,5317,5006,311,5.8
26073,7/1/19,34945,33182,1763,5
26075,7/1/19,74064,70443,3621,4.9
26077,7/1/19,132780,126956,5824,4.4
26079,7/1/19,8503,8036,467,5.5
26081,7/1/19,361442,347427,14015,3.9
26083,7/1/19,865,801,64,7.4
26085,7/1/19,3778,3506,272,7.2
26087,7/1/19,42260,39660,2600,6.2
26089,7/1/19,11317,10918,399,3.5
26091,7/1/19,46372,44085,2287,4.9
26093,7/1/19,105498,101522,3976,3.8
26095,7/1/19,2442,2299,143,5.9
26097,7/1/19,6375,6162,213,3.3
26099,7/1/19,457382,434330,23052,5
26101,7/1/19,11078,10460,618,5.6
26103,7/1/19,32242,30475,1767,5.5
26105,7/1/19,14553,13836,717,4.9
26107,7/1/19,17838,16794,1044,5.9
26109,7/1/19,11304,10742,562,5
26111,7/1/19,40500,38687,1813,4.5
26113,7/1/19,7220,6859,361,5
26115,7/1/19,75969,71665,4304,5.7
26117,7/1/19,28680,27154,1526,5.3
26119,7/1/19,3106,2858,248,8
26121,7/1/19,78973,74669,4304,5.4
26123,7/1/19,23839,22637,1202,5
26125,7/1/19,689748,660975,28773,4.2
26127,7/1/19,13227,12468,759,5.7
26129,7/1/19,8435,7870,565,6.7
26131,7/1/19,2144,1996,148,6.9
26133,7/1/19,11374,10843,531,4.7
26135,7/1/19,3317,3046,271,8.2
26137,7/1/19,12205,11415,790,6.5
26139,7/1/19,162105,156190,5915,3.6
26141,7/1/19,5213,4842,371,7.1
26143,7/1/19,8176,7561,615,7.5
26145,7/1/19,87275,82339,4936,5.7
26147,7/1/19,77409,73105,4304,5.6
26149,7/1/19,28440,26546,1894,6.7
26151,7/1/19,20101,19002,1099,5.5
26153,7/1/19,3424,3192,232,6.8
26155,7/1/19,33397,31661,1736,5.2
26157,7/1/19,24132,22665,1467,6.1
26159,7/1/19,35309,33400,1909,5.4
26161,7/1/19,197148,188961,8187,4.2
26163,7/1/19,820208,766745,53463,6.5
26165,7/1/19,15181,14408,773,5.1
27001,7/1/19,7339,7004,335,4.6
27003,7/1/19,201088,195052,6036,3
27005,7/1/19,19070,18426,644,3.4
27007,7/1/19,24539,23587,952,3.9
27009,7/1/19,22037,21366,671,3
27011,7/1/19,2632,2552,80,3
27013,7/1/19,39705,38549,1156,2.9
27015,7/1/19,14663,14207,456,3.1
27017,7/1/19,17822,17097,725,4.1
27019,7/1/19,59911,58197,1714,2.9
27021,7/1/19,15520,14912,608,3.9
27023,7/1/19,6906,6628,278,4
27025,7/1/19,30484,29502,982,3.2
27027,7/1/19,36100,35014,1086,3
27029,7/1/19,4433,4161,272,6.1
27031,7/1/19,3474,3370,104,3
27033,7/1/19,6180,5857,323,5.2
27035,7/1/19,33576,32491,1085,3.2
27037,7/1/19,246168,238840,7328,3
27039,7/1/19,12259,11881,378,3.1
27041,7/1/19,21944,21348,596,2.7
27043,7/1/19,7267,6993,274,3.8
27045,7/1/19,12018,11691,327,2.7
27047,7/1/19,16448,15891,557,3.4
27049,7/1/19,27652,26833,819,3
27051,7/1/19,3387,3258,129,3.8
27053,7/1/19,721882,700026,21856,3
27055,7/1/19,10453,10162,291,2.8
27057,7/1/19,10612,10197,415,3.9
27059,7/1/19,21569,20864,705,3.3
27061,7/1/19,22291,21063,1228,5.5
27063,7/1/19,5874,5501,373,6.4
27065,7/1/19,9067,8721,346,3.8
27067,7/1/19,24659,23881,778,3.2
27069,7/1/19,2434,2342,92,3.8
27071,7/1/19,6128,5718,410,6.7
27073,7/1/19,3570,3442,128,3.6
27075,7/1/19,5832,5653,179,3.1
27077,7/1/19,2525,2408,117,4.6
27079,7/1/19,16377,15866,511,3.1
27081,7/1/19,3415,3306,109,3.2
27083,7/1/19,14566,14089,477,3.3
27085,7/1/19,19551,18889,662,3.4
27087,7/1/19,2267,2173,94,4.1
27089,7/1/19,5442,5233,209,3.8
27091,7/1/19,10648,10084,564,5.3
27093,7/1/19,13557,13143,414,3.1
27095,7/1/19,13019,12524,495,3.8
27097,7/1/19,17735,17093,642,3.6
27099,7/1/19,20599,19981,618,3
27101,7/1/19,4909,4737,172,3.5
27103,7/1/19,20619,20062,557,2.7
27105,7/1/19,11535,11167,368,3.2
27107,7/1/19,3393,3231,162,4.8
27109,7/1/19,90784,88399,2385,2.6
27111,7/1/19,33274,31995,1279,3.8
27113,7/1/19,8597,8333,264,3.1
27115,7/1/19,15245,14639,606,4
27117,7/1/19,5155,5019,136,2.6
27119,7/1/19,16629,15892,737,4.4
27121,7/1/19,6745,6553,192,2.8
27123,7/1/19,295647,286239,9408,3.2
27125,7/1/19,2221,2129,92,4.1
27127,7/1/19,7825,7553,272,3.5
27129,7/1/19,8664,8295,369,4.3
27131,7/1/19,37501,36306,1195,3.2
27133,7/1/19,5773,5647,126,2.2
27135,7/1/19,7853,7524,329,4.2
27137,7/1/19,101865,97840,4025,4
27139,7/1/19,85038,82738,2300,2.7
27141,7/1/19,53157,51560,1597,3
27143,7/1/19,8872,8610,262,3
27145,7/1/19,91286,88637,2649,2.9
27147,7/1/19,21368,20653,715,3.3
27149,7/1/19,5595,5455,140,2.5
27151,7/1/19,5151,4911,240,4.7
27153,7/1/19,13741,13246,495,3.6
27155,7/1/19,1828,1775,53,2.9
27157,7/1/19,12822,12437,385,3
27159,7/1/19,5920,5523,397,6.7
27161,7/1/19,9270,8952,318,3.4
27163,7/1/19,145920,141802,4118,2.8
27165,7/1/19,6666,6411,255,3.8
27167,7/1/19,3608,3482,126,3.5
27169,7/1/19,28782,27869,913,3.2
27171,7/1/19,76978,74824,2154,2.8
27173,7/1/19,5524,5311,213,3.9
28001,7/1/19,11482,10548,934,8.1
28003,7/1/19,16111,15240,871,5.4
28005,7/1/19,4482,4120,362,8.1
28007,7/1/19,6989,6509,480,6.9
28009,7/1/19,3104,2884,220,7.1
28011,7/1/19,12526,11435,1091,8.7
28013,7/1/19,5902,5547,355,6
28015,7/1/19,3530,3279,251,7.1
28017,7/1/19,7091,6599,492,6.9
28019,7/1/19,3874,3648,226,5.8
28021,7/1/19,3124,2692,432,13.8
28023,7/1/19,6009,5570,439,7.3
28025,7/1/19,8019,7279,740,9.2
28027,7/1/19,8607,7871,736,8.6
28029,7/1/19,11453,10577,876,7.6
28031,7/1/19,8316,7847,469,5.6
28033,7/1/19,92426,87829,4597,5
28035,7/1/19,33390,31306,2084,6.2
28037,7/1/19,2842,2610,232,8.2
28039,7/1/19,9039,8251,788,8.7
28041,7/1/19,4468,4057,411,9.2
28043,7/1/19,9567,8999,568,5.9
28045,7/1/19,19244,18050,1194,6.2
28047,7/1/19,88461,83387,5074,5.7
28049,7/1/19,108572,101921,6651,6.1
28051,7/1/19,5805,5080,725,12.5
28053,7/1/19,2299,2050,249,10.8
28055,7/1/19,397,348,49,12.3
28057,7/1/19,10755,10153,602,5.6
28059,7/1/19,59979,55932,4047,6.7
28061,7/1/19,6340,5852,488,7.7
28063,7/1/19,2130,1722,408,19.2
28065,7/1/19,4206,3835,371,8.8
28067,7/1/19,26813,25174,1639,6.1
28069,7/1/19,3648,3296,352,9.6
28071,7/1/19,27191,25618,1573,5.8
28073,7/1/19,30636,29152,1484,4.8
28075,7/1/19,30747,28786,1961,6.4
28077,7/1/19,4631,4256,375,8.1
28079,7/1/19,8217,7711,506,6.2
28081,7/1/19,41930,39749,2181,5.2
28083,7/1/19,10159,9293,866,8.5
28085,7/1/19,14943,14020,923,6.2
28087,7/1/19,25450,23823,1627,6.4
28089,7/1/19,54013,51232,2781,5.1
28091,7/1/19,10197,9563,634,6.2
28093,7/1/19,14766,13770,996,6.7
28095,7/1/19,15865,14802,1063,6.7
28097,7/1/19,4013,3741,272,6.8
28099,7/1/19,10784,10091,693,6.4
28101,7/1/19,8992,8430,562,6.3
28103,7/1/19,3870,3536,334,8.6
28105,7/1/19,22743,21169,1574,6.9
28107,7/1/19,12898,11918,980,7.6
28109,7/1/19,24155,22770,1385,5.7
28111,7/1/19,4326,3983,343,7.9
28113,7/1/19,14624,13518,1106,7.6
28115,7/1/19,15040,14297,743,4.9
28117,7/1/19,11548,10857,691,6
28119,7/1/19,2468,2226,242,9.8
28121,7/1/19,76913,73515,3398,4.4
28123,7/1/19,13115,12432,683,5.2
28125,7/1/19,1660,1514,146,8.8
28127,7/1/19,10938,10290,648,5.9
28129,7/1/19,6982,6591,391,5.6
28131,7/1/19,6907,6350,557,8.1
28133,7/1/19,7917,7164,753,9.5
28135,7/1/19,5355,4998,357,6.7
28137,7/1/19,12624,11805,819,6.5
28139,7/1/19,9589,9013,576,6
28141,7/1/19,8632,8109,523,6.1
28143,7/1/19,4557,4235,322,7.1
28145,7/1/19,14480,13820,660,4.6
28147,7/1/19,5029,4583,446,8.9
28149,7/1/19,20348,18941,1407,6.9
28151,7/1/19,17416,15951,1465,8.4
28153,7/1/19,7713,7154,559,7.2
28155,7/1/19,4019,3767,252,6.3
28157,7/1/19,2777,2449,328,11.8
28159,7/1/19,7623,7081,542,7.1
28161,7/1/19,4920,4575,345,7
28163,7/1/19,9701,8948,753,7.8
29001,7/1/19,10140,9613,527,5.2
29003,7/1/19,9941,9614,327,3.3
29005,7/1/19,2623,2469,154,5.9
29007,7/1/19,10659,10239,420,3.9
29009,7/1/19,15378,14804,574,3.7
29011,7/1/19,5084,4848,236,4.6
29013,7/1/19,7991,7608,383,4.8
29015,7/1/19,6935,6578,357,5.1
29017,7/1/19,5370,5134,236,4.4
29019,7/1/19,97250,94392,2858,2.9
29021,7/1/19,45581,43984,1597,3.5
29023,7/1/19,17821,16928,893,5
29025,7/1/19,4395,4233,162,3.7
29027,7/1/19,21803,21075,728,3.3
29029,7/1/19,20653,19936,717,3.5
29031,7/1/19,40166,38781,1385,3.4
29033,7/1/19,4571,4400,171,3.7
29035,7/1/19,2539,2411,128,5
29037,7/1/19,55783,53813,1970,3.5
29039,7/1/19,5711,5447,264,4.6
29041,7/1/19,3522,3390,132,3.7
29043,7/1/19,45633,44270,1363,3
29045,7/1/19,3086,2965,121,3.9
29047,7/1/19,139808,134274,5534,4
29049,7/1/19,10963,10480,483,4.4
29051,7/1/19,39910,38710,1200,3
29053,7/1/19,7348,7060,288,3.9
29055,7/1/19,11135,10678,457,4.1
29057,7/1/19,3383,3262,121,3.6
29059,7/1/19,7064,6782,282,4
29061,7/1/19,3924,3762,162,4.1
29063,7/1/19,4894,4712,182,3.7
29065,7/1/19,6062,5817,245,4
29067,7/1/19,4986,4776,210,4.2
29069,7/1/19,11137,10389,748,6.7
29071,7/1/19,54209,52306,1903,3.5
29073,7/1/19,7594,7332,262,3.5
29075,7/1/19,3525,3393,132,3.7
29077,7/1/19,153320,149049,4271,2.8
29079,7/1/19,4241,4037,204,4.8
29081,7/1/19,3683,3544,139,3.8
29083,7/1/19,9601,9187,414,4.3
29085,7/1/19,3883,3721,162,4.2
29087,7/1/19,2500,2389,111,4.4
29089,7/1/19,4721,4533,188,4
29091,7/1/19,16304,15526,778,4.8
29093,7/1/19,3510,3282,228,6.5
29095,7/1/19,371169,354459,16710,4.5
29097,7/1/19,57815,55771,2044,3.5
29099,7/1/19,120563,116515,4048,3.4
29101,7/1/19,22833,21728,1105,4.8
29103,7/1/19,1712,1651,61,3.6
29105,7/1/19,16771,16067,704,4.2
29107,7/1/19,17051,16412,639,3.7
29109,7/1/19,17778,17024,754,4.2
29111,7/1/19,4864,4689,175,3.6
29113,7/1/19,28901,27882,1019,3.5
29115,7/1/19,4956,4651,305,6.2
29117,7/1/19,7354,7168,186,2.5
29119,7/1/19,10827,10344,483,4.5
29121,7/1/19,7466,7197,269,3.6
29123,7/1/19,5433,5201,232,4.3
29125,7/1/19,3757,3582,175,4.7
29127,7/1/19,14520,14024,496,3.4
29129,7/1/19,1671,1617,54,3.2
29131,7/1/19,12153,11711,442,3.6
29133,7/1/19,5608,5274,334,6
29135,7/1/19,7407,7134,273,3.7
29137,7/1/19,3715,3537,178,4.8
29139,7/1/19,5658,5450,208,3.7
29141,7/1/19,8272,7930,342,4.1
29143,7/1/19,8066,7635,431,5.3
29145,7/1/19,27700,26512,1188,4.3
29147,7/1/19,10498,10043,455,4.3
29149,7/1/19,3710,3537,173,4.7
29151,7/1/19,7203,7002,201,2.8
29153,7/1/19,3184,2996,188,5.9
29155,7/1/19,6183,5780,403,6.5
29157,7/1/19,9981,9693,288,2.9
29159,7/1/19,20651,19728,923,4.5
29161,7/1/19,19570,18831,739,3.8
29163,7/1/19,7293,6996,297,4.1
29165,7/1/19,60086,57897,2189,3.6
29167,7/1/19,14708,14175,533,3.6
29169,7/1/19,14535,13939,596,4.1
29171,7/1/19,2227,2142,85,3.8
29173,7/1/19,5612,5437,175,3.1
29175,7/1/19,10304,9823,481,4.7
29177,7/1/19,11320,10733,587,5.2
29179,7/1/19,3051,2934,117,3.8
29181,7/1/19,4929,4604,325,6.6
29183,7/1/19,231144,224831,6313,2.7
29185,7/1/19,3654,3450,204,5.6
29186,7/1/19,9204,8922,282,3.1
29187,7/1/19,26605,25509,1096,4.1
29189,7/1/19,544124,525536,18588,3.4
29195,7/1/19,10298,9882,416,4
29197,7/1/19,1895,1785,110,5.8
29199,7/1/19,2346,2274,72,3.1
29201,7/1/19,19700,18798,902,4.6
29203,7/1/19,3224,3038,186,5.8
29205,7/1/19,2902,2817,85,2.9
29207,7/1/19,12909,12215,694,5.4
29209,7/1/19,14945,14380,565,3.8
29211,7/1/19,2603,2506,97,3.7
29213,7/1/19,29220,28175,1045,3.6
29215,7/1/19,8405,7982,423,5
29217,7/1/19,9110,8727,383,4.2
29219,7/1/19,18247,17697,550,3
29221,7/1/19,10041,9551,490,4.9
29223,7/1/19,5168,4888,280,5.4
29225,7/1/19,17464,16783,681,3.9
29227,7/1/19,1102,1056,46,4.2
29229,7/1/19,6954,6594,360,5.2
29510,7/1/19,156762,149613,7149,4.6
30001,7/1/19,5164,5038,126,2.4
30003,7/1/19,4768,4430,338,7.1
30005,7/1/19,2388,2315,73,3.1
30007,7/1/19,2676,2568,108,4
30009,7/1/19,5480,5319,161,2.9
30011,7/1/19,607,591,16,2.6
30013,7/1/19,37674,36475,1199,3.2
30015,7/1/19,2423,2367,56,2.3
30017,7/1/19,6169,6007,162,2.6
30019,7/1/19,907,893,14,1.5
30021,7/1/19,4588,4483,105,2.3
30023,7/1/19,5248,5093,155,3
30025,7/1/19,1706,1684,22,1.3
30027,7/1/19,6133,5978,155,2.5
30029,7/1/19,50466,48612,1854,3.7
30031,7/1/19,72563,71249,1314,1.8
30033,7/1/19,734,720,14,1.9
30035,7/1/19,6057,5624,433,7.1
30037,7/1/19,362,352,10,2.8
30039,7/1/19,1672,1600,72,4.3
30041,7/1/19,7693,7386,307,4
30043,7/1/19,5852,5689,163,2.8
30045,7/1/19,912,890,22,2.4
30047,7/1/19,13480,12952,528,3.9
30049,7/1/19,36990,35990,1000,2.7
30051,7/1/19,938,915,23,2.5
30053,7/1/19,8211,7736,475,5.8
30055,7/1/19,953,927,26,2.7
30057,7/1/19,4783,4667,116,2.4
30059,7/1/19,983,957,26,2.6
30061,7/1/19,1854,1777,77,4.2
30063,7/1/19,63386,61580,1806,2.8
30065,7/1/19,2266,2183,83,3.7
30067,7/1/19,9467,9226,241,2.5
30069,7/1/19,274,267,7,2.6
30071,7/1/19,1838,1773,65,3.5
30073,7/1/19,2626,2523,103,3.9
30075,7/1/19,946,927,19,2
30077,7/1/19,3094,3007,87,2.8
30079,7/1/19,477,458,19,4
30081,7/1/19,20435,19727,708,3.5
30083,7/1/19,5880,5729,151,2.6
30085,7/1/19,4464,4245,219,4.9
30087,7/1/19,3902,3690,212,5.4
30089,7/1/19,4913,4672,241,4.9
30091,7/1/19,1675,1645,30,1.8
30093,7/1/19,17766,17154,612,3.4
30095,7/1/19,5208,5063,145,2.8
30097,7/1/19,1811,1765,46,2.5
30099,7/1/19,2726,2651,75,2.8
30101,7/1/19,2155,2106,49,2.3
30103,7/1/19,326,319,7,2.1
30105,7/1/19,4187,4065,122,2.9
30107,7/1/19,769,740,29,3.8
30109,7/1/19,483,470,13,2.7
30111,7/1/19,82360,79763,2597,3.2
31001,7/1/19,17221,16606,615,3.6
31003,7/1/19,3627,3531,96,2.6
31005,7/1/19,225,213,12,5.3
31007,7/1/19,380,361,19,5
31009,7/1/19,254,239,15,5.9
31011,7/1/19,2971,2890,81,2.7
31013,7/1/19,5518,5304,214,3.9
31015,7/1/19,1056,1019,37,3.5
31017,7/1/19,1407,1351,56,4
31019,7/1/19,27981,27159,822,2.9
31021,7/1/19,3477,3365,112,3.2
31023,7/1/19,4689,4560,129,2.8
31025,7/1/19,13854,13339,515,3.7
31027,7/1/19,4569,4442,127,2.8
31029,7/1/19,2297,2241,56,2.4
31031,7/1/19,3471,3378,93,2.7
31033,7/1/19,4509,4328,181,4
31035,7/1/19,3341,3237,104,3.1
31037,7/1/19,5631,5459,172,3.1
31039,7/1/19,4756,4619,137,2.9
31041,7/1/19,6477,6313,164,2.5
31043,7/1/19,11004,10512,492,4.5
31045,7/1/19,4826,4645,181,3.8
31047,7/1/19,13194,12770,424,3.2
31049,7/1/19,980,949,31,3.2
31051,7/1/19,3038,2947,91,3
31053,7/1/19,19866,19237,629,3.2
31055,7/1/19,306323,295442,10881,3.6
31057,7/1/19,1149,1118,31,2.7
31059,7/1/19,3220,3133,87,2.7
31061,7/1/19,1462,1406,56,3.8
31063,7/1/19,1561,1505,56,3.6
31065,7/1/19,2635,2548,87,3.3
31067,7/1/19,11228,10821,407,3.6
31069,7/1/19,1151,1122,29,2.5
31071,7/1/19,1197,1162,35,2.9
31073,7/1/19,1178,1143,35,3
31075,7/1/19,402,390,12,3
31077,7/1/19,1223,1186,37,3
31079,7/1/19,32363,31250,1113,3.4
31081,7/1/19,4808,4656,152,3.2
31083,7/1/19,1848,1792,56,3
31085,7/1/19,595,578,17,2.9
31087,7/1/19,1289,1243,46,3.6
31089,7/1/19,5796,5632,164,2.8
31091,7/1/19,454,442,12,2.6
31093,7/1/19,3389,3269,120,3.5
31095,7/1/19,4195,4073,122,2.9
31097,7/1/19,2073,1994,79,3.8
31099,7/1/19,3835,3725,110,2.9
31101,7/1/19,4830,4693,137,2.8
31103,7/1/19,564,547,17,3
31105,7/1/19,2069,2000,69,3.3
31107,7/1/19,4669,4536,133,2.8
31109,7/1/19,178757,173386,5371,3
31111,7/1/19,18884,18097,787,4.2
31113,7/1/19,463,448,15,3.2
31115,7/1/19,399,382,17,4.3
31117,7/1/19,438,423,15,3.4
31119,7/1/19,20105,19453,652,3.2
31121,7/1/19,4038,3909,129,3.2
31123,7/1/19,2650,2581,69,2.6
31125,7/1/19,1970,1918,52,2.6
31127,7/1/19,3531,3365,166,4.7
31129,7/1/19,2432,2363,69,2.8
31131,7/1/19,8628,8290,338,3.9
31133,7/1/19,1469,1415,54,3.7
31135,7/1/19,1818,1770,48,2.6
31137,7/1/19,5012,4854,158,3.2
31139,7/1/19,4161,4043,118,2.8
31141,7/1/19,17947,17395,552,3.1
31143,7/1/19,2926,2837,89,3
31145,7/1/19,5976,5773,203,3.4
31147,7/1/19,4268,4112,156,3.7
31149,7/1/19,865,838,27,3.1
31151,7/1/19,7404,7149,255,3.4
31153,7/1/19,98679,95617,3062,3.1
31155,7/1/19,11358,11024,334,2.9
31157,7/1/19,18646,17915,731,3.9
31159,7/1/19,8995,8677,318,3.5
31161,7/1/19,2684,2591,93,3.5
31163,7/1/19,1703,1645,58,3.4
31165,7/1/19,760,739,21,2.8
31167,7/1/19,3551,3443,108,3
31169,7/1/19,2788,2707,81,2.9
31171,7/1/19,427,408,19,4.4
31173,7/1/19,3124,2960,164,5.2
31175,7/1/19,2196,2121,75,3.4
31177,7/1/19,11490,11123,367,3.2
31179,7/1/19,5510,5319,191,3.5
31181,7/1/19,1699,1622,77,4.5
31183,7/1/19,543,524,19,3.5
31185,7/1/19,7470,7229,241,3.2
32001,7/1/19,10980,10581,399,3.6
32003,7/1/19,1139458,1090602,48856,4.3
32005,7/1/19,23651,22783,868,3.7
32007,7/1/19,27279,26422,857,3.1
32009,7/1/19,423,406,17,4
32011,7/1/19,1018,990,28,2.8
32013,7/1/19,8118,7837,281,3.5
32015,7/1/19,3207,3107,100,3.1
32017,7/1/19,2105,2019,86,4.1
32019,7/1/19,23234,22150,1084,4.7
32021,7/1/19,2066,1980,86,4.2
32023,7/1/19,16899,15999,900,5.3
32027,7/1/19,2509,2409,100,4
32029,7/1/19,2039,1966,73,3.6
32031,7/1/19,256439,248134,8305,3.2
32033,7/1/19,4676,4531,145,3.1
32510,7/1/19,26541,25523,1018,3.8
33001,7/1/19,33710,32945,765,2.3
33003,7/1/19,26610,26033,577,2.2
33005,7/1/19,40745,39667,1078,2.6
33007,7/1/19,15306,14875,431,2.8
33009,7/1/19,50947,49858,1089,2.1
33011,7/1/19,243646,237170,6476,2.7
33013,7/1/19,84579,82734,1845,2.2
33015,7/1/19,192923,187651,5272,2.7
33017,7/1/19,75295,73514,1781,2.4
33019,7/1/19,23432,22896,536,2.3
34001,7/1/19,124700,118419,6281,5
34003,7/1/19,484670,468476,16194,3.3
34005,7/1/19,231420,222934,8486,3.7
34007,7/1/19,254169,242821,11348,4.5
34009,7/1/19,57280,54955,2325,4.1
34011,7/1/19,63596,59823,3773,5.9
34013,7/1/19,373799,355556,18243,4.9
34015,7/1/19,150444,144229,6215,4.1
34017,7/1/19,362971,349921,13050,3.6
34019,7/1/19,65153,63192,1961,3
34021,7/1/19,204653,197246,7407,3.6
34023,7/1/19,449363,433726,15637,3.5
34025,7/1/19,335354,323884,11470,3.4
34027,7/1/19,259819,251694,8125,3.1
34029,7/1/19,280250,269614,10636,3.8
34031,7/1/19,243656,232124,11532,4.7
34033,7/1/19,29409,27885,1524,5.2
34035,7/1/19,173499,167751,5748,3.3
34037,7/1/19,74728,71980,2748,3.7
34039,7/1/19,279992,268729,11263,4
34041,7/1/19,56239,54127,2112,3.8
35001,7/1/19,335114,318187,16927,5.1
35003,7/1/19,1214,1138,76,6.3
35005,7/1/19,27468,25857,1611,5.9
35006,7/1/19,9032,8385,647,7.2
35007,7/1/19,6379,6085,294,4.6
35009,7/1/19,21687,20622,1065,4.9
35011,7/1/19,798,758,40,5
35013,7/1/19,96423,90354,6069,6.3
35015,7/1/19,35083,33793,1290,3.7
35017,7/1/19,11999,11344,655,5.5
35019,7/1/19,1606,1510,96,6
35021,7/1/19,274,258,16,5.8
35023,7/1/19,2162,2058,104,4.8
35025,7/1/19,31302,29803,1499,4.8
35027,7/1/19,9410,8946,464,4.9
35028,7/1/19,9748,9381,367,3.8
35029,7/1/19,11026,10051,975,8.8
35031,7/1/19,23798,21803,1995,8.4
35033,7/1/19,2265,2132,133,5.9
35035,7/1/19,24786,23352,1434,5.8
35037,7/1/19,3227,3031,196,6.1
35039,7/1/19,17331,16354,977,5.6
35041,7/1/19,7839,7385,454,5.8
35043,7/1/19,66931,63183,3748,5.6
35045,7/1/19,51601,48274,3327,6.4
35047,7/1/19,10667,9941,726,6.8
35049,7/1/19,76902,73486,3416,4.4
35051,7/1/19,4051,3790,261,6.4
35053,7/1/19,6426,5970,456,7.1
35055,7/1/19,15308,14350,958,6.3
35057,7/1/19,5671,5266,405,7.1
35059,7/1/19,1939,1867,72,3.7
35061,7/1/19,31039,29128,1911,6.2
36001,7/1/19,158028,151866,6162,3.9
36003,7/1/19,19125,18120,1005,5.3
36005,7/1/19,600775,565794,34981,5.8
36007,7/1/19,83344,79215,4129,5
36009,7/1/19,33988,32371,1617,4.8
36011,7/1/19,36898,35348,1550,4.2
36013,7/1/19,56736,54183,2553,4.5
36015,7/1/19,34662,33147,1515,4.4
36017,7/1/19,22624,21677,947,4.2
36019,7/1/19,36436,34815,1621,4.4
36021,7/1/19,32168,31172,996,3.1
36023,7/1/19,22540,21486,1054,4.7
36025,7/1/19,19974,19026,948,4.7
36027,7/1/19,146104,140639,5465,3.7
36029,7/1/19,443918,424005,19913,4.5
36031,7/1/19,18164,17471,693,3.8
36033,7/1/19,19980,19049,931,4.7
36035,7/1/19,22657,21582,1075,4.7
36037,7/1/19,30427,29360,1067,3.5
36039,7/1/19,20693,19773,920,4.4
36041,7/1/19,2526,2443,83,3.3
36043,7/1/19,28212,26920,1292,4.6
36045,7/1/19,45199,42966,2233,4.9
36047,7/1/19,1202326,1149062,53264,4.4
36049,7/1/19,11754,11226,528,4.5
36051,7/1/19,30838,29559,1279,4.1
36053,7/1/19,33142,31717,1425,4.3
36055,7/1/19,361991,345981,16010,4.4
36057,7/1/19,22291,21171,1120,5
36059,7/1/19,720233,693795,26438,3.7
36061,7/1/19,913299,879242,34057,3.7
36063,7/1/19,99178,94310,4868,4.9
36065,7/1/19,102409,98018,4391,4.3
36067,7/1/19,222879,213907,8972,4
36069,7/1/19,55376,53295,2081,3.8
36071,7/1/19,188781,181156,7625,4
36073,7/1/19,17754,16871,883,5
36075,7/1/19,53453,50605,2848,5.3
36077,7/1/19,28871,27648,1223,4.2
36079,7/1/19,51925,49924,2001,3.9
36081,7/1/19,1142317,1099855,42462,3.7
36083,7/1/19,81317,78131,3186,3.9
36085,7/1/19,223566,213820,9746,4.4
36087,7/1/19,158135,152039,6096,3.9
36089,7/1/19,42613,40164,2449,5.7
36091,7/1/19,118997,115062,3935,3.3
36093,7/1/19,76228,73185,3043,4
36095,7/1/19,14722,14040,682,4.6
36097,7/1/19,8362,8036,326,3.9
36099,7/1/19,16321,15733,588,3.6
36101,7/1/19,42502,40714,1788,4.2
36103,7/1/19,792358,760908,31450,4
36105,7/1/19,38706,37280,1426,3.7
36107,7/1/19,22620,21708,912,4
36109,7/1/19,48128,46127,2001,4.2
36111,7/1/19,88568,85008,3560,4
36113,7/1/19,32823,31627,1196,3.6
36115,7/1/19,29417,28345,1072,3.6
36117,7/1/19,43970,42284,1686,3.8
36119,7/1/19,492994,473152,19842,4
36121,7/1/19,18653,17927,726,3.9
36123,7/1/19,11953,11547,406,3.4
37001,7/1/19,83371,79733,3638,4.4
37003,7/1/19,18249,17589,660,3.6
37005,7/1/19,4491,4265,226,5
37007,7/1/19,10801,10312,489,4.5
37009,7/1/19,12947,12440,507,3.9
37011,7/1/19,7989,7683,306,3.8
37013,7/1/19,19752,18747,1005,5.1
37015,7/1/19,7866,7457,409,5.2
37017,7/1/19,14913,14125,788,5.3
37019,7/1/19,57830,54783,3047,5.3
37021,7/1/19,143084,138409,4675,3.3
37023,7/1/19,41518,39791,1727,4.2
37025,7/1/19,111054,106723,4331,3.9
37027,7/1/19,37000,35356,1644,4.4
37029,7/1/19,4671,4477,194,4.2
37031,7/1/19,33864,32445,1419,4.2
37033,7/1/19,9847,9356,491,5
37035,7/1/19,79770,76586,3184,4
37037,7/1/19,36207,34857,1350,3.7
37039,7/1/19,11207,10664,543,4.8
37041,7/1/19,5654,5371,283,5
37043,7/1/19,4159,3946,213,5.1
37045,7/1/19,48852,46673,2179,4.5
37047,7/1/19,23636,22391,1245,5.3
37049,7/1/19,42939,41027,1912,4.5
37051,7/1/19,128693,121372,7321,5.7
37053,7/1/19,14427,13895,532,3.7
37055,7/1/19,23487,22628,859,3.7
37057,7/1/19,82038,78724,3314,4
37059,7/1/19,20972,20180,792,3.8
37061,7/1/19,25951,24822,1129,4.4
37063,7/1/19,173250,166670,6580,3.8
37065,7/1/19,21498,20086,1412,6.6
37067,7/1/19,190517,182513,8004,4.2
37069,7/1/19,32049,30633,1416,4.4
37071,7/1/19,113075,108294,4781,4.2
37073,7/1/19,5507,5270,237,4.3
37075,7/1/19,3383,3194,189,5.6
37077,7/1/19,30312,29172,1140,3.8
37079,7/1/19,9611,9188,423,4.4
37081,7/1/19,264486,252083,12403,4.7
37083,7/1/19,20541,19235,1306,6.4
37085,7/1/19,53678,50862,2816,5.2
37087,7/1/19,30515,29412,1103,3.6
37089,7/1/19,56233,54212,2021,3.6
37091,7/1/19,9276,8703,573,6.2
37093,7/1/19,20318,19197,1121,5.5
37095,7/1/19,2218,2086,132,6
37097,7/1/19,91151,87572,3579,3.9
37099,7/1/19,20312,19373,939,4.6
37101,7/1/19,101531,97499,4032,4
37103,7/1/19,4568,4376,192,4.2
37105,7/1/19,25895,24602,1293,5
37107,7/1/19,28400,27240,1160,4.1
37109,7/1/19,44286,42594,1692,3.8
37111,7/1/19,20890,20036,854,4.1
37113,7/1/19,16187,15538,649,4
37115,7/1/19,10396,9969,427,4.1
37117,7/1/19,9028,8503,525,5.8
37119,7/1/19,633212,607573,25639,4
37121,7/1/19,6016,5710,306,5.1
37123,7/1/19,11608,11098,510,4.4
37125,7/1/19,43193,41379,1814,4.2
37127,7/1/19,43628,41252,2376,5.4
37129,7/1/19,127296,122367,4929,3.9
37131,7/1/19,7829,7379,450,5.7
37133,7/1/19,63597,60301,3296,5.2
37135,7/1/19,79936,76917,3019,3.8
37137,7/1/19,5513,5280,233,4.2
37139,7/1/19,16787,15937,850,5.1
37141,7/1/19,29754,28486,1268,4.3
37143,7/1/19,5022,4757,265,5.3
37145,7/1/19,18722,17854,868,4.6
37147,7/1/19,89686,85102,4584,5.1
37149,7/1/19,9209,8828,381,4.1
37151,7/1/19,66814,63973,2841,4.3
37153,7/1/19,16677,15716,961,5.8
37155,7/1/19,50586,47537,3049,6
37157,7/1/19,40452,38488,1964,4.9
37159,7/1/19,67479,64548,2931,4.3
37161,7/1/19,25015,23656,1359,5.4
37163,7/1/19,29692,28383,1309,4.4
37165,7/1/19,11608,10776,832,7.2
37167,7/1/19,30685,29458,1227,4
37169,7/1/19,22009,21157,852,3.9
37171,7/1/19,34262,32907,1355,4
37173,7/1/19,7413,7128,285,3.8
37175,7/1/19,15629,15028,601,3.8
37177,7/1/19,1737,1652,85,4.9
37179,7/1/19,126297,121448,4849,3.8
37181,7/1/19,17629,16489,1140,6.5
37183,7/1/19,608994,586361,22633,3.7
37185,7/1/19,6742,6317,425,6.3
37187,7/1/19,4644,4363,281,6.1
37189,7/1/19,30232,29012,1220,4
37191,7/1/19,52517,50107,2410,4.6
37193,7/1/19,29714,28394,1320,4.4
37195,7/1/19,35278,32907,2371,6.7
37197,7/1/19,18049,17361,688,3.8
37199,7/1/19,8373,8019,354,4.2
38001,7/1/19,1062,1043,19,1.8
38003,7/1/19,5061,4806,255,5
38005,7/1/19,2199,2112,87,4
38007,7/1/19,569,560,9,1.6
38009,7/1/19,3008,2913,95,3.2
38011,7/1/19,1691,1669,22,1.3
38013,7/1/19,1025,1005,20,2
38015,7/1/19,50846,49818,1028,2
38017,7/1/19,104181,102268,1913,1.8
38019,7/1/19,1877,1832,45,2.4
38021,7/1/19,2327,2283,44,1.9
38023,7/1/19,1482,1465,17,1.1
38025,7/1/19,3168,3119,49,1.5
38027,7/1/19,1167,1123,44,3.8
38029,7/1/19,1408,1366,42,3
38031,7/1/19,1522,1490,32,2.1
38033,7/1/19,821,809,12,1.5
38035,7/1/19,37061,36280,781,2.1
38037,7/1/19,1177,1157,20,1.7
38039,7/1/19,1020,999,21,2.1
38041,7/1/19,1338,1314,24,1.8
38043,7/1/19,1242,1206,36,2.9
38045,7/1/19,1979,1932,47,2.4
38047,7/1/19,829,813,16,1.9
38049,7/1/19,2988,2906,82,2.7
38051,7/1/19,1114,1084,30,2.7
38053,7/1/19,10896,10741,155,1.4
38055,7/1/19,4726,4593,133,2.8
38057,7/1/19,3691,3543,148,4
38059,7/1/19,16667,16266,401,2.4
38061,7/1/19,7514,7417,97,1.3
38063,7/1/19,1390,1351,39,2.8
38065,7/1/19,887,856,31,3.5
38067,7/1/19,3334,3208,126,3.8
38069,7/1/19,1757,1707,50,2.8
38071,7/1/19,5757,5619,138,2.4
38073,7/1/19,2857,2808,49,1.7
38075,7/1/19,1183,1157,26,2.2
38077,7/1/19,8653,8454,199,2.3
38079,7/1/19,4643,4053,590,12.7
38081,7/1/19,2736,2690,46,1.7
38083,7/1/19,651,632,19,2.9
38085,7/1/19,1283,1227,56,4.4
38087,7/1/19,400,391,9,2.3
38089,7/1/19,19085,18732,353,1.8
38091,7/1/19,972,952,20,2.1
38093,7/1/19,10447,10225,222,2.1
38095,7/1/19,1125,1094,31,2.8
38097,7/1/19,4289,4154,135,3.1
38099,7/1/19,5180,4989,191,3.7
38101,7/1/19,32209,31541,668,2.1
38103,7/1/19,1933,1884,49,2.5
38105,7/1/19,25500,25082,418,1.6
39001,7/1/19,10796,10061,735,6.8
39003,7/1/19,48641,46333,2308,4.7
39005,7/1/19,27008,25817,1191,4.4
39007,7/1/19,45296,43119,2177,4.8
39009,7/1/19,25123,23379,1744,6.9
39011,7/1/19,25367,24513,854,3.4
39013,7/1/19,30492,28903,1589,5.2
39015,7/1/19,19802,18787,1015,5.1
39017,7/1/19,197827,189048,8779,4.4
39019,7/1/19,13032,12419,613,4.7
39021,7/1/19,20264,19416,848,4.2
39023,7/1/19,63579,60414,3165,5
39025,7/1/19,108228,103664,4564,4.2
39027,7/1/19,17851,16936,915,5.1
39029,7/1/19,48200,45556,2644,5.5
39031,7/1/19,14561,13639,922,6.3
39033,7/1/19,18579,17608,971,5.2
39035,7/1/19,629425,599328,30097,4.8
39037,7/1/19,25936,24908,1028,4
39039,7/1/19,18316,17451,865,4.7
39041,7/1/19,112211,108136,4075,3.6
39043,7/1/19,39880,37802,2078,5.2
39045,7/1/19,79113,75912,3201,4
39047,7/1/19,14030,13430,600,4.3
39049,7/1/19,708505,680579,27926,3.9
39051,7/1/19,22464,21517,947,4.2
39053,7/1/19,11985,11294,691,5.8
39055,7/1/19,50504,48526,1978,3.9
39057,7/1/19,84390,80796,3594,4.3
39059,7/1/19,18781,17814,967,5.1
39061,7/1/19,421659,403498,18161,4.3
39063,7/1/19,41985,40465,1520,3.6
39065,7/1/19,13509,12790,719,5.3
39067,7/1/19,6905,6541,364,5.3
39069,7/1/19,13340,12727,613,4.6
39071,7/1/19,17055,16126,929,5.4
39073,7/1/19,13228,12636,592,4.5
39075,7/1/19,21208,20461,747,3.5
39077,7/1/19,28923,27026,1897,6.6
39079,7/1/19,12754,11941,813,6.4
39081,7/1/19,28082,26380,1702,6.1
39083,7/1/19,31633,30228,1405,4.4
39085,7/1/19,129576,124157,5419,4.2
39087,7/1/19,23906,22492,1414,5.9
39089,7/1/19,91934,88155,3779,4.1
39091,7/1/19,23131,22208,923,4
39093,7/1/19,157966,150085,7881,5
39095,7/1/19,210796,200566,10230,4.9
39097,7/1/19,21039,20269,770,3.7
39099,7/1/19,104240,97865,6375,6.1
39101,7/1/19,28694,27414,1280,4.5
39103,7/1/19,100088,96158,3930,3.9
39105,7/1/19,8809,8177,632,7.2
39107,7/1/19,23870,23169,701,2.9
39109,7/1/19,54671,52514,2157,3.9
39111,7/1/19,5396,4988,408,7.6
39113,7/1/19,255882,244023,11859,4.6
39115,7/1/19,6732,6342,390,5.8
39117,7/1/19,17036,16313,723,4.2
39119,7/1/19,39679,37742,1937,4.9
39121,7/1/19,4708,4414,294,6.2
39123,7/1/19,22602,21613,989,4.4
39125,7/1/19,8717,8335,382,4.4
39127,7/1/19,16069,15240,829,5.2
39129,7/1/19,26780,25667,1113,4.2
39131,7/1/19,10923,10242,681,6.2
39133,7/1/19,88268,84227,4041,4.6
39135,7/1/19,21385,20538,847,4
39137,7/1/19,19095,18449,646,3.4
39139,7/1/19,52955,50332,2623,5
39141,7/1/19,35737,34167,1570,4.4
39143,7/1/19,30980,29623,1357,4.4
39145,7/1/19,28870,26959,1911,6.6
39147,7/1/19,27620,26351,1269,4.6
39149,7/1/19,24588,23619,969,3.9
39151,7/1/19,187477,178822,8655,4.6
39153,7/1/19,275058,262511,12547,4.6
39155,7/1/19,87803,82060,5743,6.5
39157,7/1/19,45657,43675,1982,4.3
39159,7/1/19,29407,28344,1063,3.6
39161,7/1/19,15341,14788,553,3.6
39163,7/1/19,5590,5286,304,5.4
39165,7/1/19,120691,115870,4821,4
39167,7/1/19,27688,26173,1515,5.5
39169,7/1/19,62381,60152,2229,3.6
39171,7/1/19,19330,18631,699,3.6
39173,7/1/19,71541,68578,2963,4.1
39175,7/1/19,13146,12723,423,3.2
40001,7/1/19,7778,7435,343,4.4
40003,7/1/19,2748,2689,59,2.1
40005,7/1/19,4838,4620,218,4.5
40007,7/1/19,2758,2698,60,2.2
40009,7/1/19,10418,10102,316,3
40011,7/1/19,4818,4715,103,2.1
40013,7/1/19,22193,21488,705,3.2
40015,7/1/19,11380,10926,454,4
40017,7/1/19,74744,72533,2211,3
40019,7/1/19,21231,20475,756,3.6
40021,7/1/19,18945,18107,838,4.4
40023,7/1/19,5509,5231,278,5
40025,7/1/19,1305,1281,24,1.8
40027,7/1/19,143782,139527,4255,3
40029,7/1/19,2316,2221,95,4.1
40031,7/1/19,48488,46613,1875,3.9
40033,7/1/19,2748,2661,87,3.2
40035,7/1/19,5919,5711,208,3.5
40037,7/1/19,32070,30887,1183,3.7
40039,7/1/19,15617,15204,413,2.6
40041,7/1/19,18510,17792,718,3.9
40043,7/1/19,2837,2778,59,2.1
40045,7/1/19,2117,2061,56,2.6
40047,7/1/19,27549,26713,836,3
40049,7/1/19,12380,11983,397,3.2
40051,7/1/19,26697,25872,825,3.1
40053,7/1/19,2664,2605,59,2.2
40055,7/1/19,1785,1704,81,4.5
40057,7/1/19,1162,1122,40,3.4
40059,7/1/19,1716,1669,47,2.7
40061,7/1/19,4091,3864,227,5.5
40063,7/1/19,5147,4876,271,5.3
40065,7/1/19,10325,10005,320,3.1
40067,7/1/19,2394,2302,92,3.8
40069,7/1/19,3677,3519,158,4.3
40071,7/1/19,18195,17385,810,4.5
40073,7/1/19,9072,8874,198,2.2
40075,7/1/19,3474,3336,138,4
40077,7/1/19,3109,2906,203,6.5
40079,7/1/19,19140,18224,916,4.8
40081,7/1/19,15932,15370,562,3.5
40083,7/1/19,22260,21600,660,3
40085,7/1/19,6129,5974,155,2.5
40087,7/1/19,19821,19279,542,2.7
40089,7/1/19,14293,13434,859,6
40091,7/1/19,7148,6709,439,6.1
40093,7/1/19,3886,3802,84,2.2
40095,7/1/19,6933,6682,251,3.6
40097,7/1/19,19211,18581,630,3.3
40099,7/1/19,6319,6125,194,3.1
40101,7/1/19,30340,28865,1475,4.9
40103,7/1/19,5650,5511,139,2.5
40105,7/1/19,4478,4315,163,3.6
40107,7/1/19,4513,4290,223,4.9
40109,7/1/19,387444,374887,12557,3.2
40111,7/1/19,15951,15150,801,5
40113,7/1/19,20984,20178,806,3.8
40115,7/1/19,13907,13401,506,3.6
40117,7/1/19,7478,7187,291,3.9
40119,7/1/19,38078,36916,1162,3.1
40121,7/1/19,16522,15788,734,4.4
40123,7/1/19,18626,18043,583,3.1
40125,7/1/19,31746,30542,1204,3.8
40127,7/1/19,4190,3972,218,5.2
40129,7/1/19,1825,1769,56,3.1
40131,7/1/19,45690,44260,1430,3.1
40133,7/1/19,9050,8596,454,5
40135,7/1/19,16265,15592,673,4.1
40137,7/1/19,18619,17811,808,4.3
40139,7/1/19,11136,10901,235,2.1
40141,7/1/19,2924,2801,123,4.2
40143,7/1/19,327915,317550,10365,3.2
40145,7/1/19,38494,37280,1214,3.2
40147,7/1/19,22630,21821,809,3.6
40149,7/1/19,5057,4891,166,3.3
40151,7/1/19,4525,4416,109,2.4
40153,7/1/19,9136,8900,236,2.6
41001,7/1/19,7108,6799,309,4.3
41003,7/1/19,46188,44474,1714,3.7
41005,7/1/19,221108,212948,8160,3.7
41007,7/1/19,20228,19510,718,3.5
41009,7/1/19,24569,23380,1189,4.8
41011,7/1/19,26185,24788,1397,5.3
41013,7/1/19,9810,9314,496,5.1
41015,7/1/19,9100,8658,442,4.9
41017,7/1/19,97698,94019,3679,3.8
41019,7/1/19,46695,44278,2417,5.2
41021,7/1/19,996,964,32,3.2
41023,7/1/19,3264,3115,149,4.6
41025,7/1/19,3669,3512,157,4.3
41027,7/1/19,16399,15890,509,3.1
41029,7/1/19,103568,98246,5322,5.1
41031,7/1/19,10290,9817,473,4.6
41033,7/1/19,35865,34035,1830,5.1
41035,7/1/19,29548,27866,1682,5.7
41037,7/1/19,3826,3655,171,4.5
41039,7/1/19,179377,171416,7961,4.4
41041,7/1/19,21506,20568,938,4.4
41043,7/1/19,58253,55461,2792,4.8
41045,7/1/19,12414,11845,569,4.6
41047,7/1/19,164971,157860,7111,4.3
41049,7/1/19,5971,5658,313,5.2
41051,7/1/19,457534,441397,16137,3.5
41053,7/1/19,40372,38522,1850,4.6
41055,7/1/19,994,961,33,3.3
41057,7/1/19,12244,11781,463,3.8
41059,7/1/19,38721,36439,2282,5.9
41061,7/1/19,12008,11470,538,4.5
41063,7/1/19,3644,3487,157,4.3
41065,7/1/19,18388,17853,535,2.9
41067,7/1/19,327465,316364,11101,3.4
41069,7/1/19,719,688,31,4.3
41071,7/1/19,55715,53616,2099,3.8
42001,7/1/19,56165,53975,2190,3.9
42003,7/1/19,658352,628036,30316,4.6
42005,7/1/19,32766,31058,1708,5.2
42007,7/1/19,85288,81097,4191,4.9
42009,7/1/19,24181,23005,1176,4.9
42011,7/1/19,219663,209028,10635,4.8
42013,7/1/19,60843,57573,3270,5.4
42015,7/1/19,29759,28393,1366,4.6
42017,7/1/19,351667,336557,15110,4.3
42019,7/1/19,101491,97099,4392,4.3
42021,7/1/19,58394,54741,3653,6.3
42023,7/1/19,2163,2034,129,6
42025,7/1/19,32513,30654,1859,5.7
42027,7/1/19,77590,74383,3207,4.1
42029,7/1/19,295072,283911,11161,3.8
42031,7/1/19,17130,16225,905,5.3
42033,7/1/19,36209,34290,1919,5.3
42035,7/1/19,18482,17467,1015,5.5
42037,7/1/19,33686,31912,1774,5.3
42039,7/1/19,39381,37335,2046,5.2
42041,7/1/19,135903,130575,5328,3.9
42043,7/1/19,148058,141299,6759,4.6
42045,7/1/19,301599,287707,13892,4.6
42047,7/1/19,16109,15273,836,5.2
42049,7/1/19,130267,123664,6603,5.1
42051,7/1/19,57976,54436,3540,6.1
42053,7/1/19,1880,1752,128,6.8
42055,7/1/19,79077,75602,3475,4.4
42057,7/1/19,8124,7777,347,4.3
42059,7/1/19,16700,15738,962,5.8
42061,7/1/19,20242,19106,1136,5.6
42063,7/1/19,38984,36698,2286,5.9
42065,7/1/19,21018,19982,1036,4.9
42067,7/1/19,13007,12429,578,4.4
42069,7/1/19,106167,100261,5906,5.6
42071,7/1/19,292146,280307,11839,4.1
42073,7/1/19,41380,39236,2144,5.2
42075,7/1/19,74280,71110,3170,4.3
42077,7/1/19,194854,185200,9654,5
42079,7/1/19,158751,149046,9705,6.1
42081,7/1/19,57189,54363,2826,4.9
42083,7/1/19,17677,16690,987,5.6
42085,7/1/19,50262,47527,2735,5.4
42087,7/1/19,21516,20454,1062,4.9
42089,7/1/19,84978,80019,4959,5.8
42091,7/1/19,464707,446046,18661,4
42093,7/1/19,9160,8785,375,4.1
42095,7/1/19,163271,155100,8171,5
42097,7/1/19,44370,41804,2566,5.8
42099,7/1/19,25338,24314,1024,4
42101,7/1/19,723626,678020,45606,6.3
42103,7/1/19,25786,24291,1495,5.8
42105,7/1/19,7474,7072,402,5.4
42107,7/1/19,67917,63936,3981,5.9
42109,7/1/19,20212,18818,1394,6.9
42111,7/1/19,34066,32196,1870,5.5
42113,7/1/19,2761,2627,134,4.9
42115,7/1/19,21329,20453,876,4.1
42117,7/1/19,19501,18442,1059,5.4
42119,7/1/19,19878,18877,1001,5
42121,7/1/19,22822,21617,1205,5.3
42123,7/1/19,19438,18515,923,4.7
42125,7/1/19,108744,103462,5282,4.9
42127,7/1/19,24548,23501,1047,4.3
42129,7/1/19,184039,174944,9095,4.9
42131,7/1/19,13757,13078,679,4.9
42133,7/1/19,239871,229110,10761,4.5
44001,7/1/19,26243,25403,840,3.2
44003,7/1/19,91677,88435,3242,3.5
44005,7/1/19,44516,43206,1310,2.9
44007,7/1/19,329289,315137,14152,4.3
44009,7/1/19,70456,68199,2257,3.2
45001,7/1/19,9792,9441,351,3.6
45003,7/1/19,75454,73104,2350,3.1
45005,7/1/19,2699,2551,148,5.5
45007,7/1/19,92340,89689,2651,2.9
45009,7/1/19,4955,4652,303,6.1
45011,7/1/19,8297,7927,370,4.5
45013,7/1/19,80433,78146,2287,2.8
45015,7/1/19,106064,103244,2820,2.7
45017,7/1/19,6678,6426,252,3.8
45019,7/1/19,215888,210555,5333,2.5
45021,7/1/19,24679,23799,880,3.6
45023,7/1/19,13526,12912,614,4.5
45025,7/1/19,22312,21590,722,3.2
45027,7/1/19,12407,11864,543,4.4
45029,7/1/19,17019,16448,571,3.4
45031,7/1/19,30894,29746,1148,3.7
45033,7/1/19,12693,12157,536,4.2
45035,7/1/19,79705,77604,2101,2.6
45037,7/1/19,10834,10513,321,3
45039,7/1/19,9707,9266,441,4.5
45041,7/1/19,67754,65650,2104,3.1
45043,7/1/19,26676,25736,940,3.5
45045,7/1/19,257808,251238,6570,2.5
45047,7/1/19,30592,29556,1036,3.4
45049,7/1/19,8515,8252,263,3.1
45051,7/1/19,156579,151458,5121,3.3
45053,7/1/19,13132,12760,372,2.8
45055,7/1/19,29601,28647,954,3.2
45057,7/1/19,41459,40020,1439,3.5
45059,7/1/19,30594,29630,964,3.2
45061,7/1/19,6735,6447,288,4.3
45063,7/1/19,151458,147677,3781,2.5
45065,7/1/19,3384,3276,108,3.2
45067,7/1/19,13361,12761,600,4.5
45069,7/1/19,9072,8558,514,5.7
45071,7/1/19,19445,18883,562,2.9
45073,7/1/19,34866,33773,1093,3.1
45075,7/1/19,34611,32914,1697,4.9
45077,7/1/19,58171,56424,1747,3
45079,7/1/19,200420,194443,5977,3
45081,7/1/19,9088,8836,252,2.8
45083,7/1/19,153824,149471,4353,2.8
45085,7/1/19,43834,42257,1577,3.6
45087,7/1/19,11709,11270,439,3.7
45089,7/1/19,12231,11652,579,4.7
45091,7/1/19,140877,136707,4170,3
46003,7/1/19,1531,1499,32,2.1
46005,7/1/19,9832,9574,258,2.6
46007,7/1/19,1115,1059,56,5
46009,7/1/19,2940,2853,87,3
46011,7/1/19,18862,18236,626,3.3
46013,7/1/19,20813,20233,580,2.8
46015,7/1/19,2504,2424,80,3.2
46017,7/1/19,700,642,58,8.3
46019,7/1/19,5142,4986,156,3
46021,7/1/19,787,761,26,3.3
46023,7/1/19,3860,3717,143,3.7
46025,7/1/19,1946,1875,71,3.6
46027,7/1/19,6973,6741,232,3.3
46029,7/1/19,15612,15188,424,2.7
46031,7/1/19,1363,1253,110,8.1
46033,7/1/19,4116,3975,141,3.4
46035,7/1/19,11320,11034,286,2.5
46037,7/1/19,2850,2748,102,3.6
46039,7/1/19,2298,2216,82,3.6
46041,7/1/19,2379,1961,418,17.6
46043,7/1/19,1616,1581,35,2.2
46045,7/1/19,2039,1983,56,2.7
46047,7/1/19,3136,3023,113,3.6
46049,7/1/19,1063,1031,32,3
46051,7/1/19,4453,4340,113,2.5
46053,7/1/19,2041,1985,56,2.7
46055,7/1/19,1056,1030,26,2.5
46057,7/1/19,3384,3293,91,2.7
46059,7/1/19,1750,1705,45,2.6
46061,7/1/19,1768,1692,76,4.3
46063,7/1/19,726,707,19,2.6
46065,7/1/19,10228,10001,227,2.2
46067,7/1/19,3683,3599,84,2.3
46069,7/1/19,668,649,19,2.8
46071,7/1/19,1349,1280,69,5.1
46073,7/1/19,1132,1104,28,2.5
46075,7/1/19,593,578,15,2.5
46077,7/1/19,2694,2623,71,2.6
46079,7/1/19,6653,6415,238,3.6
46081,7/1/19,13750,13365,385,2.8
46083,7/1/19,35124,34360,764,2.2
46085,7/1/19,1795,1700,95,5.3
46087,7/1/19,3102,3037,65,2.1
46089,7/1/19,988,949,39,3.9
46091,7/1/19,2432,2354,78,3.2
46093,7/1/19,14705,14244,461,3.1
46095,7/1/19,732,682,50,6.8
46097,7/1/19,1184,1147,37,3.1
46099,7/1/19,114826,111998,2828,2.5
46101,7/1/19,4122,3903,219,5.3
46102,7/1/19,3728,3215,513,13.8
46103,7/1/19,59096,57340,1756,3
46105,7/1/19,1418,1379,39,2.8
46107,7/1/19,1086,1058,28,2.6
46109,7/1/19,4744,4564,180,3.8
46111,7/1/19,1164,1129,35,3
46115,7/1/19,3225,3138,87,2.7
46117,7/1/19,1872,1829,43,2.3
46119,7/1/19,805,786,19,2.4
46121,7/1/19,3199,2935,264,8.3
46123,7/1/19,3164,3062,102,3.2
46125,7/1/19,4759,4638,121,2.5
46127,7/1/19,8502,8223,279,3.3
46129,7/1/19,2198,2083,115,5.2
46135,7/1/19,12230,11942,288,2.4
46137,7/1/19,923,841,82,8.9
47001,7/1/19,35377,33867,1510,4.3
47003,7/1/19,21459,20496,963,4.5
47005,7/1/19,6890,6535,355,5.2
47007,7/1/19,4301,4037,264,6.1
47009,7/1/19,64724,62332,2392,3.7
47011,7/1/19,52791,50602,2189,4.1
47013,7/1/19,15119,14354,765,5.1
47015,7/1/19,6773,6515,258,3.8
47017,7/1/19,12128,11433,695,5.7
47019,7/1/19,24203,23081,1122,4.6
47021,7/1/19,22443,21768,675,3
47023,7/1/19,8740,8398,342,3.9
47025,7/1/19,13204,12532,672,5.1
47027,7/1/19,2731,2536,195,7.1
47029,7/1/19,15418,14672,746,4.8
47031,7/1/19,26090,25085,1005,3.9
47033,7/1/19,7112,6844,268,3.8
47035,7/1/19,23906,22759,1147,4.8
47037,7/1/19,414455,402332,12123,2.9
47039,7/1/19,4654,4399,255,5.5
47041,7/1/19,7923,7541,382,4.8
47043,7/1/19,27711,26760,951,3.4
47045,7/1/19,16580,15659,921,5.6
47047,7/1/19,19530,18744,786,4
47049,7/1/19,7499,7112,387,5.2
47051,7/1/19,20475,19681,794,3.9
47053,7/1/19,22333,21277,1056,4.7
47055,7/1/19,14900,14198,702,4.7
47057,7/1/19,9697,9252,445,4.6
47059,7/1/19,30186,28571,1615,5.4
47061,7/1/19,4909,4653,256,5.2
47063,7/1/19,28401,27147,1254,4.4
47065,7/1/19,187940,180798,7142,3.8
47067,7/1/19,2107,1954,153,7.3
47069,7/1/19,9635,9143,492,5.1
47071,7/1/19,10637,10111,526,4.9
47073,7/1/19,24118,22949,1169,4.8
47075,7/1/19,7654,7246,408,5.3
47077,7/1/19,12463,11890,573,4.6
47079,7/1/19,14461,13820,641,4.4
47081,7/1/19,11736,11316,420,3.6
47083,7/1/19,3263,3095,168,5.1
47085,7/1/19,9012,8640,372,4.1
47087,7/1/19,4697,4449,248,5.3
47089,7/1/19,24804,23757,1047,4.2
47091,7/1/19,7700,7402,298,3.9
47093,7/1/19,248900,240154,8746,3.5
47095,7/1/19,1774,1663,111,6.3
47097,7/1/19,9793,9204,589,6
47099,7/1/19,19456,18532,924,4.7
47101,7/1/19,5228,5005,223,4.3
47103,7/1/19,17024,16406,618,3.6
47105,7/1/19,23894,22944,950,4
47107,7/1/19,24531,23465,1066,4.3
47109,7/1/19,8567,8076,491,5.7
47111,7/1/19,11539,11094,445,3.9
47113,7/1/19,50164,48145,2019,4
47115,7/1/19,12787,12154,633,5
47117,7/1/19,15789,15194,595,3.8
47119,7/1/19,50492,48882,1610,3.2
47121,7/1/19,5241,4964,277,5.3
47123,7/1/19,20510,19608,902,4.4
47125,7/1/19,87190,83275,3915,4.5
47127,7/1/19,3595,3468,127,3.5
47129,7/1/19,8031,7649,382,4.8
47131,7/1/19,12657,11956,701,5.5
47133,7/1/19,9979,9527,452,4.5
47135,7/1/19,3072,2919,153,5
47137,7/1/19,2446,2324,122,5
47139,7/1/19,7641,7263,378,4.9
47141,7/1/19,35240,33767,1473,4.2
47143,7/1/19,13324,12484,840,6.3
47145,7/1/19,23871,22743,1128,4.7
47147,7/1/19,38907,37614,1293,3.3
47149,7/1/19,188832,183080,5752,3
47151,7/1/19,8523,8102,421,4.9
47153,7/1/19,6356,6035,321,5.1
47155,7/1/19,57888,56155,1733,3
47157,7/1/19,455900,435012,20888,4.6
47159,7/1/19,9691,9352,339,3.5
47161,7/1/19,5561,5282,279,5
47163,7/1/19,71376,68253,3123,4.4
47165,7/1/19,104983,101747,3236,3.1
47167,7/1/19,28785,27519,1266,4.4
47169,7/1/19,5565,5364,201,3.6
47171,7/1/19,7123,6735,388,5.4
47173,7/1/19,7818,7427,391,5
47175,7/1/19,2072,1962,110,5.3
47177,7/1/19,17130,16289,841,4.9
47179,7/1/19,60790,58333,2457,4
47181,7/1/19,6267,5959,308,4.9
47183,7/1/19,15982,15013,969,6.1
47185,7/1/19,12312,11757,555,4.5
47187,7/1/19,131763,127968,3795,2.9
47189,7/1/19,78557,76101,2456,3.1
48001,7/1/19,24070,23310,760,3.2
48003,7/1/19,9912,9666,246,2.5
48005,7/1/19,35800,34240,1560,4.4
48007,7/1/19,9427,8992,435,4.6
48009,7/1/19,4148,4019,129,3.1
48011,7/1/19,926,900,26,2.8
48013,7/1/19,21757,20906,851,3.9
48015,7/1/19,14122,13583,539,3.8
48017,7/1/19,2523,2412,111,4.4
48019,7/1/19,10078,9728,350,3.5
48021,7/1/19,43111,41601,1510,3.5
48023,7/1/19,1788,1745,43,2.4
48025,7/1/19,9740,9273,467,4.8
48027,7/1/19,143926,137945,5981,4.2
48029,7/1/19,952247,919342,32905,3.5
48031,7/1/19,6515,6335,180,2.8
48033,7/1/19,440,429,11,2.5
48035,7/1/19,8424,8115,309,3.7
48037,7/1/19,39503,37559,1944,4.9
48039,7/1/19,180092,171749,8343,4.6
48041,7/1/19,114926,111278,3648,3.2
48043,7/1/19,4184,4040,144,3.4
48045,7/1/19,567,546,21,3.7
48047,7/1/19,2616,2442,174,6.7
48049,7/1/19,15659,14996,663,4.2
48051,7/1/19,8071,7797,274,3.4
48053,7/1/19,23891,23171,720,3
48055,7/1/19,19768,19008,760,3.8
48057,7/1/19,12234,11795,439,3.6
48059,7/1/19,6116,5904,212,3.5
48061,7/1/19,167732,157789,9943,5.9
48063,7/1/19,5011,4773,238,4.7
48065,7/1/19,3005,2922,83,2.8
48067,7/1/19,12464,11885,579,4.6
48069,7/1/19,3372,3267,105,3.1
48071,7/1/19,19572,18575,997,5.1
48073,7/1/19,20938,20103,835,4
48075,7/1/19,3021,2935,86,2.8
48077,7/1/19,4951,4775,176,3.6
48079,7/1/19,1127,1079,48,4.3
48081,7/1/19,1473,1420,53,3.6
48083,7/1/19,2893,2767,126,4.4
48085,7/1/19,566346,547316,19030,3.4
48087,7/1/19,1161,1122,39,3.4
48089,7/1/19,10069,9741,328,3.3
48091,7/1/19,73493,71080,2413,3.3
48093,7/1/19,5587,5392,195,3.5
48095,7/1/19,1283,1236,47,3.7
48097,7/1/19,19996,19387,609,3
48099,7/1/19,24148,23100,1048,4.3
48101,7/1/19,542,521,21,3.9
48103,7/1/19,1588,1517,71,4.5
48105,7/1/19,1650,1602,48,2.9
48107,7/1/19,2511,2389,122,4.9
48109,7/1/19,1086,1033,53,4.9
48111,7/1/19,3972,3885,87,2.2
48113,7/1/19,1371036,1319740,51296,3.7
48115,7/1/19,4627,4432,195,4.2
48117,7/1/19,8496,8220,276,3.2
48119,7/1/19,2419,2332,87,3.6
48121,7/1/19,497065,480939,16126,3.2
48123,7/1/19,9860,9584,276,2.8
48125,7/1/19,691,661,30,4.3
48127,7/1/19,8012,7788,224,2.8
48129,7/1/19,1401,1343,58,4.1
48131,7/1/19,4948,4708,240,4.9
48133,7/1/19,8176,7871,305,3.7
48135,7/1/19,88454,85933,2521,2.9
48137,7/1/19,1075,1050,25,2.3
48139,7/1/19,93193,89969,3224,3.5
48141,7/1/19,360254,345434,14820,4.1
48143,7/1/19,20027,19270,757,3.8
48145,7/1/19,6611,6376,235,3.6
48147,7/1/19,17482,16963,519,3
48149,7/1/19,12219,11851,368,3
48151,7/1/19,1655,1595,60,3.6
48153,7/1/19,2605,2482,123,4.7
48155,7/1/19,601,582,19,3.2
48157,7/1/19,392806,378023,14783,3.8
48159,7/1/19,4725,4537,188,4
48161,7/1/19,6440,6106,334,5.2
48163,7/1/19,10523,10202,321,3.1
48165,7/1/19,9821,9555,266,2.7
48167,7/1/19,165810,158539,7271,4.4
48169,7/1/19,2191,2129,62,2.8
48171,7/1/19,13699,13343,356,2.6
48173,7/1/19,796,777,19,2.4
48175,7/1/19,3265,3147,118,3.6
48177,7/1/19,9549,9265,284,3
48179,7/1/19,8166,7855,311,3.8
48181,7/1/19,64573,62456,2117,3.3
48183,7/1/19,58408,56034,2374,4.1
48185,7/1/19,11121,10613,508,4.6
48187,7/1/19,81730,79061,2669,3.3
48189,7/1/19,12122,11462,660,5.4
48191,7/1/19,1067,1023,44,4.1
48193,7/1/19,3705,3582,123,3.3
48195,7/1/19,2782,2713,69,2.5
48197,7/1/19,1735,1678,57,3.3
48199,7/1/19,25148,23844,1304,5.2
48201,7/1/19,2320496,2224686,95810,4.1
48203,7/1/19,29332,28079,1253,4.3
48205,7/1/19,2824,2774,50,1.8
48207,7/1/19,2270,2191,79,3.5
48209,7/1/19,120192,116580,3612,3
48211,7/1/19,1962,1904,58,3
48213,7/1/19,36612,35183,1429,3.9
48215,7/1/19,348112,324042,24070,6.9
48217,7/1/19,16460,15851,609,3.7
48219,7/1/19,11240,10865,375,3.3
48221,7/1/19,27609,26580,1029,3.7
48223,7/1/19,17551,16976,575,3.3
48225,7/1/19,10627,10256,371,3.5
48227,7/1/19,14079,13589,490,3.5
48229,7/1/19,1819,1730,89,4.9
48231,7/1/19,43634,41935,1699,3.9
48233,7/1/19,8866,8426,440,5
48235,7/1/19,754,732,22,2.9
48237,7/1/19,3534,3420,114,3.2
48239,7/1/19,7698,7435,263,3.4
48241,7/1/19,12845,11982,863,6.7
48243,7/1/19,1080,1047,33,3.1
48245,7/1/19,106477,99433,7044,6.6
48247,7/1/19,1857,1764,93,5
48249,7/1/19,16818,15954,864,5.1
48251,7/1/19,82360,79449,2911,3.5
48253,7/1/19,5749,5476,273,4.7
48255,7/1/19,7228,7029,199,2.8
48257,7/1/19,64944,62608,2336,3.6
48259,7/1/19,22169,21499,670,3
48261,7/1/19,207,196,11,5.3
48263,7/1/19,490,480,10,2
48265,7/1/19,22705,21984,721,3.2
48267,7/1/19,1936,1871,65,3.4
48269,7/1/19,237,231,6,2.5
48271,7/1/19,1384,1333,51,3.7
48273,7/1/19,13138,12486,652,5
48275,7/1/19,1441,1391,50,3.5
48277,7/1/19,23980,23124,856,3.6
48279,7/1/19,5288,5073,215,4.1
48281,7/1/19,9207,8876,331,3.6
48283,7/1/19,4529,4421,108,2.4
48285,7/1/19,8680,8398,282,3.2
48287,7/1/19,10065,9770,295,2.9
48289,7/1/19,6379,6074,305,4.8
48291,7/1/19,33217,31374,1843,5.5
48293,7/1/19,8588,8232,356,4.1
48295,7/1/19,1613,1562,51,3.2
48297,7/1/19,5698,5508,190,3.3
48299,7/1/19,8936,8608,328,3.7
48301,7/1/19,590,586,4,0.7
48303,7/1/19,158287,152951,5336,3.4
48305,7/1/19,2766,2677,89,3.2
48307,7/1/19,3415,3207,208,6.1
48309,7/1/19,120620,116079,4541,3.8
48311,7/1/19,850,836,14,1.6
48313,7/1/19,4482,4247,235,5.2
48315,7/1/19,4249,4068,181,4.3
48317,7/1/19,2914,2835,79,2.7
48319,7/1/19,1772,1706,66,3.7
48321,7/1/19,16694,15643,1051,6.3
48323,7/1/19,22865,21083,1782,7.8
48325,7/1/19,21872,21124,748,3.4
48327,7/1/19,869,836,33,3.8
48329,7/1/19,108676,106270,2406,2.2
48331,7/1/19,9779,9271,508,5.2
48333,7/1/19,1927,1861,66,3.4
48335,7/1/19,2317,2227,90,3.9
48337,7/1/19,9404,9122,282,3
48339,7/1/19,284446,273898,10548,3.7
48341,7/1/19,10983,10698,285,2.6
48343,7/1/19,4861,4583,278,5.7
48345,7/1/19,493,475,18,3.7
48347,7/1/19,28074,26829,1245,4.4
48349,7/1/19,24151,23324,827,3.4
48351,7/1/19,5169,4795,374,7.2
48353,7/1/19,7191,6965,226,3.1
48355,7/1/19,167471,160113,7358,4.4
48357,7/1/19,4317,4190,127,2.9
48359,7/1/19,916,886,30,3.3
48361,7/1/19,36175,34071,2104,5.8
48363,7/1/19,13712,13236,476,3.5
48365,7/1/19,10080,9626,454,4.5
48367,7/1/19,67428,65289,2139,3.2
48369,7/1/19,4911,4789,122,2.5
48371,7/1/19,6441,6215,226,3.5
48373,7/1/19,18070,17129,941,5.2
48375,7/1/19,55230,53495,1735,3.1
48377,7/1/19,3120,2907,213,6.8
48379,7/1/19,5988,5793,195,3.3
48381,7/1/19,72062,70111,1951,2.7
48383,7/1/19,1936,1885,51,2.6
48385,7/1/19,1171,1125,46,3.9
48387,7/1/19,5099,4850,249,4.9
48389,7/1/19,11215,11000,215,1.9
48391,7/1/19,3144,3019,125,4
48393,7/1/19,428,413,15,3.5
48395,7/1/19,7396,7107,289,3.9
48397,7/1/19,52299,50563,1736,3.3
48399,7/1/19,4638,4502,136,2.9
48401,7/1/19,23085,22187,898,3.9
48403,7/1/19,3847,3567,280,7.3
48405,7/1/19,3339,3171,168,5
48407,7/1/19,11697,11122,575,4.9
48409,7/1/19,29951,28208,1743,5.8
48411,7/1/19,2497,2419,78,3.1
48413,7/1/19,1292,1246,46,3.6
48415,7/1/19,6805,6542,263,3.9
48417,7/1/19,1940,1896,44,2.3
48419,7/1/19,11266,10773,493,4.4
48421,7/1/19,1369,1332,37,2.7
48423,7/1/19,107191,103276,3915,3.7
48425,7/1/19,4366,4204,162,3.7
48427,7/1/19,24693,22011,2682,10.9
48429,7/1/19,4089,3955,134,3.3
48431,7/1/19,572,554,18,3.1
48433,7/1/19,614,595,19,3.1
48435,7/1/19,1327,1273,54,4.1
48437,7/1/19,2611,2510,101,3.9
48439,7/1/19,1084792,1045899,38893,3.6
48441,7/1/19,66961,64825,2136,3.2
48443,7/1/19,369,357,12,3.3
48445,7/1/19,4982,4783,199,4
48447,7/1/19,660,631,29,4.4
48449,7/1/19,13043,12435,608,4.7
48451,7/1/19,54076,52228,1848,3.4
48453,7/1/19,742943,721984,20959,2.8
48455,7/1/19,5318,5058,260,4.9
48457,7/1/19,7209,6758,451,6.3
48459,7/1/19,17915,17203,712,4
48461,7/1/19,1712,1659,53,3.1
48463,7/1/19,11675,11189,486,4.2
48465,7/1/19,22930,22127,803,3.5
48467,7/1/19,26315,25379,936,3.6
48469,7/1/19,42772,41194,1578,3.7
48471,7/1/19,23848,22763,1085,4.5
48473,7/1/19,23540,22554,986,4.2
48475,7/1/19,7500,7309,191,2.5
48477,7/1/19,15317,14726,591,3.9
48479,7/1/19,118394,113600,4794,4
48481,7/1/19,21797,20969,828,3.8
48483,7/1/19,2360,2285,75,3.2
48485,7/1/19,56523,54488,2035,3.6
48487,7/1/19,4989,4785,204,4.1
48489,7/1/19,6506,5879,627,9.6
48491,7/1/19,314705,305213,9492,3
48493,7/1/19,24940,24155,785,3.1
48495,7/1/19,4034,3912,122,3
48497,7/1/19,32032,30822,1210,3.8
48499,7/1/19,17715,16985,730,4.1
48501,7/1/19,3745,3629,116,3.1
48503,7/1/19,8080,7813,267,3.3
48505,7/1/19,4855,4560,295,6.1
48507,7/1/19,3318,2995,323,9.7
49001,7/1/19,2725,2635,90,3.3
49003,7/1/19,26139,25444,695,2.7
49005,7/1/19,61246,59747,1499,2.4
49007,7/1/19,8487,8165,322,3.8
49009,7/1/19,442,430,12,2.7
49011,7/1/19,176599,172176,4423,2.5
49013,7/1/19,7781,7463,318,4.1
49015,7/1/19,4284,4119,165,3.9
49017,7/1/19,3171,3063,108,3.4
49019,7/1/19,6834,6674,160,2.3
49021,7/1/19,23500,22747,753,3.2
49023,7/1/19,5661,5513,148,2.6
49025,7/1/19,4201,4101,100,2.4
49027,7/1/19,6017,5850,167,2.8
49029,7/1/19,5649,5501,148,2.6
49031,7/1/19,471,451,20,4.2
49033,7/1/19,1562,1530,32,2
49035,7/1/19,642182,625576,16606,2.6
49037,7/1/19,5773,5503,270,4.7
49039,7/1/19,12151,11714,437,3.6
49041,7/1/19,9761,9448,313,3.2
49043,7/1/19,24963,24367,596,2.4
49045,7/1/19,34418,33358,1060,3.1
49047,7/1/19,13903,13310,593,4.3
49049,7/1/19,305084,297162,7922,2.6
49051,7/1/19,16493,16050,443,2.7
49053,7/1/19,76101,73700,2401,3.2
49055,7/1/19,1500,1448,52,3.5
49057,7/1/19,129321,125539,3782,2.9
50001,7/1/19,21189,20700,489,2.3
50003,7/1/19,18365,17839,526,2.9
50005,7/1/19,14809,14396,413,2.8
50007,7/1/19,97751,95840,1911,2
50009,7/1/19,2745,2661,84,3.1
50011,7/1/19,27573,26882,691,2.5
50013,7/1/19,4070,3972,98,2.4
50015,7/1/19,14067,13706,361,2.6
50017,7/1/19,16207,15853,354,2.2
50019,7/1/19,13212,12735,477,3.6
50021,7/1/19,31052,30160,892,2.9
50023,7/1/19,34476,33753,723,2.1
50025,7/1/19,22144,21584,560,2.5
50027,7/1/19,29049,28418,631,2.2
51001,7/1/19,17272,16711,561,3.2
51003,7/1/19,57765,56162,1603,2.8
51005,7/1/19,6798,6553,245,3.6
51007,7/1/19,6432,6215,217,3.4
51009,7/1/19,15201,14642,559,3.7
51011,7/1/19,7233,6964,269,3.7
51013,7/1/19,158146,155069,3077,1.9
51015,7/1/19,37924,36970,954,2.5
51017,7/1/19,2611,2553,58,2.2
51019,7/1/19,38758,37587,1171,3
51021,7/1/19,2832,2745,87,3.1
51023,7/1/19,17613,17159,454,2.6
51025,7/1/19,6120,5833,287,4.7
51027,7/1/19,6780,6327,453,6.7
51029,7/1/19,6493,6208,285,4.4
51031,7/1/19,26208,25314,894,3.4
51033,7/1/19,15569,15041,528,3.4
51035,7/1/19,13291,12838,453,3.4
51036,7/1/19,3745,3616,129,3.4
51037,7/1/19,5323,5112,211,4
51041,7/1/19,191298,185623,5675,3
51043,7/1/19,7825,7627,198,2.5
51045,7/1/19,2337,2255,82,3.5
51047,7/1/19,25291,24616,675,2.7
51049,7/1/19,4722,4569,153,3.2
51051,7/1/19,4714,4464,250,5.3
51053,7/1/19,13969,13492,477,3.4
51057,7/1/19,5571,5383,188,3.4
51059,7/1/19,651558,635931,15627,2.4
51061,7/1/19,38329,37351,978,2.6
51063,7/1/19,8148,7940,208,2.6
51065,7/1/19,14007,13654,353,2.5
51067,7/1/19,26755,25954,801,3
51069,7/1/19,48980,47730,1250,2.6
51071,7/1/19,7783,7532,251,3.2
51073,7/1/19,20057,19537,520,2.6
51075,7/1/19,11462,11129,333,2.9
51077,7/1/19,7973,7736,237,3
51079,7/1/19,10587,10315,272,2.6
51081,7/1/19,4336,4183,153,3.5
51083,7/1/19,15544,14842,702,4.5
51085,7/1/19,60428,58880,1548,2.6
51087,7/1/19,185531,180056,5475,3
51089,7/1/19,23846,23005,841,3.5
51091,7/1/19,1312,1278,34,2.6
51093,7/1/19,19960,19361,599,3
51095,7/1/19,37510,36447,1063,2.8
51097,7/1/19,3928,3810,118,3
51099,7/1/19,13744,13382,362,2.6
51101,7/1/19,9347,9091,256,2.7
51103,7/1/19,5599,5404,195,3.5
51105,7/1/19,8291,7906,385,4.6
51107,7/1/19,228311,222749,5562,2.4
51109,7/1/19,20021,19464,557,2.8
51111,7/1/19,5371,5179,192,3.6
51113,7/1/19,7501,7330,171,2.3
51115,7/1/19,4235,4117,118,2.8
51117,7/1/19,12789,12241,548,4.3
51119,7/1/19,5473,5334,139,2.5
51121,7/1/19,49471,47870,1601,3.2
51125,7/1/19,7569,7332,237,3.1
51127,7/1/19,12742,12413,329,2.6
51131,7/1/19,5872,5635,237,4
51133,7/1/19,5853,5653,200,3.4
51135,7/1/19,7316,7105,211,2.9
51137,7/1/19,17774,17215,559,3.1
51139,7/1/19,12276,11870,406,3.3
51141,7/1/19,7192,6923,269,3.7
51143,7/1/19,29752,28566,1186,4
51145,7/1/19,14431,14044,387,2.7
51147,7/1/19,10594,10106,488,4.6
51149,7/1/19,15399,14842,557,3.6
51153,7/1/19,251730,245137,6593,2.6
51155,7/1/19,15798,15265,533,3.4
51157,7/1/19,3816,3715,101,2.6
51159,7/1/19,4170,4041,129,3.1
51161,7/1/19,49944,48588,1356,2.7
51163,7/1/19,11087,10778,309,2.8
51165,7/1/19,41770,40686,1084,2.6
51167,7/1/19,11142,10641,501,4.5
51169,7/1/19,9127,8832,295,3.2
51171,7/1/19,22882,22304,578,2.5
51173,7/1/19,14005,13446,559,4
51175,7/1/19,9291,9020,271,2.9
51177,7/1/19,68874,66712,2162,3.1
51179,7/1/19,73867,71739,2128,2.9
51181,7/1/19,3751,3603,148,3.9
51183,7/1/19,3930,3743,187,4.8
51185,7/1/19,15424,14657,767,5
51187,7/1/19,20974,20362,612,2.9
51191,7/1/19,26766,25799,967,3.6
51193,7/1/19,9840,9508,332,3.4
51195,7/1/19,13348,12642,706,5.3
51197,7/1/19,13842,13327,515,3.7
51199,7/1/19,33528,32605,923,2.8
51510,7/1/19,103813,101587,2226,2.1
51520,7/1/19,7207,6911,296,4.1
51530,7/1/19,3388,3274,114,3.4
51540,7/1/19,26596,25895,701,2.6
51550,7/1/19,125623,121808,3815,3
51570,7/1/19,8975,8675,300,3.3
51580,7/1/19,2357,2252,105,4.5
51590,7/1/19,19064,17980,1084,5.7
51595,7/1/19,2328,2207,121,5.2
51600,7/1/19,13774,13486,288,2.1
51610,7/1/19,8828,8628,200,2.3
51620,7/1/19,3662,3504,158,4.3
51630,7/1/19,14528,14001,527,3.6
51640,7/1/19,2963,2850,113,3.8
51650,7/1/19,65905,63305,2600,3.9
51660,7/1/19,24870,23929,941,3.8
51670,7/1/19,9866,9426,440,4.5
51678,7/1/19,2122,1998,124,5.8
51680,7/1/19,36754,35146,1608,4.4
51683,7/1/19,22599,22019,580,2.6
51685,7/1/19,9615,9372,243,2.5
51690,7/1/19,5542,5292,250,4.5
51700,7/1/19,90920,87606,3314,3.6
51710,7/1/19,114357,110114,4243,3.7
51720,7/1/19,1683,1615,68,4
51730,7/1/19,13326,12514,812,6.1
51735,7/1/19,6548,6384,164,2.5
51740,7/1/19,45318,43478,1840,4.1
51750,7/1/19,8542,8178,364,4.3
51760,7/1/19,120786,116493,4293,3.6
51770,7/1/19,49769,48129,1640,3.3
51775,7/1/19,13135,12729,406,3.1
51790,7/1/19,12345,11997,348,2.8
51800,7/1/19,45706,44237,1469,3.2
51810,7/1/19,238470,231817,6653,2.8
51820,7/1/19,10773,10452,321,3
51830,7/1/19,6878,6574,304,4.4
51840,7/1/19,15080,14637,443,2.9
53001,7/1/19,11548,11099,449,3.9
53003,7/1/19,10297,9873,424,4.1
53005,7/1/19,105715,100769,4946,4.7
53007,7/1/19,51952,50099,1853,3.6
53009,7/1/19,29166,27357,1809,6.2
53011,7/1/19,239896,228202,11694,4.9
53013,7/1/19,1868,1784,84,4.5
53015,7/1/19,47659,44857,2802,5.9
53017,7/1/19,25217,24169,1048,4.2
53019,7/1/19,2505,2273,232,9.3
53021,7/1/19,45342,42973,2369,5.2
53023,7/1/19,958,916,42,4.4
53025,7/1/19,51218,48625,2593,5.1
53027,7/1/19,29048,27184,1864,6.4
53029,7/1/19,36222,34382,1840,5.1
53031,7/1/19,13134,12418,716,5.5
53033,7/1/19,1298313,1259313,39000,3
53035,7/1/19,128283,122403,5880,4.6
53037,7/1/19,22095,20932,1163,5.3
53039,7/1/19,10960,10393,567,5.2
53041,7/1/19,35199,33120,2079,5.9
53043,7/1/19,5193,4968,225,4.3
53045,7/1/19,25138,23614,1524,6.1
53047,7/1/19,23242,22121,1121,4.8
53049,7/1/19,9054,8513,541,6
53051,7/1/19,4975,4648,327,6.6
53053,7/1/19,439331,417202,22129,5
53055,7/1/19,9840,9539,301,3.1
53057,7/1/19,63642,60319,3323,5.2
53059,7/1/19,5522,5213,309,5.6
53061,7/1/19,441932,427741,14191,3.2
53063,7/1/19,251461,238797,12664,5
53065,7/1/19,18861,17708,1153,6.1
53067,7/1/19,141080,134273,6807,4.8
53069,7/1/19,1389,1302,87,6.3
53071,7/1/19,30556,29076,1480,4.8
53073,7/1/19,115641,109911,5730,5
53075,7/1/19,21292,20222,1070,5
53077,7/1/19,140212,132485,7727,5.5
54001,7/1/19,6931,6514,417,6
54003,7/1/19,59573,57461,2112,3.5
54005,7/1/19,7590,7190,400,5.3
54007,7/1/19,5224,4908,316,6
54009,7/1/19,10214,9685,529,5.2
54011,7/1/19,42058,40242,1816,4.3
54013,7/1/19,2492,2226,266,10.7
54015,7/1/19,3163,2943,220,7
54017,7/1/19,4117,3963,154,3.7
54019,7/1/19,16559,15682,877,5.3
54021,7/1/19,2314,2173,141,6.1
54023,7/1/19,6121,5790,331,5.4
54025,7/1/19,16560,15910,650,3.9
54027,7/1/19,10962,10534,428,3.9
54029,7/1/19,13407,12679,728,5.4
54031,7/1/19,5803,5518,285,4.9
54033,7/1/19,35521,34038,1483,4.2
54035,7/1/19,14172,13544,628,4.4
54037,7/1/19,30956,29971,985,3.2
54039,7/1/19,84086,80401,3685,4.4
54041,7/1/19,6989,6591,398,5.7
54043,7/1/19,7277,6825,452,6.2
54045,7/1/19,11246,10597,649,5.8
54047,7/1/19,4445,4035,410,9.2
54049,7/1/19,25672,24384,1288,5
54051,7/1/19,14571,13741,830,5.7
54053,7/1/19,9944,9331,613,6.2
54055,7/1/19,20795,19547,1248,6
54057,7/1/19,12885,12072,813,6.3
54059,7/1/19,6928,6437,491,7.1
54061,7/1/19,54332,52303,2029,3.7
54063,7/1/19,5921,5683,238,4
54065,7/1/19,8376,8059,317,3.8
54067,7/1/19,9573,9054,519,5.4
54069,7/1/19,21888,20976,912,4.2
54071,7/1/19,3710,3581,129,3.5
54073,7/1/19,2857,2688,169,5.9
54075,7/1/19,3909,3748,161,4.1
54077,7/1/19,15508,14819,689,4.4
54079,7/1/19,26941,25817,1124,4.2
54081,7/1/19,31068,29666,1402,4.5
54083,7/1/19,12536,11864,672,5.4
54085,7/1/19,4440,4235,205,4.6
54087,7/1/19,5096,4697,399,7.8
54089,7/1/19,4425,4213,212,4.8
54091,7/1/19,8014,7644,370,4.6
54093,7/1/19,3454,3287,167,4.8
54095,7/1/19,3093,2855,238,7.7
54097,7/1/19,9603,9045,558,5.8
54099,7/1/19,15930,15104,826,5.2
54101,7/1/19,3276,3095,181,5.5
54103,7/1/19,6596,6146,450,6.8
54105,7/1/19,2300,2136,164,7.1
54107,7/1/19,37169,35357,1812,4.9
54109,7/1/19,6749,6274,475,7
55001,7/1/19,8397,7976,421,5
55003,7/1/19,8421,7965,456,5.4
55005,7/1/19,24326,23498,828,3.4
55007,7/1/19,7965,7568,397,5
55009,7/1/19,143470,138450,5020,3.5
55011,7/1/19,6511,6241,270,4.1
55013,7/1/19,7458,7108,350,4.7
55015,7/1/19,28070,27203,867,3.1
55017,7/1/19,33077,31928,1149,3.5
55019,7/1/19,17802,17222,580,3.3
55021,7/1/19,32037,31017,1020,3.2
55023,7/1/19,7662,7380,282,3.7
55025,7/1/19,326762,318102,8660,2.7
55027,7/1/19,48528,47013,1515,3.1
55029,7/1/19,17240,16741,499,2.9
55031,7/1/19,23011,22022,989,4.3
55033,7/1/19,23282,22442,840,3.6
55035,7/1/19,59114,57062,2052,3.5
55037,7/1/19,2258,2137,121,5.4
55039,7/1/19,58289,56353,1936,3.3
55041,7/1/19,4089,3874,215,5.3
55043,7/1/19,27034,26169,865,3.2
55045,7/1/19,21345,20722,623,2.9
55047,7/1/19,9789,9409,380,3.9
55049,7/1/19,13913,13523,390,2.8
55051,7/1/19,2564,2403,161,6.3
55053,7/1/19,10404,10054,350,3.4
55055,7/1/19,46598,45077,1521,3.3
55057,7/1/19,13672,13226,446,3.3
55059,7/1/19,91488,87557,3931,4.3
55061,7/1/19,11144,10772,372,3.3
55063,7/1/19,65902,63797,2105,3.2
55065,7/1/19,10102,9826,276,2.7
55067,7/1/19,9341,8922,419,4.5
55069,7/1/19,15125,14528,597,3.9
55071,7/1/19,41330,39881,1449,3.5
55073,7/1/19,74468,72093,2375,3.2
55075,7/1/19,19688,18680,1008,5.1
55077,7/1/19,7744,7478,266,3.4
55078,7/1/19,1697,1519,178,10.5
55079,7/1/19,473882,451979,21903,4.6
55081,7/1/19,23815,23124,691,2.9
55083,7/1/19,20728,19992,736,3.6
55085,7/1/19,19031,18285,746,3.9
55087,7/1/19,105067,101588,3479,3.3
55089,7/1/19,49704,48073,1631,3.3
55091,7/1/19,4176,4037,139,3.3
55093,7/1/19,25654,24828,826,3.2
55095,7/1/19,24596,23795,801,3.3
55097,7/1/19,38192,36855,1337,3.5
55099,7/1/19,6607,6251,356,5.4
55101,7/1/19,100573,95945,4628,4.6
55103,7/1/19,9276,8994,282,3
55105,7/1/19,87131,83646,3485,4
55107,7/1/19,6611,6323,288,4.4
55109,7/1/19,50989,49403,1586,3.1
55111,7/1/19,37180,36109,1071,2.9
55113,7/1/19,8537,8161,376,4.4
55115,7/1/19,21372,20667,705,3.3
55117,7/1/19,64099,62206,1893,3
55119,7/1/19,11047,10677,370,3.3
55121,7/1/19,16002,15440,562,3.5
55123,7/1/19,15239,14777,462,3
55125,7/1/19,11210,10818,392,3.5
55127,7/1/19,58539,56485,2054,3.5
55129,7/1/19,8229,7912,317,3.9
55131,7/1/19,78016,75582,2434,3.1
55133,7/1/19,227514,220027,7487,3.3
55135,7/1/19,26295,25363,932,3.5
55137,7/1/19,11401,10919,482,4.2
55139,7/1/19,92662,89527,3135,3.4
55141,7/1/19,35609,34092,1517,4.3
56001,7/1/19,19294,18591,703,3.6
56003,7/1/19,5579,5355,224,4
56005,7/1/19,23326,22091,1235,5.3
56007,7/1/19,8568,8318,250,2.9
56009,7/1/19,8816,8584,232,2.6
56011,7/1/19,3918,3783,135,3.4
56013,7/1/19,18463,17667,796,4.3
56015,7/1/19,6676,6432,244,3.7
56017,7/1/19,2263,2189,74,3.3
56019,7/1/19,4418,4280,138,3.1
56021,7/1/19,49052,47398,1654,3.4
56023,7/1/19,9099,8819,280,3.1
56025,7/1/19,39751,38297,1454,3.7
56027,7/1/19,1286,1253,33,2.6
56029,7/1/19,17139,16588,551,3.2
56031,7/1/19,4715,4546,169,3.6
56033,7/1/19,15873,15354,519,3.3
56035,7/1/19,4341,4172,169,3.9
56037,7/1/19,20859,20054,805,3.9
56039,7/1/19,17904,17564,340,1.9
56041,7/1/19,9025,8669,356,3.9
56043,7/1/19,3975,3812,163,4.1
56045,7/1/19,3744,3635,109,2.9
72001,7/1/19,4098,3560,538,13.1
72003,7/1/19,11977,10856,1121,9.4
72005,7/1/19,14786,13258,1528,10.3
72007,7/1/19,6630,6043,587,8.9
72009,7/1/19,6554,5904,650,9.9
72011,7/1/19,8949,8206,743,8.3
72013,7/1/19,24416,22273,2143,8.8
72015,7/1/19,4630,4053,577,12.5
72017,7/1/19,5976,5343,633,10.6
72019,7/1/19,7510,6820,690,9.2
72021,7/1/19,66141,62099,4042,6.1
72023,7/1/19,13765,12555,1210,8.8
72025,7/1/19,48438,45222,3216,6.6
72027,7/1/19,9765,8935,830,8.5
72029,7/1/19,16261,15223,1038,6.4
72031,7/1/19,62280,58758,3522,5.7
72033,7/1/19,7915,7375,540,6.8
72035,7/1/19,16334,15209,1125,6.9
72037,7/1/19,3760,3386,374,9.9
72039,7/1/19,3791,3350,441,11.6
72041,7/1/19,15706,14668,1038,6.6
72043,7/1/19,10006,8844,1162,11.6
72045,7/1/19,4976,4531,445,8.9
72047,7/1/19,9121,8239,882,9.7
72049,7/1/19,910,880,30,3.3
72051,7/1/19,13334,12607,727,5.5
72053,7/1/19,11108,9960,1148,10.3
72054,7/1/19,3350,3014,336,10
72055,7/1/19,3976,3450,526,13.2
72057,7/1/19,11090,9785,1305,11.8
72059,7/1/19,5228,4611,617,11.8
72061,7/1/19,38049,36557,1492,3.9
72063,7/1/19,18347,17303,1044,5.7
72065,7/1/19,13511,12234,1277,9.5
72067,7/1/19,5496,5045,451,8.2
72069,7/1/19,17297,15708,1589,9.2
72071,7/1/19,12537,11383,1154,9.2
72073,7/1/19,4245,3676,569,13.4
72075,7/1/19,15280,13843,1437,9.4
72077,7/1/19,12437,11431,1006,8.1
72079,7/1/19,5282,4590,692,13.1
72081,7/1/19,6935,6044,891,12.8
72083,7/1/19,2651,2396,255,9.6
72085,7/1/19,11462,10446,1016,8.9
72087,7/1/19,8509,7902,607,7.1
72089,7/1/19,6232,5690,542,8.7
72091,7/1/19,11555,10693,862,7.5
72093,7/1/19,1916,1679,237,12.4
72095,7/1/19,2892,2544,348,12
72097,7/1/19,22394,20056,2338,10.4
72099,7/1/19,10641,9534,1107,10.4
72101,7/1/19,8109,7364,745,9.2
72103,7/1/19,8199,7527,672,8.2
72105,7/1/19,7210,6574,636,8.8
72107,7/1/19,5040,4510,530,10.5
72109,7/1/19,4242,3663,579,13.6
72111,7/1/19,5954,5193,761,12.8
72113,7/1/19,46321,42127,4194,9.1
72115,7/1/19,6179,5497,682,11
72117,7/1/19,4631,4168,463,10
72119,7/1/19,17098,15928,1170,6.8
72121,7/1/19,6242,5404,838,13.4
72123,7/1/19,7130,6185,945,13.3
72125,7/1/19,9834,8745,1089,11.1
72127,7/1/19,135485,128411,7074,5.2
72129,7/1/19,11860,10838,1022,8.6
72131,7/1/19,10252,9046,1206,11.8
72133,7/1/19,7901,7035,866,11
72135,7/1/19,27474,25948,1526,5.6
72137,7/1/19,29556,27927,1629,5.5
72139,7/1/19,27440,26120,1320,4.8
72141,7/1/19,6759,6014,745,11
72143,7/1/19,9861,9074,787,8
72145,7/1/19,13437,12188,1249,9.3
72147,7/1/19,2600,2448,152,5.8
72149,7/1/19,7421,6456,965,13
72151,7/1/19,8860,7797,1063,12
72153,7/1/19,9904,8641,1263,12.8
1001,8/1/19,26079,25368,711,2.7
1003,8/1/19,97939,95367,2572,2.6
1005,8/1/19,8652,8322,330,3.8
1007,8/1/19,8670,8403,267,3.1
1009,8/1/19,25309,24641,668,2.6
1011,8/1/19,4836,4653,183,3.8
1013,8/1/19,9324,8955,369,4
1015,8/1/19,46104,44535,1569,3.4
1017,8/1/19,15778,15320,458,2.9
1019,8/1/19,11589,11264,325,2.8
1021,8/1/19,19786,19257,529,2.7
1023,8/1/19,4486,4274,212,4.7
1025,8/1/19,7485,7021,464,6.2
1027,8/1/19,6094,5917,177,2.9
1029,8/1/19,5777,5612,165,2.9
1031,8/1/19,21369,20771,598,2.8
1033,8/1/19,23564,22700,864,3.7
1035,8/1/19,4556,4379,177,3.9
1037,8/1/19,4576,4441,135,3
1039,8/1/19,15594,15053,541,3.5
1041,8/1/19,6399,6226,173,2.7
1043,8/1/19,38204,37201,1003,2.6
1045,8/1/19,20705,20097,608,2.9
1047,8/1/19,14533,13695,838,5.8
1049,8/1/19,30999,30164,835,2.7
1051,8/1/19,37408,36447,961,2.6
1053,8/1/19,14766,14253,513,3.5
1055,8/1/19,42344,40926,1418,3.3
1057,8/1/19,6553,6345,208,3.2
1059,8/1/19,14749,14359,390,2.6
1061,8/1/19,11041,10724,317,2.9
1063,8/1/19,2886,2714,172,6
1065,8/1/19,6097,5859,238,3.9
1067,8/1/19,6933,6690,243,3.5
1069,8/1/19,46080,44705,1375,3
1071,8/1/19,23340,22602,738,3.2
1073,8/1/19,318116,308988,9128,2.9
1075,8/1/19,5852,5679,173,3
1077,8/1/19,42460,41082,1378,3.2
1079,8/1/19,14266,13829,437,3.1
1081,8/1/19,76167,74144,2023,2.7
1083,8/1/19,43708,42618,1090,2.5
1085,8/1/19,3574,3370,204,5.7
1087,8/1/19,7857,7521,336,4.3
1089,8/1/19,184603,180091,4512,2.4
1091,8/1/19,7627,7354,273,3.6
1093,8/1/19,12860,12414,446,3.5
1095,8/1/19,44246,43178,1068,2.4
1097,8/1/19,188145,181220,6925,3.7
1099,8/1/19,7314,6979,335,4.6
1101,8/1/19,105279,102052,3227,3.1
1103,8/1/19,58061,56583,1478,2.5
1105,8/1/19,3408,3209,199,5.8
1107,8/1/19,7888,7614,274,3.5
1109,8/1/19,15407,14900,507,3.3
1111,8/1/19,9685,9392,293,3
1113,8/1/19,23614,22921,693,2.9
1115,8/1/19,40453,39376,1077,2.7
1117,8/1/19,115691,113184,2507,2.2
1119,8/1/19,4829,4615,214,4.4
1121,8/1/19,35649,34411,1238,3.5
1123,8/1/19,19066,18526,540,2.8
1125,8/1/19,104331,101496,2835,2.7
1127,8/1/19,25334,24494,840,3.3
1129,8/1/19,6699,6389,310,4.6
1131,8/1/19,2710,2517,193,7.1
1133,8/1/19,10145,9810,335,3.3
2013,8/1/19,3552,3495,57,1.6
2016,8/1/19,3907,3803,104,2.7
2020,8/1/19,145090,138245,6845,4.7
2050,8/1/19,6899,5953,946,13.7
2060,8/1/19,576,555,21,3.6
2068,8/1/19,1677,1622,55,3.3
2070,8/1/19,2114,1967,147,7
2090,8/1/19,44963,42907,2056,4.6
2100,8/1/19,1385,1319,66,4.8
2105,8/1/19,1399,1315,84,6
2110,8/1/19,17769,17106,663,3.7
2122,8/1/19,27766,26303,1463,5.3
2130,8/1/19,7608,7259,349,4.6
2150,8/1/19,6328,6072,256,4
2158,8/1/19,2762,2263,499,18.1
2164,8/1/19,851,791,60,7.1
2170,8/1/19,45944,43196,2748,6
2180,8/1/19,3889,3478,411,10.6
2185,8/1/19,3356,3135,221,6.6
2188,8/1/19,2893,2495,398,13.8
2195,8/1/19,1551,1452,99,6.4
2198,8/1/19,2846,2606,240,8.4
2220,8/1/19,4970,4800,170,3.4
2230,8/1/19,1078,1050,28,2.6
2240,8/1/19,2845,2643,202,7.1
2261,8/1/19,6212,5951,261,4.2
2275,8/1/19,1009,947,62,6.1
2282,8/1/19,278,263,15,5.4
2290,8/1/19,2341,2061,280,12
4001,8/1/19,20762,18730,2032,9.8
4003,8/1/19,50007,47008,2999,6
4005,8/1/19,77493,73209,4284,5.5
4007,8/1/19,21659,20442,1217,5.6
4009,8/1/19,15094,14349,745,4.9
4011,8/1/19,4590,4402,188,4.1
4012,8/1/19,9084,8535,549,6
4013,8/1/19,2316171,2219376,96795,4.2
4015,8/1/19,88067,82946,5121,5.8
4017,8/1/19,41536,38582,2954,7.1
4019,8/1/19,496370,473292,23078,4.6
4021,8/1/19,187027,177447,9580,5.1
4023,8/1/19,19387,17222,2165,11.2
4025,8/1/19,107395,102442,4953,4.6
4027,8/1/19,101414,79668,21746,21.4
5001,8/1/19,9518,9259,259,2.7
5003,8/1/19,7735,7332,403,5.2
5005,8/1/19,16200,15546,654,4
5007,8/1/19,137711,133961,3750,2.7
5009,8/1/19,15812,15276,536,3.4
5011,8/1/19,4359,4181,178,4.1
5013,8/1/19,2428,2328,100,4.1
5015,8/1/19,13224,12855,369,2.8
5017,8/1/19,3296,3078,218,6.6
5019,8/1/19,9625,9217,408,4.2
5021,8/1/19,5756,5502,254,4.4
5023,8/1/19,9220,8815,405,4.4
5025,8/1/19,3218,3092,126,3.9
5027,8/1/19,8969,8534,435,4.9
5029,8/1/19,8351,7988,363,4.3
5031,8/1/19,55660,54063,1597,2.9
5033,8/1/19,27006,26047,959,3.6
5035,8/1/19,21685,20740,945,4.4
5037,8/1/19,7573,7263,310,4.1
5039,8/1/19,2856,2717,139,4.9
5041,8/1/19,5399,5160,239,4.4
5043,8/1/19,7681,7289,392,5.1
5045,8/1/19,62701,60760,1941,3.1
5047,8/1/19,7646,7367,279,3.6
5049,8/1/19,4874,4674,200,4.1
5051,8/1/19,41798,40210,1588,3.8
5053,8/1/19,8443,8163,280,3.3
5055,8/1/19,19960,19249,711,3.6
5057,8/1/19,9829,9437,392,4
5059,8/1/19,14150,13604,546,3.9
5061,8/1/19,5700,5516,184,3.2
5063,8/1/19,16059,15363,696,4.3
5065,8/1/19,4918,4658,260,5.3
5067,8/1/19,5860,5496,364,6.2
5069,8/1/19,27737,26183,1554,5.6
5071,8/1/19,9909,9418,491,5
5073,8/1/19,2405,2280,125,5.2
5075,8/1/19,6669,6366,303,4.5
5077,8/1/19,2863,2730,133,4.6
5079,8/1/19,3957,3779,178,4.5
5081,8/1/19,5506,5263,243,4.4
5083,8/1/19,8672,8269,403,4.6
5085,8/1/19,34586,33481,1105,3.2
5087,8/1/19,7472,7268,204,2.7
5089,8/1/19,6670,6408,262,3.9
5091,8/1/19,19696,18888,808,4.1
5093,8/1/19,17408,16481,927,5.3
5095,8/1/19,2759,2649,110,4
5097,8/1/19,2989,2849,140,4.7
5099,8/1/19,3610,3465,145,4
5101,8/1/19,3282,3173,109,3.3
5103,8/1/19,9727,9243,484,5
5105,8/1/19,4295,4117,178,4.1
5107,8/1/19,6282,5893,389,6.2
5109,8/1/19,4232,4062,170,4
5111,8/1/19,10295,9935,360,3.5
5113,8/1/19,8228,7873,355,4.3
5115,8/1/19,28329,27016,1313,4.6
5117,8/1/19,3620,3484,136,3.8
5119,8/1/19,191039,184361,6678,3.5
5121,8/1/19,7307,7032,275,3.8
5123,8/1/19,8298,7883,415,5
5125,8/1/19,59380,57636,1744,2.9
5127,8/1/19,4231,4085,146,3.5
5129,8/1/19,3016,2865,151,5
5131,8/1/19,56810,54863,1947,3.4
5133,8/1/19,5594,5305,289,5.2
5135,8/1/19,5530,5246,284,5.1
5137,8/1/19,4794,4604,190,4
5139,8/1/19,15785,14938,847,5.4
5141,8/1/19,5740,5456,284,4.9
5143,8/1/19,125489,122242,3247,2.6
5145,8/1/19,33680,32281,1399,4.2
5147,8/1/19,2806,2657,149,5.3
5149,8/1/19,8274,7927,347,4.2
6001,8/1/19,845763,819286,26477,3.1
6003,8/1/19,479,451,28,5.8
6005,8/1/19,15170,14615,555,3.7
6007,8/1/19,97641,92738,4903,5
6009,8/1/19,21950,21153,797,3.6
6011,8/1/19,11554,10634,920,8
6013,8/1/19,562586,544361,18225,3.2
6015,8/1/19,9804,9249,555,5.7
6017,8/1/19,92107,88842,3265,3.5
6019,8/1/19,452231,422720,29511,6.5
6021,8/1/19,12900,12128,772,6
6023,8/1/19,61749,59415,2334,3.8
6025,8/1/19,72360,56393,15967,22.1
6027,8/1/19,8906,8615,291,3.3
6029,8/1/19,397036,368204,28832,7.3
6031,8/1/19,57580,53591,3989,6.9
6033,8/1/19,29440,28108,1332,4.5
6035,8/1/19,9699,9289,410,4.2
6037,8/1/19,5112508,4868200,244308,4.8
6039,8/1/19,61847,57919,3928,6.4
6041,8/1/19,140893,137468,3425,2.4
6043,8/1/19,8070,7776,294,3.6
6045,8/1/19,39071,37630,1441,3.7
6047,8/1/19,115472,107200,8272,7.2
6049,8/1/19,3280,3102,178,5.4
6051,8/1/19,8613,8304,309,3.6
6053,8/1/19,229104,219517,9587,4.2
6055,8/1/19,75369,73364,2005,2.7
6057,8/1/19,48771,47160,1611,3.3
6059,8/1/19,1617548,1569467,48081,3
6061,8/1/19,188158,182133,6025,3.2
6063,8/1/19,8467,8003,464,5.5
6065,8/1/19,1101133,1050078,51055,4.6
6067,8/1/19,714027,686682,27345,3.8
6069,8/1/19,31477,30080,1397,4.4
6071,8/1/19,964440,925029,39411,4.1
6073,8/1/19,1590925,1537267,53658,3.4
6075,8/1/19,586744,573218,13526,2.3
6077,8/1/19,329199,310576,18623,5.7
6079,8/1/19,139474,135294,4180,3
6081,8/1/19,462827,452850,9977,2.2
6083,8/1/19,219011,211645,7366,3.4
6085,8/1/19,1058182,1030329,27853,2.6
6087,8/1/19,143841,138286,5555,3.9
6089,8/1/19,74708,71482,3226,4.3
6091,8/1/19,1336,1277,59,4.4
6093,8/1/19,17584,16645,939,5.3
6095,8/1/19,209103,201195,7908,3.8
6097,8/1/19,261694,254567,7127,2.7
6099,8/1/19,243873,229821,14052,5.8
6101,8/1/19,46915,44197,2718,5.8
6103,8/1/19,25613,24220,1393,5.4
6105,8/1/19,4920,4703,217,4.4
6107,8/1/19,205322,186504,18818,9.2
6109,8/1/19,21415,20517,898,4.2
6111,8/1/19,419649,403492,16157,3.9
6113,8/1/19,109174,105033,4141,3.8
6115,8/1/19,30227,28514,1713,5.7
8001,8/1/19,277748,270030,7718,2.8
8003,8/1/19,8536,8234,302,3.5
8005,8/1/19,372301,362499,9802,2.6
8007,8/1/19,7149,6940,209,2.9
8009,8/1/19,2107,2071,36,1.7
8011,8/1/19,1869,1814,55,2.9
8013,8/1/19,198688,194068,4620,2.3
8014,8/1/19,40912,39939,973,2.4
8015,8/1/19,10482,10257,225,2.1
8017,8/1/19,1120,1101,19,1.7
8019,8/1/19,6177,6024,153,2.5
8021,8/1/19,4058,3912,146,3.6
8023,8/1/19,1908,1844,64,3.4
8025,8/1/19,1521,1458,63,4.1
8027,8/1/19,2128,2065,63,3
8029,8/1/19,14556,14128,428,2.9
8031,8/1/19,425520,414428,11092,2.6
8033,8/1/19,1159,1128,31,2.7
8035,8/1/19,198266,193634,4632,2.3
8037,8/1/19,37415,36694,721,1.9
8039,8/1/19,15427,15103,324,2.1
8041,8/1/19,344716,333777,10939,3.2
8043,8/1/19,15541,14862,679,4.4
8045,8/1/19,33417,32630,787,2.4
8047,8/1/19,3855,3775,80,2.1
8049,8/1/19,10318,10131,187,1.8
8051,8/1/19,11943,11739,204,1.7
8053,8/1/19,548,529,19,3.5
8055,8/1/19,2539,2411,128,5
8057,8/1/19,1020,1001,19,1.9
8059,8/1/19,342155,333739,8416,2.5
8061,8/1/19,964,949,15,1.6
8063,8/1/19,4310,4236,74,1.7
8065,8/1/19,4918,4803,115,2.3
8067,8/1/19,32663,31945,718,2.2
8069,8/1/19,205936,201222,4714,2.3
8071,8/1/19,6569,6321,248,3.8
8073,8/1/19,2420,2367,53,2.2
8075,8/1/19,10895,10634,261,2.4
8077,8/1/19,76940,74563,2377,3.1
8079,8/1/19,535,525,10,1.9
8081,8/1/19,7374,7176,198,2.7
8083,8/1/19,13317,12885,432,3.2
8085,8/1/19,22020,21432,588,2.7
8087,8/1/19,16455,16004,451,2.7
8089,8/1/19,8443,8113,330,3.9
8091,8/1/19,2715,2651,64,2.4
8093,8/1/19,11388,11134,254,2.2
8095,8/1/19,2598,2553,45,1.7
8097,8/1/19,11530,11273,257,2.2
8099,8/1/19,6318,6162,156,2.5
8101,8/1/19,76049,73038,3011,4
8103,8/1/19,3015,2916,99,3.3
8105,8/1/19,5499,5277,222,4
8107,8/1/19,16649,16329,320,1.9
8109,8/1/19,3545,3390,155,4.4
8111,8/1/19,722,709,13,1.8
8113,8/1/19,6082,5973,109,1.8
8115,8/1/19,1200,1177,23,1.9
8117,8/1/19,22143,21746,397,1.8
8119,8/1/19,12919,12537,382,3
8121,8/1/19,2914,2853,61,2.1
8123,8/1/19,170331,166080,4251,2.5
8125,8/1/19,5786,5690,96,1.7
9001,8/1/19,485911,467958,17953,3.7
9003,8/1/19,483938,464275,19663,4.1
9005,8/1/19,106273,102798,3475,3.3
9007,8/1/19,93888,90906,2982,3.2
9009,8/1/19,463991,445328,18663,4
9011,8/1/19,139892,134955,4937,3.5
9013,8/1/19,87017,84160,2857,3.3
9015,8/1/19,64906,62325,2581,4
10001,8/1/19,78973,75120,3853,4.9
10003,8/1/19,298079,285618,12461,4.2
10005,8/1/19,113772,109852,3920,3.4
11001,8/1/19,407817,385399,22418,5.5
12001,8/1/19,136698,132426,4272,3.1
12003,8/1/19,11947,11567,380,3.2
12005,8/1/19,85531,82517,3014,3.5
12007,8/1/19,11209,10828,381,3.4
12009,8/1/19,287115,277577,9538,3.3
12011,8/1/19,1046333,1013004,33329,3.2
12013,8/1/19,4788,4581,207,4.3
12015,8/1/19,71267,68448,2819,4
12017,8/1/19,47414,44998,2416,5.1
12019,8/1/19,108673,105250,3423,3.1
12021,8/1/19,175558,169095,6463,3.7
12023,8/1/19,30027,29010,1017,3.4
12027,8/1/19,13942,13423,519,3.7
12029,8/1/19,5759,5511,248,4.3
12031,8/1/19,496472,479295,17177,3.5
12033,8/1/19,147229,142353,4876,3.3
12035,8/1/19,47249,45355,1894,4
12037,8/1/19,4740,4574,166,3.5
12039,8/1/19,18575,17748,827,4.5
12041,8/1/19,7019,6766,253,3.6
12043,8/1/19,5101,4864,237,4.6
12045,8/1/19,5851,5595,256,4.4
12047,8/1/19,4349,4171,178,4.1
12049,8/1/19,8404,7924,480,5.7
12051,8/1/19,15090,13863,1227,8.1
12053,8/1/19,72297,69133,3164,4.4
12055,8/1/19,35498,33718,1780,5
12057,8/1/19,751947,727331,24616,3.3
12059,8/1/19,6854,6605,249,3.6
12061,8/1/19,65198,62404,2794,4.3
12063,8/1/19,17078,16451,627,3.7
12065,8/1/19,5538,5345,193,3.5
12067,8/1/19,2815,2725,90,3.2
12069,8/1/19,160205,154819,5386,3.4
12071,8/1/19,344870,333213,11657,3.4
12073,8/1/19,153392,148326,5066,3.3
12075,8/1/19,16643,15995,648,3.9
12077,8/1/19,2606,2516,90,3.5
12079,8/1/19,7539,7244,295,3.9
12081,8/1/19,178333,172279,6054,3.4
12083,8/1/19,137952,132347,5605,4.1
12085,8/1/19,74133,71626,2507,3.4
12086,8/1/19,1377292,1341959,35333,2.6
12087,8/1/19,46583,45583,1000,2.1
12089,8/1/19,41557,40269,1288,3.1
12091,8/1/19,99066,96369,2697,2.7
12093,8/1/19,17837,17154,683,3.8
12095,8/1/19,769175,745574,23601,3.1
12097,8/1/19,185995,179531,6464,3.5
12099,8/1/19,733517,707017,26500,3.6
12101,8/1/19,239031,230286,8745,3.7
12103,8/1/19,496511,481009,15502,3.1
12105,8/1/19,308001,295822,12179,4
12107,8/1/19,26633,25423,1210,4.5
12109,8/1/19,133356,129699,3657,2.7
12111,8/1/19,145459,139291,6168,4.2
12113,8/1/19,83686,81123,2563,3.1
12115,8/1/19,187494,181287,6207,3.3
12117,8/1/19,257440,249660,7780,3
12119,8/1/19,32764,31145,1619,4.9
12121,8/1/19,18139,17452,687,3.8
12123,8/1/19,8299,7977,322,3.9
12125,8/1/19,4588,4446,142,3.1
12127,8/1/19,255193,246097,9096,3.6
12129,8/1/19,14721,14273,448,3
12131,8/1/19,32213,31294,919,2.9
12133,8/1/19,9803,9474,329,3.4
13001,8/1/19,9698,9294,404,4.2
13003,8/1/19,4696,4568,128,2.7
13005,8/1/19,4990,4810,180,3.6
13007,8/1/19,1180,1123,57,4.8
13009,8/1/19,17375,16613,762,4.4
13011,8/1/19,9612,9338,274,2.9
13013,8/1/19,40210,39005,1205,3
13015,8/1/19,50363,48612,1751,3.5
13017,8/1/19,5396,5098,298,5.5
13019,8/1/19,7425,7130,295,4
13021,8/1/19,67576,64667,2909,4.3
13023,8/1/19,4470,4236,234,5.2
13025,8/1/19,7441,7119,322,4.3
13027,8/1/19,6977,6725,252,3.6
13029,8/1/19,18270,17680,590,3.2
13031,8/1/19,36586,35137,1449,4
13033,8/1/19,9125,8631,494,5.4
13035,8/1/19,10686,10315,371,3.5
13037,8/1/19,2279,2193,86,3.8
13039,8/1/19,20841,20031,810,3.9
13043,8/1/19,5614,5446,168,3
13045,8/1/19,55114,53131,1983,3.6
13047,8/1/19,33415,32356,1059,3.2
13049,8/1/19,4829,4619,210,4.3
13051,8/1/19,139499,134404,5095,3.7
13053,8/1/19,1977,1883,94,4.8
13055,8/1/19,10138,9734,404,4
13057,8/1/19,135478,131540,3938,2.9
13059,8/1/19,58443,56184,2259,3.9
13061,8/1/19,922,852,70,7.6
13063,8/1/19,137369,131072,6297,4.6
13065,8/1/19,2531,2416,115,4.5
13067,8/1/19,424024,410532,13492,3.2
13069,8/1/19,18706,18025,681,3.6
13071,8/1/19,21503,20789,714,3.3
13073,8/1/19,74812,72346,2466,3.3
13075,8/1/19,8032,7741,291,3.6
13077,8/1/19,74257,71982,2275,3.1
13079,8/1/19,5585,5373,212,3.8
13081,8/1/19,9393,9011,382,4.1
13083,8/1/19,8296,7993,303,3.7
13085,8/1/19,12342,11972,370,3
13087,8/1/19,11513,11037,476,4.1
13089,8/1/19,398021,383397,14624,3.7
13091,8/1/19,7092,6649,443,6.2
13093,8/1/19,5139,4936,203,4
13095,8/1/19,38207,36279,1928,5
13097,8/1/19,72991,70244,2747,3.8
13099,8/1/19,4429,4252,177,4
13101,8/1/19,1925,1871,54,2.8
13103,8/1/19,30768,29823,945,3.1
13105,8/1/19,7673,7363,310,4
13107,8/1/19,8276,7814,462,5.6
13109,8/1/19,4960,4784,176,3.5
13111,8/1/19,11506,11096,410,3.6
13113,8/1/19,57748,55893,1855,3.2
13115,8/1/19,43744,42062,1682,3.8
13117,8/1/19,121741,118129,3612,3
13119,8/1/19,9879,9514,365,3.7
13121,8/1/19,555437,534594,20843,3.8
13123,8/1/19,11950,11500,450,3.8
13125,8/1/19,1282,1227,55,4.3
13127,8/1/19,39833,38446,1387,3.5
13129,8/1/19,28071,27109,962,3.4
13131,8/1/19,10429,10020,409,3.9
13133,8/1/19,7063,6786,277,3.9
13135,8/1/19,488676,472828,15848,3.2
13137,8/1/19,18938,18294,644,3.4
13139,8/1/19,101937,98931,3006,2.9
13141,8/1/19,2453,2323,130,5.3
13143,8/1/19,12561,12102,459,3.7
13145,8/1/19,16505,15967,538,3.3
13147,8/1/19,11023,10607,416,3.8
13149,8/1/19,5250,5056,194,3.7
13151,8/1/19,114851,110473,4378,3.8
13153,8/1/19,70030,67517,2513,3.6
13155,8/1/19,3370,3215,155,4.6
13157,8/1/19,36221,35203,1018,2.8
13159,8/1/19,6933,6715,218,3.1
13161,8/1/19,6055,5739,316,5.2
13163,8/1/19,6622,6312,310,4.7
13165,8/1/19,3147,2983,164,5.2
13167,8/1/19,3979,3821,158,4
13169,8/1/19,13641,13179,462,3.4
13171,8/1/19,8231,7893,338,4.1
13173,8/1/19,3744,3590,154,4.1
13175,8/1/19,18883,17908,975,5.2
13177,8/1/19,14667,14190,477,3.3
13179,8/1/19,26110,25018,1092,4.2
13181,8/1/19,3557,3412,145,4.1
13183,8/1/19,8195,7862,333,4.1
13185,8/1/19,50914,48943,1971,3.9
13187,8/1/19,16738,16191,547,3.3
13189,8/1/19,8812,8326,486,5.5
13191,8/1/19,6273,6033,240,3.8
13193,8/1/19,4714,4484,230,4.9
13195,8/1/19,13191,12751,440,3.3
13197,8/1/19,3290,3142,148,4.5
13199,8/1/19,8932,8504,428,4.8
13201,8/1/19,2794,2691,103,3.7
13205,8/1/19,8567,8146,421,4.9
13207,8/1/19,12989,12524,465,3.6
13209,8/1/19,3831,3613,218,5.7
13211,8/1/19,9301,8986,315,3.4
13213,8/1/19,15400,14650,750,4.9
13215,8/1/19,76723,72983,3740,4.9
13217,8/1/19,52067,49903,2164,4.2
13219,8/1/19,19358,18824,534,2.8
13221,8/1/19,6875,6642,233,3.4
13223,8/1/19,85554,82855,2699,3.2
13225,8/1/19,11839,11338,501,4.2
13227,8/1/19,15227,14730,497,3.3
13229,8/1/19,8756,8444,312,3.6
13231,8/1/19,8905,8614,291,3.3
13233,8/1/19,18344,17657,687,3.7
13235,8/1/19,4067,3901,166,4.1
13237,8/1/19,8216,7855,361,4.4
13239,8/1/19,804,762,42,5.2
13241,8/1/19,7327,7072,255,3.5
13243,8/1/19,2502,2374,128,5.1
13245,8/1/19,84543,80392,4151,4.9
13247,8/1/19,44625,42821,1804,4
13249,8/1/19,2211,2119,92,4.2
13251,8/1/19,5085,4833,252,5
13253,8/1/19,3098,2950,148,4.8
13255,8/1/19,28599,27387,1212,4.2
13257,8/1/19,10684,10263,421,3.9
13259,8/1/19,2415,2308,107,4.4
13261,8/1/19,12710,12079,631,5
13263,8/1/19,2810,2680,130,4.6
13265,8/1/19,568,543,25,4.4
13267,8/1/19,9699,9326,373,3.8
13269,8/1/19,3246,3115,131,4
13271,8/1/19,4043,3569,474,11.7
13273,8/1/19,3491,3321,170,4.9
13275,8/1/19,16428,15694,734,4.5
13277,8/1/19,19887,19182,705,3.5
13279,8/1/19,11728,11124,604,5.2
13281,8/1/19,3975,3775,200,5
13283,8/1/19,2600,2439,161,6.2
13285,8/1/19,37424,36152,1272,3.4
13287,8/1/19,3142,3021,121,3.9
13289,8/1/19,2855,2687,168,5.9
13291,8/1/19,10229,9889,340,3.3
13293,8/1/19,11324,10906,418,3.7
13295,8/1/19,31182,30111,1071,3.4
13297,8/1/19,45857,44326,1531,3.3
13299,8/1/19,15604,15021,583,3.7
13301,8/1/19,2813,2689,124,4.4
13303,8/1/19,6977,6674,303,4.3
13305,8/1/19,11404,10900,504,4.4
13307,8/1/19,998,944,54,5.4
13309,8/1/19,1620,1484,136,8.4
13311,8/1/19,16208,15767,441,2.7
13313,8/1/19,43204,41362,1842,4.3
13315,8/1/19,2681,2550,131,4.9
13317,8/1/19,3863,3689,174,4.5
13319,8/1/19,4043,3879,164,4.1
13321,8/1/19,8898,8534,364,4.1
15001,8/1/19,90556,87463,3093,3.4
15003,8/1/19,448845,437255,11590,2.6
15007,8/1/19,36821,35876,945,2.6
15009,8/1/19,87484,85291,2193,2.5
16001,8/1/19,255752,249776,5976,2.3
16003,8/1/19,1805,1718,87,4.8
16005,8/1/19,41837,40793,1044,2.5
16007,8/1/19,3081,3017,64,2.1
16009,8/1/19,4204,4040,164,3.9
16011,8/1/19,24006,23402,604,2.5
16013,8/1/19,12816,12567,249,1.9
16015,8/1/19,3522,3394,128,3.6
16017,8/1/19,20556,19895,661,3.2
16019,8/1/19,57439,56249,1190,2.1
16021,8/1/19,5524,5342,182,3.3
16023,8/1/19,1419,1389,30,2.1
16025,8/1/19,719,703,16,2.2
16027,8/1/19,105699,102618,3081,2.9
16029,8/1/19,4227,4133,94,2.2
16031,8/1/19,12410,12146,264,2.1
16033,8/1/19,392,378,14,3.6
16035,8/1/19,2969,2821,148,5
16037,8/1/19,2567,2496,71,2.8
16039,8/1/19,11905,11558,347,2.9
16041,8/1/19,6789,6663,126,1.9
16043,8/1/19,7348,7223,125,1.7
16045,8/1/19,8377,8133,244,2.9
16047,8/1/19,8326,8139,187,2.2
16049,8/1/19,6819,6568,251,3.7
16051,8/1/19,14223,13933,290,2
16053,8/1/19,12206,11948,258,2.1
16055,8/1/19,81725,79406,2319,2.8
16057,8/1/19,19907,19467,440,2.2
16059,8/1/19,3849,3712,137,3.6
16061,8/1/19,1746,1655,91,5.2
16063,8/1/19,2783,2717,66,2.4
16065,8/1/19,20391,20076,315,1.5
16067,8/1/19,11575,11313,262,2.3
16069,8/1/19,20988,20468,520,2.5
16071,8/1/19,2334,2298,36,1.5
16073,8/1/19,5729,5576,153,2.7
16075,8/1/19,11771,11356,415,3.5
16077,8/1/19,4122,4008,114,2.8
16079,8/1/19,5153,4911,242,4.7
16081,8/1/19,7429,7324,105,1.4
16083,8/1/19,41525,40510,1015,2.4
16085,8/1/19,6022,5872,150,2.5
16087,8/1/19,4680,4497,183,3.9
17001,8/1/19,32172,31088,1084,3.4
17003,8/1/19,2020,1890,130,6.4
17005,8/1/19,7868,7566,302,3.8
17007,8/1/19,26364,24927,1437,5.5
17009,8/1/19,3034,2959,75,2.5
17011,8/1/19,17525,16783,742,4.2
17013,8/1/19,2330,2232,98,4.2
17015,8/1/19,7454,7182,272,3.6
17017,8/1/19,6134,5900,234,3.8
17019,8/1/19,103297,99268,4029,3.9
17021,8/1/19,14731,14030,701,4.8
17023,8/1/19,7675,7349,326,4.2
17025,8/1/19,6507,6207,300,4.6
17027,8/1/19,20547,19946,601,2.9
17029,8/1/19,22867,21931,936,4.1
17031,8/1/19,2610328,2506421,103907,4
17033,8/1/19,8621,8253,368,4.3
17035,8/1/19,6058,5873,185,3.1
17037,8/1/19,55302,53115,2187,4
17039,8/1/19,7412,7108,304,4.1
17041,8/1/19,10132,9750,382,3.8
17043,8/1/19,510111,494992,15119,3
17045,8/1/19,8980,8609,371,4.1
17047,8/1/19,2705,2598,107,4
17049,8/1/19,19376,18781,595,3.1
17051,8/1/19,9908,9497,411,4.1
17053,8/1/19,6236,5965,271,4.3
17055,8/1/19,16335,15428,907,5.6
17057,8/1/19,15278,14469,809,5.3
17059,8/1/19,2330,2210,120,5.2
17061,8/1/19,6094,5822,272,4.5
17063,8/1/19,25484,24436,1048,4.1
17065,8/1/19,4306,4140,166,3.9
17067,8/1/19,8451,8041,410,4.9
17069,8/1/19,1308,1221,87,6.7
17071,8/1/19,3697,3512,185,5
17073,8/1/19,25379,24267,1112,4.4
17075,8/1/19,14480,13916,564,3.9
17077,8/1/19,27525,26467,1058,3.8
17079,8/1/19,4745,4558,187,3.9
17081,8/1/19,17374,16546,828,4.8
17083,8/1/19,11019,10550,469,4.3
17085,8/1/19,11018,10642,376,3.4
17087,8/1/19,4003,3774,229,5.7
17089,8/1/19,273033,261881,11152,4.1
17091,8/1/19,55978,53415,2563,4.6
17093,8/1/19,68900,66710,2190,3.2
17095,8/1/19,22069,21037,1032,4.7
17097,8/1/19,379473,365218,14255,3.8
17099,8/1/19,54734,52090,2644,4.8
17101,8/1/19,5846,5542,304,5.2
17103,8/1/19,17754,17075,679,3.8
17105,8/1/19,16867,16236,631,3.7
17107,8/1/19,12684,12124,560,4.4
17109,8/1/19,12747,12138,609,4.8
17111,8/1/19,166043,160824,5219,3.1
17113,8/1/19,87382,84057,3325,3.8
17115,8/1/19,49107,46445,2662,5.4
17117,8/1/19,23106,22171,935,4
17119,8/1/19,134904,129524,5380,4
17121,8/1/19,17536,16734,802,4.6
17123,8/1/19,5399,5167,232,4.3
17125,8/1/19,6441,6105,336,5.2
17127,8/1/19,5673,5356,317,5.6
17129,8/1/19,6624,6407,217,3.3
17131,8/1/19,8210,7858,352,4.3
17133,8/1/19,18896,18303,593,3.1
17135,8/1/19,11804,11238,566,4.8
17137,8/1/19,16664,16003,661,4
17139,8/1/19,7710,7449,261,3.4
17141,8/1/19,25061,23955,1106,4.4
17143,8/1/19,86041,81654,4387,5.1
17145,8/1/19,8291,7870,421,5.1
17147,8/1/19,8221,7926,295,3.6
17149,8/1/19,7109,6838,271,3.8
17151,8/1/19,1670,1577,93,5.6
17153,8/1/19,1995,1866,129,6.5
17155,8/1/19,3045,2916,129,4.2
17157,8/1/19,14599,14113,486,3.3
17159,8/1/19,7247,6949,298,4.1
17161,8/1/19,72268,68855,3413,4.7
17163,8/1/19,127427,121468,5959,4.7
17165,8/1/19,9609,9085,524,5.5
17167,8/1/19,103213,99071,4142,4
17169,8/1/19,3314,3174,140,4.2
17171,8/1/19,2571,2460,111,4.3
17173,8/1/19,10751,10353,398,3.7
17175,8/1/19,2585,2448,137,5.3
17177,8/1/19,21993,21031,962,4.4
17179,8/1/19,64633,61847,2786,4.3
17181,8/1/19,7385,7016,369,5
17183,8/1/19,33052,31224,1828,5.5
17185,8/1/19,5871,5637,234,4
17187,8/1/19,8392,8062,330,3.9
17189,8/1/19,10293,10054,239,2.3
17191,8/1/19,7004,6667,337,4.8
17193,8/1/19,6626,6364,262,4
17195,8/1/19,28873,27657,1216,4.2
17197,8/1/19,358689,345294,13395,3.7
17199,8/1/19,31516,30116,1400,4.4
17201,8/1/19,140805,132318,8487,6
17203,8/1/19,19036,18330,706,3.7
18001,8/1/19,17361,16862,499,2.9
18003,8/1/19,187094,181136,5958,3.2
18005,8/1/19,45408,44281,1127,2.5
18007,8/1/19,4460,4317,143,3.2
18009,8/1/19,4937,4748,189,3.8
18011,8/1/19,36768,35821,947,2.6
18013,8/1/19,7814,7590,224,2.9
18015,8/1/19,10004,9703,301,3
18017,8/1/19,17872,17296,576,3.2
18019,8/1/19,62066,59944,2122,3.4
18021,8/1/19,12081,11600,481,4
18023,8/1/19,17239,16765,474,2.7
18025,8/1/19,4942,4751,191,3.9
18027,8/1/19,16876,16428,448,2.7
18029,8/1/19,26014,25069,945,3.6
18031,8/1/19,15132,14705,427,2.8
18033,8/1/19,22789,22138,651,2.9
18035,8/1/19,52654,50498,2156,4.1
18037,8/1/19,23218,22644,574,2.5
18039,8/1/19,112661,109048,3613,3.2
18041,8/1/19,8716,8265,451,5.2
18043,8/1/19,41867,40546,1321,3.2
18045,8/1/19,8092,7816,276,3.4
18047,8/1/19,11535,11143,392,3.4
18049,8/1/19,10009,9701,308,3.1
18051,8/1/19,19579,19086,493,2.5
18053,8/1/19,30899,29686,1213,3.9
18055,8/1/19,13526,12985,541,4
18057,8/1/19,186198,181273,4925,2.6
18059,8/1/19,40794,39599,1195,2.9
18061,8/1/19,20418,19767,651,3.2
18063,8/1/19,91126,88561,2565,2.8
18065,8/1/19,22366,21656,710,3.2
18067,8/1/19,37037,35670,1367,3.7
18069,8/1/19,18481,17905,576,3.1
18071,8/1/19,23098,22459,639,2.8
18073,8/1/19,16386,15824,562,3.4
18075,8/1/19,9603,9316,287,3
18077,8/1/19,14930,14395,535,3.6
18079,8/1/19,13667,13254,413,3
18081,8/1/19,84017,81692,2325,2.8
18083,8/1/19,18498,17889,609,3.3
18085,8/1/19,42477,41254,1223,2.9
18087,8/1/19,20035,19449,586,2.9
18089,8/1/19,231891,221144,10747,4.6
18091,8/1/19,47782,45852,1930,4
18093,8/1/19,21074,20339,735,3.5
18095,8/1/19,59797,57662,2135,3.6
18097,8/1/19,497018,480268,16750,3.4
18099,8/1/19,23248,22520,728,3.1
18101,8/1/19,5434,5284,150,2.8
18103,8/1/19,15467,14886,581,3.8
18105,8/1/19,67477,64931,2546,3.8
18107,8/1/19,18918,18306,612,3.2
18109,8/1/19,36808,35676,1132,3.1
18111,8/1/19,7027,6752,275,3.9
18113,8/1/19,23881,23130,751,3.1
18115,8/1/19,3204,3097,107,3.3
18117,8/1/19,8661,8357,304,3.5
18119,8/1/19,9026,8652,374,4.1
18121,8/1/19,7267,6980,287,3.9
18123,8/1/19,9386,9087,299,3.2
18125,8/1/19,6208,6009,199,3.2
18127,8/1/19,87562,84334,3228,3.7
18129,8/1/19,13641,13249,392,2.9
18131,8/1/19,6554,6358,196,3
18133,8/1/19,17065,16402,663,3.9
18135,8/1/19,11235,10815,420,3.7
18137,8/1/19,14263,13799,464,3.3
18139,8/1/19,9102,8857,245,2.7
18141,8/1/19,134613,129485,5128,3.8
18143,8/1/19,10620,10237,383,3.6
18145,8/1/19,23470,22761,709,3
18147,8/1/19,11065,10734,331,3
18149,8/1/19,9969,9549,420,4.2
18151,8/1/19,21038,20466,572,2.7
18153,8/1/19,8342,8011,331,4
18155,8/1/19,5049,4881,168,3.3
18157,8/1/19,96497,93372,3125,3.2
18159,8/1/19,9386,9139,247,2.6
18161,8/1/19,3580,3463,117,3.3
18163,8/1/19,94563,91566,2997,3.2
18165,8/1/19,6963,6622,341,4.9
18167,8/1/19,48075,46023,2052,4.3
18169,8/1/19,14784,14317,467,3.2
18171,8/1/19,4242,4106,136,3.2
18173,8/1/19,33072,32099,973,2.9
18175,8/1/19,13802,13344,458,3.3
18177,8/1/19,30611,29481,1130,3.7
18179,8/1/19,14513,14137,376,2.6
18181,8/1/19,13606,13247,359,2.6
18183,8/1/19,17891,17366,525,2.9
19001,8/1/19,4319,4230,89,2.1
19003,8/1/19,2228,2197,31,1.4
19005,8/1/19,7398,7200,198,2.7
19007,8/1/19,6063,5814,249,4.1
19009,8/1/19,3168,3092,76,2.4
19011,8/1/19,13835,13437,398,2.9
19013,8/1/19,70330,67465,2865,4.1
19015,8/1/19,14976,14635,341,2.3
19017,8/1/19,14008,13660,348,2.5
19019,8/1/19,11592,11286,306,2.6
19021,8/1/19,11541,11265,276,2.4
19023,8/1/19,7953,7722,231,2.9
19025,8/1/19,4255,4158,97,2.3
19027,8/1/19,11256,11039,217,1.9
19029,8/1/19,6962,6787,175,2.5
19031,8/1/19,10916,10662,254,2.3
19033,8/1/19,24107,23454,653,2.7
19035,8/1/19,6281,6117,164,2.6
19037,8/1/19,6527,6351,176,2.7
19039,8/1/19,5008,4886,122,2.4
19041,8/1/19,8592,8385,207,2.4
19043,8/1/19,10351,10103,248,2.4
19045,8/1/19,23451,22502,949,4
19047,8/1/19,8244,7982,262,3.2
19049,8/1/19,51218,50213,1005,2
19051,8/1/19,4249,4090,159,3.7
19053,8/1/19,4300,4200,100,2.3
19055,8/1/19,10734,10491,243,2.3
19057,8/1/19,19943,19051,892,4.5
19059,8/1/19,11303,11074,229,2
19061,8/1/19,57018,55528,1490,2.6
19063,8/1/19,5338,5218,120,2.2
19065,8/1/19,10160,9814,346,3.4
19067,8/1/19,9217,8837,380,4.1
19069,8/1/19,5760,5637,123,2.1
19071,8/1/19,3763,3652,111,2.9
19073,8/1/19,5428,5297,131,2.4
19075,8/1/19,6556,6385,171,2.6
19077,8/1/19,5752,5604,148,2.6
19079,8/1/19,6937,6753,184,2.7
19081,8/1/19,6067,5916,151,2.5
19083,8/1/19,8162,7919,243,3
19085,8/1/19,7543,7375,168,2.2
19087,8/1/19,9804,9509,295,3
19089,8/1/19,5231,5114,117,2.2
19091,8/1/19,5160,5040,120,2.3
19093,8/1/19,4129,4062,67,1.6
19095,8/1/19,10674,10484,190,1.8
19097,8/1/19,11197,10871,326,2.9
19099,8/1/19,20118,19560,558,2.8
19101,8/1/19,10037,9755,282,2.8
19103,8/1/19,89125,87201,1924,2.2
19105,8/1/19,10875,10601,274,2.5
19107,8/1/19,5307,5139,168,3.2
19109,8/1/19,8496,8307,189,2.2
19111,8/1/19,16373,15553,820,5
19113,8/1/19,125510,121702,3808,3
19115,8/1/19,6229,6022,207,3.3
19117,8/1/19,4693,4590,103,2.2
19119,8/1/19,7195,7103,92,1.3
19121,8/1/19,8806,8536,270,3.1
19123,8/1/19,11961,11640,321,2.7
19125,8/1/19,18630,18254,376,2
19127,8/1/19,18191,17546,645,3.5
19129,8/1/19,7593,7420,173,2.3
19131,8/1/19,7483,7372,111,1.5
19133,8/1/19,4486,4352,134,3
19135,8/1/19,4121,3988,133,3.2
19137,8/1/19,5044,4911,133,2.6
19139,8/1/19,22530,21917,613,2.7
19141,8/1/19,8346,8179,167,2
19143,8/1/19,3593,3526,67,1.9
19145,8/1/19,6423,6252,171,2.7
19147,8/1/19,4805,4705,100,2.1
19149,8/1/19,15151,14783,368,2.4
19151,8/1/19,4722,4632,90,1.9
19153,8/1/19,278272,270548,7724,2.8
19155,8/1/19,49927,48725,1202,2.4
19157,8/1/19,10107,9875,232,2.3
19159,8/1/19,2505,2440,65,2.6
19161,8/1/19,5299,5188,111,2.1
19163,8/1/19,92700,89506,3194,3.4
19165,8/1/19,6886,6744,142,2.1
19167,8/1/19,20806,20465,341,1.6
19169,8/1/19,55961,54781,1180,2.1
19171,8/1/19,9561,9316,245,2.6
19173,8/1/19,3221,3159,62,1.9
19175,8/1/19,6351,6148,203,3.2
19177,8/1/19,3768,3664,104,2.8
19179,8/1/19,18101,17323,778,4.3
19181,8/1/19,29230,28532,698,2.4
19183,8/1/19,12324,12050,274,2.2
19185,8/1/19,2799,2726,73,2.6
19187,8/1/19,20062,19364,698,3.5
19189,8/1/19,5276,5126,150,2.8
19191,8/1/19,11483,11209,274,2.4
19193,8/1/19,56937,55422,1515,2.7
19195,8/1/19,4337,4242,95,2.2
19197,8/1/19,7247,7060,187,2.6
20001,8/1/19,6139,5891,248,4
20003,8/1/19,4217,4075,142,3.4
20005,8/1/19,7006,6601,405,5.8
20007,8/1/19,2330,2262,68,2.9
20009,8/1/19,13507,13058,449,3.3
20011,8/1/19,6523,6238,285,4.4
20013,8/1/19,5358,5181,177,3.3
20015,8/1/19,32530,31391,1139,3.5
20017,8/1/19,1522,1478,44,2.9
20019,8/1/19,1413,1350,63,4.5
20021,8/1/19,10082,9722,360,3.6
20023,8/1/19,1310,1275,35,2.7
20025,8/1/19,1090,1062,28,2.6
20027,8/1/19,3755,3627,128,3.4
20029,8/1/19,3768,3632,136,3.6
20031,8/1/19,3817,3634,183,4.8
20033,8/1/19,869,839,30,3.5
20035,8/1/19,16150,15552,598,3.7
20037,8/1/19,18476,17707,769,4.2
20039,8/1/19,1290,1243,47,3.6
20041,8/1/19,8736,8423,313,3.6
20043,8/1/19,4162,4020,142,3.4
20045,8/1/19,64895,62822,2073,3.2
20047,8/1/19,1459,1424,35,2.4
20049,8/1/19,1091,1044,47,4.3
20051,8/1/19,16554,16140,414,2.5
20053,8/1/19,2737,2641,96,3.5
20055,8/1/19,20273,19763,510,2.5
20057,8/1/19,17549,17096,453,2.6
20059,8/1/19,13832,13371,461,3.3
20061,8/1/19,11008,10485,523,4.8
20063,8/1/19,1495,1460,35,2.3
20065,8/1/19,1148,1111,37,3.2
20067,8/1/19,3253,3153,100,3.1
20069,8/1/19,3177,3104,73,2.3
20071,8/1/19,802,778,24,3
20073,8/1/19,3173,3058,115,3.6
20075,8/1/19,1656,1621,35,2.1
20077,8/1/19,2824,2742,82,2.9
20079,8/1/19,17025,16489,536,3.1
20081,8/1/19,2248,2196,52,2.3
20083,8/1/19,1031,1007,24,2.3
20085,8/1/19,7233,7011,222,3.1
20087,8/1/19,10172,9868,304,3
20089,8/1/19,1315,1278,37,2.8
20091,8/1/19,340500,330335,10165,3
20093,8/1/19,2034,1978,56,2.8
20095,8/1/19,3483,3369,114,3.3
20097,8/1/19,1270,1237,33,2.6
20099,8/1/19,9882,9487,395,4
20101,8/1/19,782,756,26,3.3
20103,8/1/19,36668,35352,1316,3.6
20105,8/1/19,1637,1597,40,2.4
20107,8/1/19,4474,4212,262,5.9
20109,8/1/19,1517,1480,37,2.4
20111,8/1/19,16470,15890,580,3.5
20113,8/1/19,17342,16907,435,2.5
20115,8/1/19,5865,5680,185,3.2
20117,8/1/19,5540,5386,154,2.8
20119,8/1/19,2188,2132,56,2.6
20121,8/1/19,17530,16959,571,3.3
20123,8/1/19,3379,3292,87,2.6
20125,8/1/19,14613,13980,633,4.3
20127,8/1/19,2942,2856,86,2.9
20129,8/1/19,1117,1079,38,3.4
20131,8/1/19,5375,5207,168,3.1
20133,8/1/19,6167,5856,311,5
20135,8/1/19,1378,1340,38,2.8
20137,8/1/19,2715,2645,70,2.6
20139,8/1/19,8041,7753,288,3.6
20141,8/1/19,2042,1998,44,2.2
20143,8/1/19,3015,2926,89,3
20145,8/1/19,2970,2879,91,3.1
20147,8/1/19,2549,2476,73,2.9
20149,8/1/19,12103,11745,358,3
20151,8/1/19,4873,4740,133,2.7
20153,8/1/19,1556,1518,38,2.4
20155,8/1/19,29132,28118,1014,3.5
20157,8/1/19,2310,2244,66,2.9
20159,8/1/19,5137,4988,149,2.9
20161,8/1/19,34099,33028,1071,3.1
20163,8/1/19,2533,2440,93,3.7
20165,8/1/19,1648,1601,47,2.9
20167,8/1/19,3233,3121,112,3.5
20169,8/1/19,30531,29549,982,3.2
20171,8/1/19,2918,2850,68,2.3
20173,8/1/19,250870,241610,9260,3.7
20175,8/1/19,9648,9332,316,3.3
20177,8/1/19,90875,87733,3142,3.5
20179,8/1/19,1434,1401,33,2.3
20181,8/1/19,2874,2787,87,3
20183,8/1/19,1934,1878,56,2.9
20185,8/1/19,2012,1953,59,2.9
20187,8/1/19,997,971,26,2.6
20189,8/1/19,2572,2497,75,2.9
20191,8/1/19,10969,10571,398,3.6
20193,8/1/19,4324,4214,110,2.5
20195,8/1/19,1398,1354,44,3.1
20197,8/1/19,3712,3590,122,3.3
20199,8/1/19,823,802,21,2.6
20201,8/1/19,2947,2867,80,2.7
20203,8/1/19,1229,1199,30,2.4
20205,8/1/19,3916,3741,175,4.5
20207,8/1/19,1584,1516,68,4.3
20209,8/1/19,77495,74155,3340,4.3
21001,8/1/19,6985,6636,349,5
21003,8/1/19,8992,8620,372,4.1
21005,8/1/19,12182,11732,450,3.7
21007,8/1/19,3511,3325,186,5.3
21009,8/1/19,18769,17959,810,4.3
21011,8/1/19,4595,4337,258,5.6
21013,8/1/19,8318,7733,585,7
21015,8/1/19,71556,69197,2359,3.3
21017,8/1/19,9869,9525,344,3.5
21019,8/1/19,17738,16793,945,5.3
21021,8/1/19,12437,11845,592,4.8
21023,8/1/19,3818,3653,165,4.3
21025,8/1/19,3368,3143,225,6.7
21027,8/1/19,7920,7540,380,4.8
21029,8/1/19,43171,41402,1769,4.1
21031,8/1/19,5020,4787,233,4.6
21033,8/1/19,5460,5180,280,5.1
21035,8/1/19,18699,17974,725,3.9
21037,8/1/19,51115,49394,1721,3.4
21039,8/1/19,2224,2131,93,4.2
21041,8/1/19,5303,5091,212,4
21043,8/1/19,9676,8822,854,8.8
21045,8/1/19,6630,6356,274,4.1
21047,8/1/19,25260,23829,1431,5.7
21049,8/1/19,17201,16542,659,3.8
21051,8/1/19,5206,4836,370,7.1
21053,8/1/19,4014,3823,191,4.8
21055,8/1/19,3760,3594,166,4.4
21057,8/1/19,3225,3119,106,3.3
21059,8/1/19,47691,45942,1749,3.7
21061,8/1/19,4766,4554,212,4.4
21063,8/1/19,2047,1871,176,8.6
21065,8/1/19,5271,5033,238,4.5
21067,8/1/19,175812,170050,5762,3.3
21069,8/1/19,6137,5816,321,5.2
21071,8/1/19,10881,10221,660,6.1
21073,8/1/19,25471,24555,916,3.6
21075,8/1/19,2069,1955,114,5.5
21077,8/1/19,4121,3961,160,3.9
21079,8/1/19,7546,7209,337,4.5
21081,8/1/19,11778,11328,450,3.8
21083,8/1/19,15819,15125,694,4.4
21085,8/1/19,11071,10535,536,4.8
21087,8/1/19,4996,4781,215,4.3
21089,8/1/19,13393,12519,874,6.5
21091,8/1/19,4017,3864,153,3.8
21093,8/1/19,49505,47520,1985,4
21095,8/1/19,6770,5898,872,12.9
21097,8/1/19,8891,8518,373,4.2
21099,8/1/19,7715,7381,334,4.3
21101,8/1/19,21967,21159,808,3.7
21103,8/1/19,8287,7989,298,3.6
21105,8/1/19,1769,1689,80,4.5
21107,8/1/19,18520,17739,781,4.2
21109,8/1/19,4112,3856,256,6.2
21111,8/1/19,402904,386743,16161,4
21113,8/1/19,26570,25607,963,3.6
21115,8/1/19,6739,6328,411,6.1
21117,8/1/19,88480,85474,3006,3.4
21119,8/1/19,4502,4187,315,7
21121,8/1/19,9938,9348,590,5.9
21123,8/1/19,5966,5713,253,4.2
21125,8/1/19,24687,23471,1216,4.9
21127,8/1/19,5234,4885,349,6.7
21129,8/1/19,2048,1950,98,4.8
21131,8/1/19,2746,2472,274,10
21133,8/1/19,6362,5845,517,8.1
21135,8/1/19,4562,4194,368,8.1
21137,8/1/19,9224,8779,445,4.8
21139,8/1/19,3659,3475,184,5
21141,8/1/19,12603,12107,496,3.9
21143,8/1/19,3288,3148,140,4.3
21145,8/1/19,29227,27827,1400,4.8
21147,8/1/19,4793,4527,266,5.5
21149,8/1/19,4241,4075,166,3.9
21151,8/1/19,46842,45021,1821,3.9
21153,8/1/19,3149,2803,346,11
21155,8/1/19,9694,9321,373,3.8
21157,8/1/19,15268,14624,644,4.2
21159,8/1/19,2754,2565,189,6.9
21161,8/1/19,7115,6704,411,5.8
21163,8/1/19,12424,11850,574,4.6
21165,8/1/19,2307,2172,135,5.9
21167,8/1/19,10085,9630,455,4.5
21169,8/1/19,4095,3890,205,5
21171,8/1/19,4664,4496,168,3.6
21173,8/1/19,11673,11086,587,5
21175,8/1/19,4537,4332,205,4.5
21177,8/1/19,10203,9559,644,6.3
21179,8/1/19,23211,22217,994,4.3
21181,8/1/19,3318,3179,139,4.2
21183,8/1/19,9999,9508,491,4.9
21185,8/1/19,33499,32433,1066,3.2
21187,8/1/19,5087,4870,217,4.3
21189,8/1/19,1134,1059,75,6.6
21191,8/1/19,6980,6742,238,3.4
21193,8/1/19,8265,7765,500,6
21195,8/1/19,19856,18798,1058,5.3
21197,8/1/19,5045,4812,233,4.6
21199,8/1/19,26935,25771,1164,4.3
21201,8/1/19,813,777,36,4.4
21203,8/1/19,6607,6297,310,4.7
21205,8/1/19,10235,9709,526,5.1
21207,8/1/19,6338,6027,311,4.9
21209,8/1/19,29296,28277,1019,3.5
21211,8/1/19,25768,24844,924,3.6
21213,8/1/19,8871,8480,391,4.4
21215,8/1/19,10283,9903,380,3.7
21217,8/1/19,12500,11946,554,4.4
21219,8/1/19,5478,5276,202,3.7
21221,8/1/19,6050,5799,251,4.1
21223,8/1/19,3904,3741,163,4.2
21225,8/1/19,6111,5852,259,4.2
21227,8/1/19,64753,62271,2482,3.8
21229,8/1/19,6245,6010,235,3.8
21231,8/1/19,7415,7022,393,5.3
21233,8/1/19,5860,5633,227,3.9
21235,8/1/19,13762,13069,693,5
21237,8/1/19,1919,1798,121,6.3
21239,8/1/19,14991,14554,437,2.9
22001,8/1/19,24065,22672,1393,5.8
22003,8/1/19,8675,8155,520,6
22005,8/1/19,63533,60606,2927,4.6
22007,8/1/19,8944,8348,596,6.7
22009,8/1/19,15380,14309,1071,7
22011,8/1/19,14796,13930,866,5.9
22013,8/1/19,5616,5277,339,6
22015,8/1/19,57620,54935,2685,4.7
22017,8/1/19,103600,97486,6114,5.9
22019,8/1/19,105516,100696,4820,4.6
22021,8/1/19,3740,3512,228,6.1
22023,8/1/19,3906,3752,154,3.9
22025,8/1/19,3564,3324,240,6.7
22027,8/1/19,5909,5555,354,6
22029,8/1/19,7243,6743,500,6.9
22031,8/1/19,10909,10181,728,6.7
22033,8/1/19,229404,217751,11653,5.1
22035,8/1/19,1930,1720,210,10.9
22037,8/1/19,7965,7548,417,5.2
22039,8/1/19,11810,11007,803,6.8
22041,8/1/19,7574,6941,633,8.4
22043,8/1/19,8240,7711,529,6.4
22045,8/1/19,28354,26708,1646,5.8
22047,8/1/19,14040,13091,949,6.8
22049,8/1/19,6776,6428,348,5.1
22051,8/1/19,213285,203405,9880,4.6
22053,8/1/19,13491,12784,707,5.2
22055,8/1/19,113921,108526,5395,4.7
22057,8/1/19,42544,40501,2043,4.8
22059,8/1/19,6742,6424,318,4.7
22061,8/1/19,21064,19742,1322,6.3
22063,8/1/19,68361,65287,3074,4.5
22065,8/1/19,3654,3329,325,8.9
22067,8/1/19,9938,9012,926,9.3
22069,8/1/19,16563,15359,1204,7.3
22071,8/1/19,178999,169128,9871,5.5
22073,8/1/19,69552,65486,4066,5.8
22075,8/1/19,10122,9636,486,4.8
22077,8/1/19,9927,9331,596,6
22079,8/1/19,55363,52208,3155,5.7
22081,8/1/19,3821,3597,224,5.9
22083,8/1/19,8280,7727,553,6.7
22085,8/1/19,9358,8849,509,5.4
22087,8/1/19,19909,18848,1061,5.3
22089,8/1/19,25089,23887,1202,4.8
22091,8/1/19,4264,3983,281,6.6
22093,8/1/19,9241,8615,626,6.8
22095,8/1/19,19594,18390,1204,6.1
22097,8/1/19,32182,29990,2192,6.8
22099,8/1/19,22252,21025,1227,5.5
22101,8/1/19,19944,18655,1289,6.5
22103,8/1/19,119241,113788,5453,4.6
22105,8/1/19,54728,51410,3318,6.1
22107,8/1/19,1501,1365,136,9.1
22109,8/1/19,46892,44585,2307,4.9
22111,8/1/19,9083,8537,546,6
22113,8/1/19,24301,22988,1313,5.4
22115,8/1/19,16196,15012,1184,7.3
22117,8/1/19,16573,15512,1061,6.4
22119,8/1/19,14565,13563,1002,6.9
22121,8/1/19,13561,12865,696,5.1
22123,8/1/19,3641,3282,359,9.9
22125,8/1/19,5373,5126,247,4.6
22127,8/1/19,4980,4637,343,6.9
23001,8/1/19,54692,53329,1363,2.5
23003,8/1/19,30627,29601,1026,3.3
23005,8/1/19,167946,164718,3228,1.9
23007,8/1/19,14210,13752,458,3.2
23009,8/1/19,32569,31934,635,1.9
23011,8/1/19,62466,61020,1446,2.3
23013,8/1/19,21477,21071,406,1.9
23015,8/1/19,18118,17740,378,2.1
23017,8/1/19,26969,26227,742,2.8
23019,8/1/19,76679,74762,1917,2.5
23021,8/1/19,7498,7291,207,2.8
23023,8/1/19,19670,19331,339,1.7
23025,8/1/19,23329,22562,767,3.3
23027,8/1/19,21348,20821,527,2.5
23029,8/1/19,14524,14062,462,3.2
23031,8/1/19,116225,113859,2366,2
24001,8/1/19,32512,30607,1905,5.9
24003,8/1/19,320234,309808,10426,3.3
24005,8/1/19,461261,443323,17938,3.9
24009,8/1/19,50458,48725,1733,3.4
24011,8/1/19,18301,17655,646,3.5
24013,8/1/19,96442,93479,2963,3.1
24015,8/1/19,53433,51104,2329,4.4
24017,8/1/19,88274,84678,3596,4.1
24019,8/1/19,15701,14985,716,4.6
24021,8/1/19,136079,131709,4370,3.2
24023,8/1/19,16165,15470,695,4.3
24025,8/1/19,143158,137976,5182,3.6
24027,8/1/19,190556,185105,5451,2.9
24029,8/1/19,10038,9667,371,3.7
24031,8/1/19,569244,552801,16443,2.9
24033,8/1/19,513176,493140,20036,3.9
24035,8/1/19,27752,26862,890,3.2
24037,8/1/19,57708,55509,2199,3.8
24039,8/1/19,9497,8904,593,6.2
24041,8/1/19,19408,18785,623,3.2
24043,8/1/19,74792,71917,2875,3.8
24045,8/1/19,54672,52258,2414,4.4
24047,8/1/19,26456,25169,1287,4.9
24510,8/1/19,294759,277884,16875,5.7
25001,8/1/19,128334,125122,3212,2.5
25003,8/1/19,67213,65112,2101,3.1
25005,8/1/19,304588,293687,10901,3.6
25007,8/1/19,12404,12178,226,1.8
25009,8/1/19,432776,420405,12371,2.9
25011,8/1/19,41221,40183,1038,2.5
25013,8/1/19,228173,218415,9758,4.3
25015,8/1/19,89994,87548,2446,2.7
25017,8/1/19,937299,915727,21572,2.3
25019,8/1/19,10222,10083,139,1.4
25021,8/1/19,398784,388898,9886,2.5
25023,8/1/19,289938,281439,8499,2.9
25025,8/1/19,465595,453249,12346,2.7
25027,8/1/19,449269,435363,13906,3.1
26001,8/1/19,4029,3812,217,5.4
26003,8/1/19,3452,3250,202,5.9
26005,8/1/19,63174,61291,1883,3
26007,8/1/19,13228,12618,610,4.6
26009,8/1/19,11079,10621,458,4.1
26011,8/1/19,6236,5882,354,5.7
26013,8/1/19,3282,3088,194,5.9
26015,8/1/19,31712,30704,1008,3.2
26017,8/1/19,50094,47892,2202,4.4
26019,8/1/19,9268,8921,347,3.7
26021,8/1/19,73984,70932,3052,4.1
26023,8/1/19,19652,18869,783,4
26025,8/1/19,62248,59562,2686,4.3
26027,8/1/19,24282,23202,1080,4.4
26029,8/1/19,13855,13354,501,3.6
26031,8/1/19,11314,10910,404,3.6
26033,8/1/19,15963,15096,867,5.4
26035,8/1/19,11710,11076,634,5.4
26037,8/1/19,40111,38888,1223,3
26039,8/1/19,5738,5456,282,4.9
26041,8/1/19,17582,16739,843,4.8
26043,8/1/19,12500,12026,474,3.8
26045,8/1/19,55429,53555,1874,3.4
26047,8/1/19,19051,18331,720,3.8
26049,8/1/19,183576,174910,8666,4.7
26051,8/1/19,10083,9522,561,5.6
26053,8/1/19,5976,5663,313,5.2
26055,8/1/19,52365,50812,1553,3
26057,8/1/19,17744,17007,737,4.2
26059,8/1/19,20706,19840,866,4.2
26061,8/1/19,15578,14824,754,4.8
26063,8/1/19,15741,15120,621,3.9
26065,8/1/19,146693,141341,5352,3.6
26067,8/1/19,30302,29291,1011,3.3
26069,8/1/19,10621,10091,530,5
26071,8/1/19,5301,5048,253,4.8
26073,8/1/19,34678,33342,1336,3.9
26075,8/1/19,73669,70847,2822,3.8
26077,8/1/19,132661,127985,4676,3.5
26079,8/1/19,8294,7917,377,4.5
26081,8/1/19,360011,349072,10939,3
26083,8/1/19,852,799,53,6.2
26085,8/1/19,3748,3518,230,6.1
26087,8/1/19,41804,39652,2152,5.1
26089,8/1/19,11088,10751,337,3
26091,8/1/19,46367,44648,1719,3.7
26093,8/1/19,105225,101478,3747,3.6
26095,8/1/19,2426,2292,134,5.5
26097,8/1/19,6288,6100,188,3
26099,8/1/19,455437,434467,20970,4.6
26101,8/1/19,10877,10369,508,4.7
26103,8/1/19,32253,30793,1460,4.5
26105,8/1/19,14234,13625,609,4.3
26107,8/1/19,17658,16843,815,4.6
26109,8/1/19,11208,10738,470,4.2
26111,8/1/19,40174,38713,1461,3.6
26113,8/1/19,7134,6844,290,4.1
26115,8/1/19,74662,71816,2846,3.8
26117,8/1/19,28519,27420,1099,3.9
26119,8/1/19,3062,2864,198,6.5
26121,8/1/19,78095,74797,3298,4.2
26123,8/1/19,23630,22685,945,4
26125,8/1/19,687450,660784,26666,3.9
26127,8/1/19,12955,12367,588,4.5
26129,8/1/19,8271,7809,462,5.6
26131,8/1/19,2118,1997,121,5.7
26133,8/1/19,11317,10887,430,3.8
26135,8/1/19,3232,3041,191,5.9
26137,8/1/19,11917,11397,520,4.4
26139,8/1/19,161542,156945,4597,2.8
26141,8/1/19,5139,4848,291,5.7
26143,8/1/19,8032,7517,515,6.4
26145,8/1/19,86675,82782,3893,4.5
26147,8/1/19,76948,73078,3870,5
26149,8/1/19,28602,27356,1246,4.4
26151,8/1/19,19966,19095,871,4.4
26153,8/1/19,3400,3205,195,5.7
26155,8/1/19,33123,31746,1377,4.2
26157,8/1/19,23966,22830,1136,4.7
26159,8/1/19,35196,33637,1559,4.4
26161,8/1/19,195961,189782,6179,3.2
26163,8/1/19,816837,770486,46351,5.7
26165,8/1/19,14991,14362,629,4.2
27001,8/1/19,7205,6901,304,4.2
27003,8/1/19,200785,194905,5880,2.9
27005,8/1/19,18870,18329,541,2.9
27007,8/1/19,24707,23805,902,3.7
27009,8/1/19,21880,21217,663,3
27011,8/1/19,2492,2427,65,2.6
27013,8/1/19,39960,38794,1166,2.9
27015,8/1/19,14497,14075,422,2.9
27017,8/1/19,17660,16961,699,4
27019,8/1/19,59597,57946,1651,2.8
27021,8/1/19,15294,14718,576,3.8
27023,8/1/19,6799,6575,224,3.3
27025,8/1/19,30320,29384,936,3.1
27027,8/1/19,35738,34781,957,2.7
27029,8/1/19,4351,4114,237,5.4
27031,8/1/19,3434,3343,91,2.6
27033,8/1/19,5837,5615,222,3.8
27035,8/1/19,33168,32114,1054,3.2
27037,8/1/19,245848,238710,7138,2.9
27039,8/1/19,12081,11726,355,2.9
27041,8/1/19,21646,21086,560,2.6
27043,8/1/19,7161,6924,237,3.3
27045,8/1/19,11708,11402,306,2.6
27047,8/1/19,15845,15363,482,3
27049,8/1/19,27514,26762,752,2.7
27051,8/1/19,3271,3163,108,3.3
27053,8/1/19,720645,699539,21106,2.9
27055,8/1/19,10280,10008,272,2.6
27057,8/1/19,10368,9996,372,3.6
27059,8/1/19,21485,20801,684,3.2
27061,8/1/19,22201,21063,1138,5.1
27063,8/1/19,5780,5613,167,2.9
27065,8/1/19,9001,8705,296,3.3
27067,8/1/19,24364,23648,716,2.9
27069,8/1/19,2364,2286,78,3.3
27071,8/1/19,6070,5703,367,6
27073,8/1/19,3413,3312,101,3
27075,8/1/19,5775,5604,171,3
27077,8/1/19,2480,2368,112,4.5
27079,8/1/19,16180,15698,482,3
27081,8/1/19,3233,3132,101,3.1
27083,8/1/19,14156,13729,427,3
27085,8/1/19,19434,18784,650,3.3
27087,8/1/19,2218,2146,72,3.2
27089,8/1/19,5232,5050,182,3.5
27091,8/1/19,10236,9866,370,3.6
27093,8/1/19,13398,12997,401,3
27095,8/1/19,12931,12454,477,3.7
27097,8/1/19,17385,16792,593,3.4
27099,8/1/19,20331,19750,581,2.9
27101,8/1/19,4747,4580,167,3.5
27103,8/1/19,20641,20107,534,2.6
27105,8/1/19,11164,10822,342,3.1
27107,8/1/19,3199,3076,123,3.8
27109,8/1/19,90662,88381,2281,2.5
27111,8/1/19,32244,31226,1018,3.2
27113,8/1/19,8491,8269,222,2.6
27115,8/1/19,15082,14510,572,3.8
27117,8/1/19,4963,4843,120,2.4
27119,8/1/19,16162,15571,591,3.7
27121,8/1/19,6592,6429,163,2.5
27123,8/1/19,295177,286001,9176,3.1
27125,8/1/19,2180,2095,85,3.9
27127,8/1/19,7539,7296,243,3.2
27129,8/1/19,8498,8169,329,3.9
27131,8/1/19,37226,36073,1153,3.1
27133,8/1/19,5566,5441,125,2.2
27135,8/1/19,7770,7462,308,4
27137,8/1/19,101104,97269,3835,3.8
27139,8/1/19,84916,82656,2260,2.7
27141,8/1/19,52979,51458,1521,2.9
27143,8/1/19,8594,8345,249,2.9
27145,8/1/19,90451,87877,2574,2.8
27147,8/1/19,21242,20587,655,3.1
27149,8/1/19,5423,5290,133,2.5
27151,8/1/19,4939,4779,160,3.2
27153,8/1/19,13340,12897,443,3.3
27155,8/1/19,1726,1671,55,3.2
27157,8/1/19,12536,12166,370,3
27159,8/1/19,5757,5491,266,4.6
27161,8/1/19,9190,8892,298,3.2
27163,8/1/19,145631,141642,3989,2.7
27165,8/1/19,6396,6149,247,3.9
27167,8/1/19,3500,3378,122,3.5
27169,8/1/19,28613,27754,859,3
27171,8/1/19,76587,74539,2048,2.7
27173,8/1/19,5273,5093,180,3.4
28001,8/1/19,11301,10444,857,7.6
28003,8/1/19,15808,15001,807,5.1
28005,8/1/19,4455,4117,338,7.6
28007,8/1/19,7056,6631,425,6
28009,8/1/19,3038,2863,175,5.8
28011,8/1/19,12176,11310,866,7.1
28013,8/1/19,5740,5426,314,5.5
28015,8/1/19,3493,3265,228,6.5
28017,8/1/19,6907,6503,404,5.8
28019,8/1/19,3764,3566,198,5.3
28021,8/1/19,3090,2713,377,12.2
28023,8/1/19,5904,5531,373,6.3
28025,8/1/19,7779,7213,566,7.3
28027,8/1/19,8338,7663,675,8.1
28029,8/1/19,11168,10431,737,6.6
28031,8/1/19,8158,7729,429,5.3
28033,8/1/19,91284,87144,4140,4.5
28035,8/1/19,32885,31083,1802,5.5
28037,8/1/19,2778,2575,203,7.3
28039,8/1/19,8924,8196,728,8.2
28041,8/1/19,4450,4052,398,8.9
28043,8/1/19,9360,8866,494,5.3
28045,8/1/19,18785,17713,1072,5.7
28047,8/1/19,86595,82059,4536,5.2
28049,8/1/19,106421,100636,5785,5.4
28051,8/1/19,5639,5062,577,10.2
28053,8/1/19,2220,2014,206,9.3
28055,8/1/19,402,356,46,11.4
28057,8/1/19,10542,10023,519,4.9
28059,8/1/19,58750,55100,3650,6.2
28061,8/1/19,6132,5731,401,6.5
28063,8/1/19,2090,1713,377,18
28065,8/1/19,4093,3780,313,7.6
28067,8/1/19,26111,24650,1461,5.6
28069,8/1/19,3554,3274,280,7.9
28071,8/1/19,27956,26588,1368,4.9
28073,8/1/19,30267,28959,1308,4.3
28075,8/1/19,30436,28691,1745,5.7
28077,8/1/19,4614,4260,354,7.7
28079,8/1/19,7983,7521,462,5.8
28081,8/1/19,41200,39277,1923,4.7
28083,8/1/19,10058,9284,774,7.7
28085,8/1/19,14668,13783,885,6
28087,8/1/19,25020,23650,1370,5.5
28089,8/1/19,52914,50554,2360,4.5
28091,8/1/19,9949,9408,541,5.4
28093,8/1/19,14447,13642,805,5.6
28095,8/1/19,15594,14690,904,5.8
28097,8/1/19,3959,3722,237,6
28099,8/1/19,10491,9851,640,6.1
28101,8/1/19,8845,8342,503,5.7
28103,8/1/19,3776,3501,275,7.3
28105,8/1/19,22580,21236,1344,6
28107,8/1/19,12600,11759,841,6.7
28109,8/1/19,23616,22346,1270,5.4
28111,8/1/19,4268,3950,318,7.5
28113,8/1/19,14534,13537,997,6.9
28115,8/1/19,14777,14093,684,4.6
28117,8/1/19,11286,10718,568,5
28119,8/1/19,2409,2212,197,8.2
28121,8/1/19,75728,72591,3137,4.1
28123,8/1/19,12948,12339,609,4.7
28125,8/1/19,1610,1481,129,8
28127,8/1/19,10745,10147,598,5.6
28129,8/1/19,6822,6471,351,5.1
28131,8/1/19,6802,6349,453,6.7
28133,8/1/19,7760,7051,709,9.1
28135,8/1/19,5249,4969,280,5.3
28137,8/1/19,12423,11695,728,5.9
28139,8/1/19,9405,8922,483,5.1
28141,8/1/19,8494,8022,472,5.6
28143,8/1/19,4482,4199,283,6.3
28145,8/1/19,14223,13614,609,4.3
28147,8/1/19,4972,4593,379,7.6
28149,8/1/19,20420,19145,1275,6.2
28151,8/1/19,16921,15647,1274,7.5
28153,8/1/19,7534,7050,484,6.4
28155,8/1/19,3967,3739,228,5.7
28157,8/1/19,2836,2517,319,11.2
28159,8/1/19,7473,7006,467,6.2
28161,8/1/19,4951,4632,319,6.4
28163,8/1/19,9435,8801,634,6.7
29001,8/1/19,9932,9486,446,4.5
29003,8/1/19,9686,9426,260,2.7
29005,8/1/19,2515,2408,107,4.3
29007,8/1/19,10344,9987,357,3.5
29009,8/1/19,14912,14361,551,3.7
29011,8/1/19,5004,4810,194,3.9
29013,8/1/19,7868,7529,339,4.3
29015,8/1/19,6960,6643,317,4.6
29017,8/1/19,5395,5167,228,4.2
29019,8/1/19,96631,94045,2586,2.7
29021,8/1/19,44537,43114,1423,3.2
29023,8/1/19,17771,16935,836,4.7
29025,8/1/19,4327,4186,141,3.3
29027,8/1/19,21541,20827,714,3.3
29029,8/1/19,20003,19238,765,3.8
29031,8/1/19,40517,39136,1381,3.4
29033,8/1/19,4555,4402,153,3.4
29035,8/1/19,2633,2504,129,4.9
29037,8/1/19,55038,53335,1703,3.1
29039,8/1/19,5576,5350,226,4.1
29041,8/1/19,3478,3353,125,3.6
29043,8/1/19,44609,43287,1322,3
29045,8/1/19,3155,3046,109,3.5
29047,8/1/19,137287,133101,4186,3
29049,8/1/19,10700,10377,323,3
29051,8/1/19,39447,38270,1177,3
29053,8/1/19,7197,6937,260,3.6
29055,8/1/19,10914,10508,406,3.7
29057,8/1/19,3322,3201,121,3.6
29059,8/1/19,7018,6626,392,5.6
29061,8/1/19,3842,3707,135,3.5
29063,8/1/19,4755,4614,141,3
29065,8/1/19,6028,5774,254,4.2
29067,8/1/19,4986,4621,365,7.3
29069,8/1/19,11060,10410,650,5.9
29071,8/1/19,53463,51659,1804,3.4
29073,8/1/19,7557,7339,218,2.9
29075,8/1/19,3403,3298,105,3.1
29077,8/1/19,150343,145662,4681,3.1
29079,8/1/19,4049,3892,157,3.9
29081,8/1/19,3578,3431,147,4.1
29083,8/1/19,9426,9041,385,4.1
29085,8/1/19,3840,3662,178,4.6
29087,8/1/19,2490,2409,81,3.3
29089,8/1/19,4643,4492,151,3.3
29091,8/1/19,16331,15647,684,4.2
29093,8/1/19,3455,3275,180,5.2
29095,8/1/19,366256,351433,14823,4
29097,8/1/19,57231,55419,1812,3.2
29099,8/1/19,118919,115120,3799,3.2
29101,8/1/19,22713,21793,920,4.1
29103,8/1/19,1669,1621,48,2.9
29105,8/1/19,17283,15695,1588,9.2
29107,8/1/19,16738,16246,492,2.9
29109,8/1/19,17419,16755,664,3.8
29111,8/1/19,4815,4645,170,3.5
29113,8/1/19,28462,27530,932,3.3
29115,8/1/19,4943,4634,309,6.3
29117,8/1/19,7141,6955,186,2.6
29119,8/1/19,10637,10258,379,3.6
29121,8/1/19,7198,6946,252,3.5
29123,8/1/19,5428,5242,186,3.4
29125,8/1/19,3755,3614,141,3.8
29127,8/1/19,14291,13825,466,3.3
29129,8/1/19,1651,1597,54,3.3
29131,8/1/19,12217,11777,440,3.6
29133,8/1/19,5651,5397,254,4.5
29135,8/1/19,7267,7037,230,3.2
29137,8/1/19,3710,3538,172,4.6
29139,8/1/19,5685,5507,178,3.1
29141,8/1/19,8214,7891,323,3.9
29143,8/1/19,7944,7556,388,4.9
29145,8/1/19,27263,26329,934,3.4
29147,8/1/19,10398,10021,377,3.6
29149,8/1/19,3922,3757,165,4.2
29151,8/1/19,7111,6915,196,2.8
29153,8/1/19,3303,3091,212,6.4
29155,8/1/19,6338,5989,349,5.5
29157,8/1/19,9911,9645,266,2.7
29159,8/1/19,21178,20310,868,4.1
29161,8/1/19,19854,19178,676,3.4
29163,8/1/19,7325,7034,291,4
29165,8/1/19,59037,57384,1653,2.8
29167,8/1/19,14425,13866,559,3.9
29169,8/1/19,14717,14065,652,4.4
29171,8/1/19,2215,2108,107,4.8
29173,8/1/19,5521,5356,165,3
29175,8/1/19,10059,9631,428,4.3
29177,8/1/19,11083,10635,448,4
29179,8/1/19,2933,2812,121,4.1
29181,8/1/19,4842,4574,268,5.5
29183,8/1/19,228067,222034,6033,2.6
29185,8/1/19,3552,3354,198,5.6
29186,8/1/19,9111,8865,246,2.7
29187,8/1/19,26557,25528,1029,3.9
29189,8/1/19,537065,519166,17899,3.3
29195,8/1/19,10156,9787,369,3.6
29197,8/1/19,1849,1758,91,4.9
29199,8/1/19,2320,2243,77,3.3
29201,8/1/19,19642,18881,761,3.9
29203,8/1/19,3150,2985,165,5.2
29205,8/1/19,2913,2838,75,2.6
29207,8/1/19,12980,12334,646,5
29209,8/1/19,14368,13809,559,3.9
29211,8/1/19,2507,2402,105,4.2
29213,8/1/19,28099,27013,1086,3.9
29215,8/1/19,8492,8062,430,5.1
29217,8/1/19,9001,8650,351,3.9
29219,8/1/19,17977,17476,501,2.8
29221,8/1/19,9982,9542,440,4.4
29223,8/1/19,5278,5016,262,5
29225,8/1/19,17183,16398,785,4.6
29227,8/1/19,1081,1053,28,2.6
29229,8/1/19,7168,6688,480,6.7
29510,8/1/19,154409,147791,6618,4.3
30001,8/1/19,5132,5007,125,2.4
30003,8/1/19,4823,4476,347,7.2
30005,8/1/19,2523,2448,75,3
30007,8/1/19,2645,2552,93,3.5
30009,8/1/19,5497,5340,157,2.9
30011,8/1/19,680,667,13,1.9
30013,8/1/19,37579,36330,1249,3.3
30015,8/1/19,2508,2455,53,2.1
30017,8/1/19,6052,5911,141,2.3
30019,8/1/19,916,902,14,1.5
30021,8/1/19,4619,4521,98,2.1
30023,8/1/19,5142,4977,165,3.2
30025,8/1/19,1802,1778,24,1.3
30027,8/1/19,6228,6079,149,2.4
30029,8/1/19,49912,48008,1904,3.8
30031,8/1/19,71140,69838,1302,1.8
30033,8/1/19,746,728,18,2.4
30035,8/1/19,6228,5816,412,6.6
30037,8/1/19,365,357,8,2.2
30039,8/1/19,1722,1648,74,4.3
30041,8/1/19,7706,7387,319,4.1
30043,8/1/19,5796,5631,165,2.8
30045,8/1/19,941,920,21,2.2
30047,8/1/19,13313,12775,538,4
30049,8/1/19,36569,35523,1046,2.9
30051,8/1/19,949,927,22,2.3
30053,8/1/19,8274,7781,493,6
30055,8/1/19,951,933,18,1.9
30057,8/1/19,4732,4610,122,2.6
30059,8/1/19,906,885,21,2.3
30061,8/1/19,1824,1741,83,4.6
30063,8/1/19,63580,61812,1768,2.8
30065,8/1/19,2253,2175,78,3.5
30067,8/1/19,9496,9265,231,2.4
30069,8/1/19,279,271,8,2.9
30071,8/1/19,1875,1824,51,2.7
30073,8/1/19,2651,2563,88,3.3
30075,8/1/19,971,952,19,2
30077,8/1/19,3066,2968,98,3.2
30079,8/1/19,484,465,19,3.9
30081,8/1/19,20365,19668,697,3.4
30083,8/1/19,6096,5929,167,2.7
30085,8/1/19,4469,4277,192,4.3
30087,8/1/19,3986,3767,219,5.5
30089,8/1/19,4975,4725,250,5
30091,8/1/19,1740,1705,35,2
30093,8/1/19,17621,16987,634,3.6
30095,8/1/19,5242,5099,143,2.7
30097,8/1/19,1807,1762,45,2.5
30099,8/1/19,2762,2688,74,2.7
30101,8/1/19,2155,2104,51,2.4
30103,8/1/19,338,328,10,3
30105,8/1/19,4141,4021,120,2.9
30107,8/1/19,801,772,29,3.6
30109,8/1/19,472,462,10,2.1
30111,8/1/19,82243,79719,2524,3.1
31001,8/1/19,16976,16480,496,2.9
31003,8/1/19,3511,3420,91,2.6
31005,8/1/19,215,200,15,7
31007,8/1/19,367,350,17,4.6
31009,8/1/19,240,229,11,4.6
31011,8/1/19,2881,2807,74,2.6
31013,8/1/19,5415,5230,185,3.4
31015,8/1/19,1025,991,34,3.3
31017,8/1/19,1376,1332,44,3.2
31019,8/1/19,27605,26867,738,2.7
31021,8/1/19,3409,3303,106,3.1
31023,8/1/19,4575,4456,119,2.6
31025,8/1/19,13672,13235,437,3.2
31027,8/1/19,4439,4327,112,2.5
31029,8/1/19,2235,2180,55,2.5
31031,8/1/19,3361,3278,83,2.5
31033,8/1/19,4429,4251,178,4
31035,8/1/19,3274,3178,96,2.9
31037,8/1/19,5554,5401,153,2.8
31039,8/1/19,4605,4482,123,2.7
31041,8/1/19,6256,6095,161,2.6
31043,8/1/19,10804,10431,373,3.5
31045,8/1/19,4874,4725,149,3.1
31047,8/1/19,13035,12662,373,2.9
31049,8/1/19,966,936,30,3.1
31051,8/1/19,2978,2899,79,2.7
31053,8/1/19,19584,19011,573,2.9
31055,8/1/19,303633,293867,9766,3.2
31057,8/1/19,1121,1089,32,2.9
31059,8/1/19,3167,3088,79,2.5
31061,8/1/19,1371,1322,49,3.6
31063,8/1/19,1526,1473,53,3.5
31065,8/1/19,2534,2453,81,3.2
31067,8/1/19,10932,10567,365,3.3
31069,8/1/19,1093,1065,28,2.6
31071,8/1/19,1177,1145,32,2.7
31073,8/1/19,1150,1122,28,2.4
31075,8/1/19,390,377,13,3.3
31077,8/1/19,1162,1130,32,2.8
31079,8/1/19,31854,30876,978,3.1
31081,8/1/19,4717,4575,142,3
31083,8/1/19,1830,1769,61,3.3
31085,8/1/19,588,573,15,2.6
31087,8/1/19,1263,1221,42,3.3
31089,8/1/19,5595,5449,146,2.6
31091,8/1/19,447,434,13,2.9
31093,8/1/19,3314,3218,96,2.9
31095,8/1/19,4138,4017,121,2.9
31097,8/1/19,2029,1955,74,3.6
31099,8/1/19,3751,3656,95,2.5
31101,8/1/19,4677,4520,157,3.4
31103,8/1/19,553,536,17,3.1
31105,8/1/19,2028,1966,62,3.1
31107,8/1/19,4512,4387,125,2.8
31109,8/1/19,178242,173242,5000,2.8
31111,8/1/19,18522,17884,638,3.4
31113,8/1/19,449,436,13,2.9
31115,8/1/19,384,367,17,4.4
31117,8/1/19,429,418,11,2.6
31119,8/1/19,19858,19321,537,2.7
31121,8/1/19,3963,3844,119,3
31123,8/1/19,2591,2521,70,2.7
31125,8/1/19,1917,1866,51,2.7
31127,8/1/19,3484,3346,138,4
31129,8/1/19,2365,2301,64,2.7
31131,8/1/19,8441,8176,265,3.1
31133,8/1/19,1463,1419,44,3
31135,8/1/19,1774,1734,40,2.3
31137,8/1/19,4927,4791,136,2.8
31139,8/1/19,4085,3975,110,2.7
31141,8/1/19,17908,17393,515,2.9
31143,8/1/19,2858,2779,79,2.8
31145,8/1/19,5845,5680,165,2.8
31147,8/1/19,4217,4083,134,3.2
31149,8/1/19,836,810,26,3.1
31151,8/1/19,7200,6981,219,3
31153,8/1/19,98010,95146,2864,2.9
31155,8/1/19,11209,10904,305,2.7
31157,8/1/19,18281,17653,628,3.4
31159,8/1/19,8871,8610,261,2.9
31161,8/1/19,2618,2546,72,2.8
31163,8/1/19,1673,1620,53,3.2
31165,8/1/19,732,713,19,2.6
31167,8/1/19,3492,3407,85,2.4
31169,8/1/19,2715,2639,76,2.8
31171,8/1/19,405,390,15,3.7
31173,8/1/19,3054,2916,138,4.5
31175,8/1/19,2098,2037,61,2.9
31177,8/1/19,11357,11041,316,2.8
31179,8/1/19,5435,5293,142,2.6
31181,8/1/19,1643,1584,59,3.6
31183,8/1/19,535,520,15,2.8
31185,8/1/19,7313,7118,195,2.7
32001,8/1/19,10927,10548,379,3.5
32003,8/1/19,1137375,1091232,46143,4.1
32005,8/1/19,23511,22662,849,3.6
32007,8/1/19,27222,26450,772,2.8
32009,8/1/19,443,426,17,3.8
32011,8/1/19,1027,999,28,2.7
32013,8/1/19,8064,7818,246,3.1
32015,8/1/19,3180,3085,95,3
32017,8/1/19,2074,1997,77,3.7
32019,8/1/19,23146,22109,1037,4.5
32021,8/1/19,2072,1997,75,3.6
32023,8/1/19,17206,16339,867,5
32027,8/1/19,2484,2397,87,3.5
32029,8/1/19,2040,1970,70,3.4
32031,8/1/19,256252,248379,7873,3.1
32033,8/1/19,4696,4563,133,2.8
32510,8/1/19,26435,25475,960,3.6
33001,8/1/19,33389,32629,760,2.3
33003,8/1/19,26370,25796,574,2.2
33005,8/1/19,40610,39565,1045,2.6
33007,8/1/19,15328,14901,427,2.8
33009,8/1/19,50692,49593,1099,2.2
33011,8/1/19,242743,236342,6401,2.6
33013,8/1/19,84187,82306,1881,2.2
33015,8/1/19,191884,186765,5119,2.7
33017,8/1/19,74925,73173,1752,2.3
33019,8/1/19,23568,23019,549,2.3
34001,8/1/19,124209,118285,5924,4.8
34003,8/1/19,482282,466973,15309,3.2
34005,8/1/19,231562,223409,8153,3.5
34007,8/1/19,253992,243189,10803,4.3
34009,8/1/19,55575,53481,2094,3.8
34011,8/1/19,63760,60210,3550,5.6
34013,8/1/19,371123,353708,17415,4.7
34015,8/1/19,150309,144457,5852,3.9
34017,8/1/19,361014,348571,12443,3.4
34019,8/1/19,64841,62996,1845,2.8
34021,8/1/19,204770,197745,7025,3.4
34023,8/1/19,445540,430768,14772,3.3
34025,8/1/19,333079,322284,10795,3.2
34027,8/1/19,257966,250442,7524,2.9
34029,8/1/19,278247,268257,9990,3.6
34031,8/1/19,242316,231234,11082,4.6
34033,8/1/19,29312,27849,1463,5
34035,8/1/19,172269,166861,5408,3.1
34037,8/1/19,74302,71716,2586,3.5
34039,8/1/19,277861,267184,10677,3.8
34041,8/1/19,56215,54235,1980,3.5
35001,8/1/19,333369,317980,15389,4.6
35003,8/1/19,1221,1156,65,5.3
35005,8/1/19,27134,25777,1357,5
35006,8/1/19,8987,8408,579,6.4
35007,8/1/19,6249,5983,266,4.3
35009,8/1/19,21443,20493,950,4.4
35011,8/1/19,788,756,32,4.1
35013,8/1/19,97287,91983,5304,5.5
35015,8/1/19,34793,33670,1123,3.2
35017,8/1/19,11993,11395,598,5
35019,8/1/19,1579,1498,81,5.1
35021,8/1/19,276,261,15,5.4
35023,8/1/19,2083,1984,99,4.8
35025,8/1/19,31036,29759,1277,4.1
35027,8/1/19,9405,9011,394,4.2
35028,8/1/19,9759,9443,316,3.2
35029,8/1/19,10938,10020,918,8.4
35031,8/1/19,24134,22389,1745,7.2
35033,8/1/19,2270,2143,127,5.6
35035,8/1/19,24629,23384,1245,5.1
35037,8/1/19,3197,3024,173,5.4
35039,8/1/19,17115,16237,878,5.1
35041,8/1/19,7825,7451,374,4.8
35043,8/1/19,66357,63039,3318,5
35045,8/1/19,50950,47941,3009,5.9
35047,8/1/19,10513,9863,650,6.2
35049,8/1/19,76039,72961,3078,4
35051,8/1/19,4145,3895,250,6
35053,8/1/19,6441,6041,400,6.2
35055,8/1/19,15218,14328,890,5.8
35057,8/1/19,5680,5300,380,6.7
35059,8/1/19,1944,1879,65,3.3
35061,8/1/19,30830,29108,1722,5.6
36001,8/1/19,157698,151605,6093,3.9
36003,8/1/19,19038,18062,976,5.1
36005,8/1/19,597863,563669,34194,5.7
36007,8/1/19,82887,78926,3961,4.8
36009,8/1/19,33836,32233,1603,4.7
36011,8/1/19,36499,34974,1525,4.2
36013,8/1/19,56079,53618,2461,4.4
36015,8/1/19,34435,32939,1496,4.3
36017,8/1/19,22535,21646,889,3.9
36019,8/1/19,36194,34665,1529,4.2
36021,8/1/19,31859,30862,997,3.1
36023,8/1/19,22360,21377,983,4.4
36025,8/1/19,19598,18725,873,4.5
36027,8/1/19,144193,138736,5457,3.8
36029,8/1/19,443615,424184,19431,4.4
36031,8/1/19,18111,17427,684,3.8
36033,8/1/19,20041,19131,910,4.5
36035,8/1/19,22805,21728,1077,4.7
36037,8/1/19,30210,29162,1048,3.5
36039,8/1/19,20577,19642,935,4.5
36041,8/1/19,2467,2384,83,3.4
36043,8/1/19,28093,26868,1225,4.4
36045,8/1/19,44724,42429,2295,5.1
36047,8/1/19,1195650,1144209,51441,4.3
36049,8/1/19,11632,11120,512,4.4
36051,8/1/19,30608,29401,1207,3.9
36053,8/1/19,32976,31604,1372,4.2
36055,8/1/19,360480,344457,16023,4.4
36057,8/1/19,22289,21196,1093,4.9
36059,8/1/19,713893,687174,26719,3.7
36061,8/1/19,908438,875416,33022,3.6
36063,8/1/19,99206,94334,4872,4.9
36065,8/1/19,102232,97893,4339,4.2
36067,8/1/19,222307,213322,8985,4
36069,8/1/19,55013,53021,1992,3.6
36071,8/1/19,186884,179253,7631,4.1
36073,8/1/19,17688,16791,897,5.1
36075,8/1/19,53146,50446,2700,5.1
36077,8/1/19,28541,27440,1101,3.9
36079,8/1/19,51258,49247,2011,3.9
36081,8/1/19,1136396,1095372,41024,3.6
36083,8/1/19,81140,77968,3172,3.9
36085,8/1/19,222534,213152,9382,4.2
36087,8/1/19,156427,150306,6121,3.9
36089,8/1/19,42603,40250,2353,5.5
36091,8/1/19,118705,114772,3933,3.3
36093,8/1/19,76049,73049,3000,3.9
36095,8/1/19,14639,13992,647,4.4
36097,8/1/19,8192,7871,321,3.9
36099,8/1/19,16229,15662,567,3.5
36101,8/1/19,42517,40750,1767,4.2
36103,8/1/19,785615,753852,31763,4
36105,8/1/19,39015,37580,1435,3.7
36107,8/1/19,22520,21637,883,3.9
36109,8/1/19,47830,45894,1936,4
36111,8/1/19,87711,84176,3535,4
36113,8/1/19,32698,31497,1201,3.7
36115,8/1/19,29254,28210,1044,3.6
36117,8/1/19,43786,42087,1699,3.9
36119,8/1/19,487601,467552,20049,4.1
36121,8/1/19,18571,17881,690,3.7
36123,8/1/19,11847,11459,388,3.3
37001,8/1/19,82566,79154,3412,4.1
37003,8/1/19,17987,17338,649,3.6
37005,8/1/19,4417,4200,217,4.9
37007,8/1/19,10701,10228,473,4.4
37009,8/1/19,12925,12429,496,3.8
37011,8/1/19,7754,7459,295,3.8
37013,8/1/19,19076,18114,962,5
37015,8/1/19,7601,7207,394,5.2
37017,8/1/19,14400,13642,758,5.3
37019,8/1/19,56041,53106,2935,5.2
37021,8/1/19,141342,136755,4587,3.2
37023,8/1/19,41071,39384,1687,4.1
37025,8/1/19,110360,106172,4188,3.8
37027,8/1/19,36624,35041,1583,4.3
37029,8/1/19,4560,4374,186,4.1
37031,8/1/19,32857,31507,1350,4.1
37033,8/1/19,9764,9304,460,4.7
37035,8/1/19,79161,76091,3070,3.9
37037,8/1/19,35757,34451,1306,3.7
37039,8/1/19,11050,10524,526,4.8
37041,8/1/19,5445,5166,279,5.1
37043,8/1/19,4078,3872,206,5.1
37045,8/1/19,48253,46182,2071,4.3
37047,8/1/19,23175,21964,1211,5.2
37049,8/1/19,42060,40241,1819,4.3
37051,8/1/19,127416,120468,6948,5.5
37053,8/1/19,14152,13638,514,3.6
37055,8/1/19,22613,21813,800,3.5
37057,8/1/19,81295,78056,3239,4
37059,8/1/19,20730,19949,781,3.8
37061,8/1/19,24826,23722,1104,4.4
37063,8/1/19,172706,166345,6361,3.7
37065,8/1/19,20931,19616,1315,6.3
37067,8/1/19,189022,181334,7688,4.1
37069,8/1/19,31692,30323,1369,4.3
37071,8/1/19,112516,107904,4612,4.1
37073,8/1/19,5360,5127,233,4.3
37075,8/1/19,3280,3110,170,5.2
37077,8/1/19,29968,28881,1087,3.6
37079,8/1/19,9221,8834,387,4.2
37081,8/1/19,264275,252474,11801,4.5
37083,8/1/19,20214,18974,1240,6.1
37085,8/1/19,53252,50620,2632,4.9
37087,8/1/19,30139,29036,1103,3.7
37089,8/1/19,55343,53366,1977,3.6
37091,8/1/19,9089,8564,525,5.8
37093,8/1/19,20005,18958,1047,5.2
37095,8/1/19,2036,1919,117,5.7
37097,8/1/19,90548,87054,3494,3.9
37099,8/1/19,20415,19542,873,4.3
37101,8/1/19,100078,96172,3906,3.9
37103,8/1/19,4350,4161,189,4.3
37105,8/1/19,25875,24626,1249,4.8
37107,8/1/19,27689,26545,1144,4.1
37109,8/1/19,43914,42281,1633,3.7
37111,8/1/19,20656,19786,870,4.2
37113,8/1/19,15737,15107,630,4
37115,8/1/19,10246,9824,422,4.1
37117,8/1/19,8843,8347,496,5.6
37119,8/1/19,629721,605589,24132,3.8
37121,8/1/19,6090,5794,296,4.9
37123,8/1/19,11550,11025,525,4.5
37125,8/1/19,42640,40863,1777,4.2
37127,8/1/19,42698,40442,2256,5.3
37129,8/1/19,126142,121442,4700,3.7
37131,8/1/19,7653,7215,438,5.7
37133,8/1/19,65310,62097,3213,4.9
37135,8/1/19,79514,76633,2881,3.6
37137,8/1/19,5354,5133,221,4.1
37139,8/1/19,16543,15741,802,4.8
37141,8/1/19,29249,28011,1238,4.2
37143,8/1/19,4859,4601,258,5.3
37145,8/1/19,18548,17713,835,4.5
37147,8/1/19,88562,84328,4234,4.8
37149,8/1/19,9158,8785,373,4.1
37151,8/1/19,66492,63746,2746,4.1
37153,8/1/19,16397,15477,920,5.6
37155,8/1/19,49855,46954,2901,5.8
37157,8/1/19,40277,38388,1889,4.7
37159,8/1/19,66884,64088,2796,4.2
37161,8/1/19,25000,23680,1320,5.3
37163,8/1/19,28172,26954,1218,4.3
37165,8/1/19,11310,10502,808,7.1
37167,8/1/19,30447,29240,1207,4
37169,8/1/19,21791,20940,851,3.9
37171,8/1/19,34035,32702,1333,3.9
37173,8/1/19,7267,6998,269,3.7
37175,8/1/19,15034,14437,597,4
37177,8/1/19,1610,1533,77,4.8
37179,8/1/19,125147,120488,4659,3.7
37181,8/1/19,17584,16491,1093,6.2
37183,8/1/19,603654,581983,21671,3.6
37185,8/1/19,6570,6171,399,6.1
37187,8/1/19,4499,4238,261,5.8
37189,8/1/19,30360,29190,1170,3.9
37191,8/1/19,51194,48899,2295,4.5
37193,8/1/19,29376,28091,1285,4.4
37195,8/1/19,34615,32437,2178,6.3
37197,8/1/19,17733,17067,666,3.8
37199,8/1/19,8476,8134,342,4
38001,8/1/19,1072,1052,20,1.9
38003,8/1/19,5062,4849,213,4.2
38005,8/1/19,2269,2176,93,4.1
38007,8/1/19,560,547,13,2.3
38009,8/1/19,2973,2893,80,2.7
38011,8/1/19,1707,1681,26,1.5
38013,8/1/19,1012,989,23,2.3
38015,8/1/19,50208,49110,1098,2.2
38017,8/1/19,103825,101930,1895,1.8
38019,8/1/19,1880,1834,46,2.4
38021,8/1/19,2321,2274,47,2
38023,8/1/19,1510,1489,21,1.4
38025,8/1/19,3174,3128,46,1.4
38027,8/1/19,1155,1108,47,4.1
38029,8/1/19,1414,1370,44,3.1
38031,8/1/19,1489,1455,34,2.3
38033,8/1/19,811,797,14,1.7
38035,8/1/19,37008,36239,769,2.1
38037,8/1/19,1183,1163,20,1.7
38039,8/1/19,1029,1006,23,2.2
38041,8/1/19,1348,1318,30,2.2
38043,8/1/19,1247,1208,39,3.1
38045,8/1/19,1977,1934,43,2.2
38047,8/1/19,845,828,17,2
38049,8/1/19,2981,2901,80,2.7
38051,8/1/19,1107,1078,29,2.6
38053,8/1/19,10836,10663,173,1.6
38055,8/1/19,4756,4616,140,2.9
38057,8/1/19,3627,3478,149,4.1
38059,8/1/19,16460,16038,422,2.6
38061,8/1/19,7626,7526,100,1.3
38063,8/1/19,1400,1361,39,2.8
38065,8/1/19,874,844,30,3.4
38067,8/1/19,3402,3289,113,3.3
38069,8/1/19,1714,1664,50,2.9
38071,8/1/19,5670,5531,139,2.5
38073,8/1/19,2817,2771,46,1.6
38075,8/1/19,1214,1185,29,2.4
38077,8/1/19,8634,8445,189,2.2
38079,8/1/19,4697,4252,445,9.5
38081,8/1/19,2726,2682,44,1.6
38083,8/1/19,660,640,20,3
38085,8/1/19,1272,1209,63,5
38087,8/1/19,399,388,11,2.8
38089,8/1/19,19030,18651,379,2
38091,8/1/19,965,944,21,2.2
38093,8/1/19,10301,10081,220,2.1
38095,8/1/19,1098,1069,29,2.6
38097,8/1/19,4304,4188,116,2.7
38099,8/1/19,5102,4933,169,3.3
38101,8/1/19,31925,31211,714,2.2
38103,8/1/19,1915,1869,46,2.4
38105,8/1/19,25659,25245,414,1.6
39001,8/1/19,10715,10012,703,6.6
39003,8/1/19,48427,46413,2014,4.2
39005,8/1/19,26878,25792,1086,4
39007,8/1/19,45285,43198,2087,4.6
39009,8/1/19,25428,23892,1536,6
39011,8/1/19,25213,24434,779,3.1
39013,8/1/19,30097,28519,1578,5.2
39015,8/1/19,19747,18774,973,4.9
39017,8/1/19,196844,188960,7884,4
39019,8/1/19,12991,12390,601,4.6
39021,8/1/19,20060,19318,742,3.7
39023,8/1/19,63507,60771,2736,4.3
39025,8/1/19,107809,103622,4187,3.9
39027,8/1/19,17715,16872,843,4.8
39029,8/1/19,47886,45548,2338,4.9
39031,8/1/19,14477,13629,848,5.9
39033,8/1/19,18459,17543,916,5
39035,8/1/19,619193,593054,26139,4.2
39037,8/1/19,25901,24935,966,3.7
39039,8/1/19,18208,17433,775,4.3
39041,8/1/19,111876,108066,3810,3.4
39043,8/1/19,39124,37438,1686,4.3
39045,8/1/19,78853,75842,3011,3.8
39047,8/1/19,13984,13412,572,4.1
39049,8/1/19,706950,680148,26802,3.8
39051,8/1/19,22329,21460,869,3.9
39053,8/1/19,11974,11311,663,5.5
39055,8/1/19,49679,48022,1657,3.3
39057,8/1/19,83985,80654,3331,4
39059,8/1/19,18755,17815,940,5
39061,8/1/19,420795,403360,17435,4.1
39063,8/1/19,41820,40425,1395,3.3
39065,8/1/19,13378,12758,620,4.6
39067,8/1/19,6839,6495,344,5
39069,8/1/19,13255,12706,549,4.1
39071,8/1/19,17045,16149,896,5.3
39073,8/1/19,13191,12629,562,4.3
39075,8/1/19,21083,20424,659,3.1
39077,8/1/19,28379,27005,1374,4.8
39079,8/1/19,12662,11907,755,6
39081,8/1/19,28126,26461,1665,5.9
39083,8/1/19,31276,29998,1278,4.1
39085,8/1/19,127417,122844,4573,3.6
39087,8/1/19,23999,22646,1353,5.6
39089,8/1/19,91693,88081,3612,3.9
39091,8/1/19,22916,22044,872,3.8
39093,8/1/19,155002,148482,6520,4.2
39095,8/1/19,209895,200184,9711,4.6
39097,8/1/19,20979,20237,742,3.5
39099,8/1/19,103711,97478,6233,6
39101,8/1/19,28446,27238,1208,4.2
39103,8/1/19,98528,95135,3393,3.4
39105,8/1/19,8884,8259,625,7
39107,8/1/19,23659,23011,648,2.7
39109,8/1/19,54519,52416,2103,3.9
39111,8/1/19,5335,4931,404,7.6
39113,8/1/19,254959,243643,11316,4.4
39115,8/1/19,6684,6291,393,5.9
39117,8/1/19,16970,16299,671,4
39119,8/1/19,39599,37743,1856,4.7
39121,8/1/19,4679,4390,289,6.2
39123,8/1/19,22390,21461,929,4.1
39125,8/1/19,8716,8377,339,3.9
39127,8/1/19,15994,15224,770,4.8
39129,8/1/19,26707,25638,1069,4
39131,8/1/19,10860,10220,640,5.9
39133,8/1/19,87912,84157,3755,4.3
39135,8/1/19,21317,20515,802,3.8
39137,8/1/19,19025,18458,567,3
39139,8/1/19,52294,49938,2356,4.5
39141,8/1/19,35435,33907,1528,4.3
39143,8/1/19,30913,29706,1207,3.9
39145,8/1/19,29061,27221,1840,6.3
39147,8/1/19,27380,26266,1114,4.1
39149,8/1/19,24365,23460,905,3.7
39151,8/1/19,186768,178466,8302,4.4
39153,8/1/19,274402,262308,12094,4.4
39155,8/1/19,87247,81743,5504,6.3
39157,8/1/19,45555,43660,1895,4.2
39159,8/1/19,29349,28308,1041,3.5
39161,8/1/19,15196,14704,492,3.2
39163,8/1/19,5608,5324,284,5.1
39165,8/1/19,120364,115820,4544,3.8
39167,8/1/19,27741,26273,1468,5.3
39169,8/1/19,62299,60206,2093,3.4
39171,8/1/19,19157,18498,659,3.4
39173,8/1/19,71146,68437,2709,3.8
39175,8/1/19,13047,12649,398,3.1
40001,8/1/19,8146,7825,321,3.9
40003,8/1/19,2790,2731,59,2.1
40005,8/1/19,4915,4708,207,4.2
40007,8/1/19,2895,2838,57,2
40009,8/1/19,10339,10001,338,3.3
40011,8/1/19,4829,4737,92,1.9
40013,8/1/19,21579,20936,643,3
40015,8/1/19,11877,11441,436,3.7
40017,8/1/19,74004,71841,2163,2.9
40019,8/1/19,20966,20242,724,3.5
40021,8/1/19,18898,18145,753,4
40023,8/1/19,5482,5204,278,5.1
40025,8/1/19,1378,1356,22,1.6
40027,8/1/19,142168,138030,4138,2.9
40029,8/1/19,2393,2293,100,4.2
40031,8/1/19,47820,46002,1818,3.8
40033,8/1/19,2717,2633,84,3.1
40035,8/1/19,5942,5735,207,3.5
40037,8/1/19,31662,30470,1192,3.8
40039,8/1/19,15426,15039,387,2.5
40041,8/1/19,18228,17549,679,3.7
40043,8/1/19,2966,2904,62,2.1
40045,8/1/19,2172,2115,57,2.6
40047,8/1/19,27078,26266,812,3
40049,8/1/19,12517,12129,388,3.1
40051,8/1/19,26423,25611,812,3.1
40053,8/1/19,2719,2660,59,2.2
40055,8/1/19,1879,1800,79,4.2
40057,8/1/19,1197,1159,38,3.2
40059,8/1/19,1809,1756,53,2.9
40061,8/1/19,4195,3972,223,5.3
40063,8/1/19,5143,4897,246,4.8
40065,8/1/19,10655,10344,311,2.9
40067,8/1/19,2520,2434,86,3.4
40069,8/1/19,3765,3608,157,4.2
40071,8/1/19,18134,17373,761,4.2
40073,8/1/19,9123,8933,190,2.1
40075,8/1/19,3526,3381,145,4.1
40077,8/1/19,3061,2875,186,6.1
40079,8/1/19,18999,18125,874,4.6
40081,8/1/19,15757,15187,570,3.6
40083,8/1/19,22025,21385,640,2.9
40085,8/1/19,6135,5990,145,2.4
40087,8/1/19,19610,19075,535,2.7
40089,8/1/19,14628,13824,804,5.5
40091,8/1/19,7162,6737,425,5.9
40093,8/1/19,3834,3747,87,2.3
40095,8/1/19,6962,6720,242,3.5
40097,8/1/19,19426,18810,616,3.2
40099,8/1/19,6241,6047,194,3.1
40101,8/1/19,30041,28842,1199,4
40103,8/1/19,5592,5456,136,2.4
40105,8/1/19,4592,4443,149,3.2
40107,8/1/19,4541,4332,209,4.6
40109,8/1/19,382886,370704,12182,3.2
40111,8/1/19,15727,14970,757,4.8
40113,8/1/19,20718,19953,765,3.7
40115,8/1/19,14093,13631,462,3.3
40117,8/1/19,7370,7091,279,3.8
40119,8/1/19,37447,36359,1088,2.9
40121,8/1/19,16690,15930,760,4.6
40123,8/1/19,19042,18488,554,2.9
40125,8/1/19,32094,30950,1144,3.6
40127,8/1/19,4323,4119,204,4.7
40129,8/1/19,1931,1866,65,3.4
40131,8/1/19,45112,43756,1356,3
40133,8/1/19,9331,8903,428,4.6
40135,8/1/19,16142,15485,657,4.1
40137,8/1/19,18306,17475,831,4.5
40139,8/1/19,11263,11040,223,2
40141,8/1/19,2955,2855,100,3.4
40143,8/1/19,323330,313219,10111,3.1
40145,8/1/19,37979,36801,1178,3.1
40147,8/1/19,22370,21616,754,3.4
40149,8/1/19,5301,5127,174,3.3
40151,8/1/19,4522,4417,105,2.3
40153,8/1/19,8987,8745,242,2.7
41001,8/1/19,7202,6904,298,4.1
41003,8/1/19,46439,44812,1627,3.5
41005,8/1/19,221315,213326,7989,3.6
41007,8/1/19,20046,19344,702,3.5
41009,8/1/19,24551,23396,1155,4.7
41011,8/1/19,26375,25063,1312,5
41013,8/1/19,9837,9373,464,4.7
41015,8/1/19,9321,8899,422,4.5
41017,8/1/19,97993,94469,3524,3.6
41019,8/1/19,46870,44504,2366,5
41021,8/1/19,966,934,32,3.3
41023,8/1/19,3304,3161,143,4.3
41025,8/1/19,3692,3537,155,4.2
41027,8/1/19,16439,15965,474,2.9
41029,8/1/19,104367,99699,4668,4.5
41031,8/1/19,10272,9808,464,4.5
41033,8/1/19,36275,34442,1833,5.1
41035,8/1/19,29574,27943,1631,5.5
41037,8/1/19,3831,3663,168,4.4
41039,8/1/19,179490,171686,7804,4.3
41041,8/1/19,21669,20770,899,4.1
41043,8/1/19,58418,55811,2607,4.5
41045,8/1/19,12630,12126,504,4
41047,8/1/19,164387,157604,6783,4.1
41049,8/1/19,5917,5687,230,3.9
41051,8/1/19,458074,442260,15814,3.5
41053,8/1/19,40243,38487,1756,4.4
41055,8/1/19,1000,965,35,3.5
41057,8/1/19,12318,11857,461,3.7
41059,8/1/19,37882,36263,1619,4.3
41061,8/1/19,11978,11445,533,4.4
41063,8/1/19,3665,3511,154,4.2
41065,8/1/19,13726,13194,532,3.9
41067,8/1/19,327126,316254,10872,3.3
41069,8/1/19,710,680,30,4.2
41071,8/1/19,55586,53507,2079,3.7
42001,8/1/19,55861,53846,2015,3.6
42003,8/1/19,653454,623562,29892,4.6
42005,8/1/19,32552,30829,1723,5.3
42007,8/1/19,84737,80501,4236,5
42009,8/1/19,24051,22972,1079,4.5
42011,8/1/19,217962,207542,10420,4.8
42013,8/1/19,60599,57582,3017,5
42015,8/1/19,29390,28093,1297,4.4
42017,8/1/19,348594,333755,14839,4.3
42019,8/1/19,100600,96395,4205,4.2
42021,8/1/19,57977,54471,3506,6
42023,8/1/19,2161,2043,118,5.5
42025,8/1/19,32320,30451,1869,5.8
42027,8/1/19,79777,77114,2663,3.3
42029,8/1/19,291742,281079,10663,3.7
42031,8/1/19,16969,16126,843,5
42033,8/1/19,36298,34401,1897,5.2
42035,8/1/19,18358,17403,955,5.2
42037,8/1/19,33577,31965,1612,4.8
42039,8/1/19,39083,37118,1965,5
42041,8/1/19,134874,129826,5048,3.7
42043,8/1/19,147227,140494,6733,4.6
42045,8/1/19,299505,285842,13663,4.6
42047,8/1/19,15923,15072,851,5.3
42049,8/1/19,129231,123209,6022,4.7
42051,8/1/19,57573,54041,3532,6.1
42053,8/1/19,1863,1737,126,6.8
42055,8/1/19,78733,75450,3283,4.2
42057,8/1/19,8060,7712,348,4.3
42059,8/1/19,16557,15633,924,5.6
42061,8/1/19,20277,19119,1158,5.7
42063,8/1/19,38940,36772,2168,5.6
42065,8/1/19,20852,19823,1029,4.9
42067,8/1/19,12963,12399,564,4.4
42069,8/1/19,105865,100012,5853,5.5
42071,8/1/19,290354,279104,11250,3.9
42073,8/1/19,40914,38862,2052,5
42075,8/1/19,73701,70544,3157,4.3
42077,8/1/19,193721,184059,9662,5
42079,8/1/19,158634,148683,9951,6.3
42081,8/1/19,57284,54463,2821,4.9
42083,8/1/19,17485,16549,936,5.4
42085,8/1/19,49812,47188,2624,5.3
42087,8/1/19,21526,20386,1140,5.3
42089,8/1/19,84044,79300,4744,5.6
42091,8/1/19,460562,442274,18288,4
42093,8/1/19,9138,8798,340,3.7
42095,8/1/19,162086,154137,7949,4.9
42097,8/1/19,44007,41533,2474,5.6
42099,8/1/19,25178,24151,1027,4.1
42101,8/1/19,723251,676889,46362,6.4
42103,8/1/19,25578,24048,1530,6
42105,8/1/19,7357,6954,403,5.5
42107,8/1/19,67252,63302,3950,5.9
42109,8/1/19,20049,18714,1335,6.7
42111,8/1/19,33673,31889,1784,5.3
42113,8/1/19,2763,2616,147,5.3
42115,8/1/19,21135,20282,853,4
42117,8/1/19,19382,18395,987,5.1
42119,8/1/19,20189,19360,829,4.1
42121,8/1/19,22720,21558,1162,5.1
42123,8/1/19,19097,18218,879,4.6
42125,8/1/19,107775,102723,5052,4.7
42127,8/1/19,24531,23547,984,4
42129,8/1/19,182605,173741,8864,4.9
42131,8/1/19,13685,13040,645,4.7
42133,8/1/19,238284,228005,10279,4.3
44001,8/1/19,26172,25369,803,3.1
44003,8/1/19,91422,88315,3107,3.4
44005,8/1/19,44472,43149,1323,3
44007,8/1/19,328209,314709,13500,4.1
44009,8/1/19,70193,67988,2205,3.1
45001,8/1/19,9934,9596,338,3.4
45003,8/1/19,75153,72937,2216,2.9
45005,8/1/19,2677,2526,151,5.6
45007,8/1/19,91398,88920,2478,2.7
45009,8/1/19,4987,4678,309,6.2
45011,8/1/19,8260,7885,375,4.5
45013,8/1/19,79372,77262,2110,2.7
45015,8/1/19,105149,102471,2678,2.5
45017,8/1/19,6651,6396,255,3.8
45019,8/1/19,213629,208642,4987,2.3
45021,8/1/19,25296,24505,791,3.1
45023,8/1/19,13542,12965,577,4.3
45025,8/1/19,22081,21420,661,3
45027,8/1/19,12913,12424,489,3.8
45029,8/1/19,16935,16384,551,3.3
45031,8/1/19,30715,29629,1086,3.5
45033,8/1/19,13133,12621,512,3.9
45035,8/1/19,78966,77006,1960,2.5
45037,8/1/19,10785,10478,307,2.8
45039,8/1/19,9648,9228,420,4.4
45041,8/1/19,67258,65286,1972,2.9
45043,8/1/19,26216,25313,903,3.4
45045,8/1/19,255228,249089,6139,2.4
45047,8/1/19,31100,30099,1001,3.2
45049,8/1/19,8539,8312,227,2.7
45051,8/1/19,152853,148069,4784,3.1
45053,8/1/19,12881,12558,323,2.5
45055,8/1/19,29444,28527,917,3.1
45057,8/1/19,41523,40145,1378,3.3
45059,8/1/19,30284,29362,922,3
45061,8/1/19,6690,6408,282,4.2
45063,8/1/19,150508,147016,3492,2.3
45065,8/1/19,3382,3276,106,3.1
45067,8/1/19,13138,12582,556,4.2
45069,8/1/19,9278,8866,412,4.4
45071,8/1/19,19287,18733,554,2.9
45073,8/1/19,35191,34198,993,2.8
45075,8/1/19,34494,32631,1863,5.4
45077,8/1/19,57550,55906,1644,2.9
45079,8/1/19,199311,193712,5599,2.8
45081,8/1/19,9034,8803,231,2.6
45083,8/1/19,153135,149159,3976,2.6
45085,8/1/19,43309,41818,1491,3.4
45087,8/1/19,11658,11241,417,3.6
45089,8/1/19,12127,11553,574,4.7
45091,8/1/19,141040,137097,3943,2.8
46003,8/1/19,1552,1512,40,2.6
46005,8/1/19,9719,9425,294,3
46007,8/1/19,1134,1072,62,5.5
46009,8/1/19,2915,2826,89,3.1
46011,8/1/19,18769,18138,631,3.4
46013,8/1/19,20717,20066,651,3.1
46015,8/1/19,2487,2410,77,3.1
46017,8/1/19,702,643,59,8.4
46019,8/1/19,5116,4944,172,3.4
46021,8/1/19,790,761,29,3.7
46023,8/1/19,3815,3674,141,3.7
46025,8/1/19,1898,1827,71,3.7
46027,8/1/19,6894,6640,254,3.7
46029,8/1/19,15542,15066,476,3.1
46031,8/1/19,1337,1241,96,7.2
46033,8/1/19,4115,3957,158,3.8
46035,8/1/19,11222,10906,316,2.8
46037,8/1/19,2791,2682,109,3.9
46039,8/1/19,2206,2125,81,3.7
46041,8/1/19,2262,1993,269,11.9
46043,8/1/19,1593,1551,42,2.6
46045,8/1/19,2029,1967,62,3.1
46047,8/1/19,3040,2919,121,4
46049,8/1/19,1048,1011,37,3.5
46051,8/1/19,4433,4310,123,2.8
46053,8/1/19,2004,1940,64,3.2
46055,8/1/19,1048,1018,30,2.9
46057,8/1/19,3355,3261,94,2.8
46059,8/1/19,1757,1708,49,2.8
46061,8/1/19,1746,1677,69,4
46063,8/1/19,730,708,22,3
46065,8/1/19,10086,9819,267,2.6
46067,8/1/19,3609,3500,109,3
46069,8/1/19,688,664,24,3.5
46071,8/1/19,1355,1291,64,4.7
46073,8/1/19,1127,1097,30,2.7
46075,8/1/19,593,576,17,2.9
46077,8/1/19,2644,2568,76,2.9
46079,8/1/19,6559,6310,249,3.8
46081,8/1/19,13639,13198,441,3.2
46083,8/1/19,34792,33892,900,2.6
46085,8/1/19,1788,1692,96,5.4
46087,8/1/19,3078,2996,82,2.7
46089,8/1/19,984,940,44,4.5
46091,8/1/19,2437,2350,87,3.6
46093,8/1/19,14708,14210,498,3.4
46095,8/1/19,758,708,50,6.6
46097,8/1/19,1174,1139,35,3
46099,8/1/19,113650,110479,3171,2.8
46101,8/1/19,4145,3930,215,5.2
46102,8/1/19,3790,3447,343,9.1
46103,8/1/19,59227,57287,1940,3.3
46105,8/1/19,1429,1382,47,3.3
46107,8/1/19,1078,1043,35,3.2
46109,8/1/19,4838,4640,198,4.1
46111,8/1/19,1171,1132,39,3.3
46115,8/1/19,3196,3095,101,3.2
46117,8/1/19,1849,1799,50,2.7
46119,8/1/19,799,775,24,3
46121,8/1/19,3190,2949,241,7.6
46123,8/1/19,3099,2998,101,3.3
46125,8/1/19,4707,4564,143,3
46127,8/1/19,8431,8121,310,3.7
46129,8/1/19,2192,2078,114,5.2
46135,8/1/19,11984,11639,345,2.9
46137,8/1/19,921,857,64,6.9
47001,8/1/19,34748,33531,1217,3.5
47003,8/1/19,21181,20373,808,3.8
47005,8/1/19,6930,6612,318,4.6
47007,8/1/19,4338,4123,215,5
47009,8/1/19,63779,61780,1999,3.1
47011,8/1/19,53142,51261,1881,3.5
47013,8/1/19,14872,14226,646,4.3
47015,8/1/19,6692,6472,220,3.3
47017,8/1/19,12011,11449,562,4.7
47019,8/1/19,23932,22955,977,4.1
47021,8/1/19,22137,21565,572,2.6
47023,8/1/19,8616,8301,315,3.7
47025,8/1/19,13039,12491,548,4.2
47027,8/1/19,2852,2686,166,5.8
47029,8/1/19,15353,14717,636,4.1
47031,8/1/19,25778,24899,879,3.4
47033,8/1/19,7055,6811,244,3.5
47035,8/1/19,23880,22901,979,4.1
47037,8/1/19,408879,398419,10460,2.6
47039,8/1/19,4608,4380,228,4.9
47041,8/1/19,7918,7595,323,4.1
47043,8/1/19,27391,26533,858,3.1
47045,8/1/19,16584,15764,820,4.9
47047,8/1/19,19331,18655,676,3.5
47049,8/1/19,7552,7209,343,4.5
47051,8/1/19,20214,19543,671,3.3
47053,8/1/19,22367,21427,940,4.2
47055,8/1/19,14836,14282,554,3.7
47057,8/1/19,9558,9192,366,3.8
47059,8/1/19,29959,28544,1415,4.7
47061,8/1/19,5050,4857,193,3.8
47063,8/1/19,28108,27008,1100,3.9
47065,8/1/19,184811,178621,6190,3.3
47067,8/1/19,2162,2034,128,5.9
47069,8/1/19,9577,9136,441,4.6
47071,8/1/19,10566,10133,433,4.1
47073,8/1/19,23904,22899,1005,4.2
47075,8/1/19,7825,7451,374,4.8
47077,8/1/19,12373,11878,495,4
47079,8/1/19,14408,13844,564,3.9
47081,8/1/19,11588,11227,361,3.1
47083,8/1/19,3311,3167,144,4.3
47085,8/1/19,9019,8681,338,3.7
47087,8/1/19,4690,4488,202,4.3
47089,8/1/19,24526,23634,892,3.6
47091,8/1/19,7754,7501,253,3.3
47093,8/1/19,245160,237848,7312,3
47095,8/1/19,1763,1676,87,4.9
47097,8/1/19,9873,9343,530,5.4
47099,8/1/19,19399,18622,777,4
47101,8/1/19,5252,5067,185,3.5
47103,8/1/19,17011,16478,533,3.1
47105,8/1/19,23624,22819,805,3.4
47107,8/1/19,24120,23213,907,3.8
47109,8/1/19,8720,8267,453,5.2
47111,8/1/19,11456,11097,359,3.1
47113,8/1/19,49205,47413,1792,3.6
47115,8/1/19,12558,12007,551,4.4
47117,8/1/19,15785,15259,526,3.3
47119,8/1/19,49848,48467,1381,2.8
47121,8/1/19,5248,5017,231,4.4
47123,8/1/19,20347,19617,730,3.6
47125,8/1/19,86490,83119,3371,3.9
47127,8/1/19,3619,3499,120,3.3
47129,8/1/19,7917,7601,316,4
47131,8/1/19,12536,11983,553,4.4
47133,8/1/19,10116,9759,357,3.5
47135,8/1/19,3081,2953,128,4.2
47137,8/1/19,2447,2350,97,4
47139,8/1/19,7683,7363,320,4.2
47141,8/1/19,35173,33924,1249,3.6
47143,8/1/19,13246,12521,725,5.5
47145,8/1/19,23514,22553,961,4.1
47147,8/1/19,38510,37397,1113,2.9
47149,8/1/19,186351,181415,4936,2.6
47151,8/1/19,8380,8001,379,4.5
47153,8/1/19,6237,5966,271,4.3
47155,8/1/19,56852,55404,1448,2.5
47157,8/1/19,449052,430585,18467,4.1
47159,8/1/19,9569,9290,279,2.9
47161,8/1/19,5580,5339,241,4.3
47163,8/1/19,70646,68034,2612,3.7
47165,8/1/19,103635,100783,2852,2.8
47167,8/1/19,28396,27299,1097,3.9
47169,8/1/19,5489,5327,162,3
47171,8/1/19,7082,6746,336,4.7
47173,8/1/19,7654,7354,300,3.9
47175,8/1/19,2074,1985,89,4.3
47177,8/1/19,16919,16248,671,4
47179,8/1/19,60206,58058,2148,3.6
47181,8/1/19,6268,6004,264,4.2
47183,8/1/19,16053,15384,669,4.2
47185,8/1/19,12324,11857,467,3.8
47187,8/1/19,130063,126772,3291,2.5
47189,8/1/19,77566,75474,2092,2.7
48001,8/1/19,24055,23332,723,3
48003,8/1/19,9899,9663,236,2.4
48005,8/1/19,35730,34236,1494,4.2
48007,8/1/19,9425,9015,410,4.4
48009,8/1/19,4156,4035,121,2.9
48011,8/1/19,940,914,26,2.8
48013,8/1/19,21784,20960,824,3.8
48015,8/1/19,14112,13599,513,3.6
48017,8/1/19,2573,2485,88,3.4
48019,8/1/19,10120,9756,364,3.6
48021,8/1/19,42911,41567,1344,3.1
48023,8/1/19,1802,1757,45,2.5
48025,8/1/19,9805,9337,468,4.8
48027,8/1/19,143168,137486,5682,4
48029,8/1/19,948570,916844,31726,3.3
48031,8/1/19,6496,6331,165,2.5
48033,8/1/19,414,402,12,2.9
48035,8/1/19,8450,8141,309,3.7
48037,8/1/19,39449,37584,1865,4.7
48039,8/1/19,179398,170969,8429,4.7
48041,8/1/19,114786,111348,3438,3
48043,8/1/19,4213,4084,129,3.1
48045,8/1/19,593,574,19,3.2
48047,8/1/19,2578,2445,133,5.2
48049,8/1/19,15792,15142,650,4.1
48051,8/1/19,8106,7840,266,3.3
48053,8/1/19,23599,22909,690,2.9
48055,8/1/19,19670,18984,686,3.5
48057,8/1/19,12155,11737,418,3.4
48059,8/1/19,6124,5916,208,3.4
48061,8/1/19,167322,157828,9494,5.7
48063,8/1/19,5015,4791,224,4.5
48065,8/1/19,3035,2962,73,2.4
48067,8/1/19,12472,11910,562,4.5
48069,8/1/19,3501,3402,99,2.8
48071,8/1/19,19440,18483,957,4.9
48073,8/1/19,20961,20115,846,4
48075,8/1/19,3034,2952,82,2.7
48077,8/1/19,4962,4804,158,3.2
48079,8/1/19,1167,1126,41,3.5
48081,8/1/19,1508,1457,51,3.4
48083,8/1/19,2922,2792,130,4.4
48085,8/1/19,565015,546555,18460,3.3
48087,8/1/19,1182,1143,39,3.3
48089,8/1/19,10038,9718,320,3.2
48091,8/1/19,73358,70965,2393,3.3
48093,8/1/19,5697,5504,193,3.4
48095,8/1/19,1406,1359,47,3.3
48097,8/1/19,19668,19097,571,2.9
48099,8/1/19,24036,23037,999,4.2
48101,8/1/19,551,531,20,3.6
48103,8/1/19,1589,1522,67,4.2
48105,8/1/19,1662,1609,53,3.2
48107,8/1/19,2579,2469,110,4.3
48109,8/1/19,1079,1031,48,4.4
48111,8/1/19,4017,3941,76,1.9
48113,8/1/19,1367878,1317877,50001,3.7
48115,8/1/19,4643,4454,189,4.1
48117,8/1/19,8666,8419,247,2.9
48119,8/1/19,2450,2358,92,3.8
48121,8/1/19,495743,480216,15527,3.1
48123,8/1/19,9926,9658,268,2.7
48125,8/1/19,706,674,32,4.5
48127,8/1/19,7241,7042,199,2.7
48129,8/1/19,1412,1353,59,4.2
48131,8/1/19,4942,4704,238,4.8
48133,8/1/19,8185,7885,300,3.7
48135,8/1/19,87710,85163,2547,2.9
48137,8/1/19,1136,1114,22,1.9
48139,8/1/19,92939,89920,3019,3.2
48141,8/1/19,360767,346238,14529,4
48143,8/1/19,20719,20004,715,3.5
48145,8/1/19,6632,6415,217,3.3
48147,8/1/19,17468,16974,494,2.8
48149,8/1/19,12232,11881,351,2.9
48151,8/1/19,1679,1620,59,3.5
48153,8/1/19,2662,2544,118,4.4
48155,8/1/19,606,587,19,3.1
48157,8/1/19,390701,376254,14447,3.7
48159,8/1/19,4697,4514,183,3.9
48161,8/1/19,6511,6199,312,4.8
48163,8/1/19,10534,10259,275,2.6
48165,8/1/19,10002,9743,259,2.6
48167,8/1/19,165085,157895,7190,4.4
48169,8/1/19,2202,2142,60,2.7
48171,8/1/19,13580,13241,339,2.5
48173,8/1/19,827,808,19,2.3
48175,8/1/19,3268,3155,113,3.5
48177,8/1/19,9677,9398,279,2.9
48179,8/1/19,8174,7874,300,3.7
48181,8/1/19,64139,62027,2112,3.3
48183,8/1/19,58311,56013,2298,3.9
48185,8/1/19,11207,10723,484,4.3
48187,8/1/19,81484,78890,2594,3.2
48189,8/1/19,12200,11648,552,4.5
48191,8/1/19,1091,1047,44,4
48193,8/1/19,3718,3594,124,3.3
48195,8/1/19,2809,2742,67,2.4
48197,8/1/19,1747,1691,56,3.2
48199,8/1/19,25104,23862,1242,4.9
48201,8/1/19,2308787,2214712,94075,4.1
48203,8/1/19,29320,28081,1239,4.2
48205,8/1/19,2866,2816,50,1.7
48207,8/1/19,2328,2249,79,3.4
48209,8/1/19,119765,116237,3528,2.9
48211,8/1/19,1941,1884,57,2.9
48213,8/1/19,36485,35136,1349,3.7
48215,8/1/19,351616,328460,23156,6.6
48217,8/1/19,16564,15983,581,3.5
48219,8/1/19,11294,10940,354,3.1
48221,8/1/19,27635,26627,1008,3.6
48223,8/1/19,17607,17044,563,3.2
48225,8/1/19,10590,10226,364,3.4
48227,8/1/19,14115,13648,467,3.3
48229,8/1/19,1865,1777,88,4.7
48231,8/1/19,43580,41944,1636,3.8
48233,8/1/19,8710,8265,445,5.1
48235,8/1/19,771,752,19,2.5
48237,8/1/19,3530,3416,114,3.2
48239,8/1/19,7733,7502,231,3
48241,8/1/19,12842,12007,835,6.5
48243,8/1/19,1071,1037,34,3.2
48245,8/1/19,106426,99534,6892,6.5
48247,8/1/19,1854,1763,91,4.9
48249,8/1/19,16715,15888,827,4.9
48251,8/1/19,82196,79383,2813,3.4
48253,8/1/19,5793,5525,268,4.6
48255,8/1/19,7181,6995,186,2.6
48257,8/1/19,64765,62530,2235,3.5
48259,8/1/19,22222,21583,639,2.9
48261,8/1/19,215,206,9,4.2
48263,8/1/19,502,492,10,2
48265,8/1/19,22206,21497,709,3.2
48267,8/1/19,1945,1884,61,3.1
48269,8/1/19,250,244,6,2.4
48271,8/1/19,1423,1378,45,3.2
48273,8/1/19,13455,12817,638,4.7
48275,8/1/19,1490,1439,51,3.4
48277,8/1/19,24235,23403,832,3.4
48279,8/1/19,5432,5224,208,3.8
48281,8/1/19,9202,8885,317,3.4
48283,8/1/19,4423,4305,118,2.7
48285,8/1/19,8671,8396,275,3.2
48287,8/1/19,10144,9866,278,2.7
48289,8/1/19,6415,6114,301,4.7
48291,8/1/19,33067,31301,1766,5.3
48293,8/1/19,8638,8290,348,4
48295,8/1/19,1623,1576,47,2.9
48297,8/1/19,5687,5509,178,3.1
48299,8/1/19,8951,8623,328,3.7
48301,8/1/19,599,595,4,0.7
48303,8/1/19,158118,153394,4724,3
48305,8/1/19,2841,2755,86,3
48307,8/1/19,3433,3221,212,6.2
48309,8/1/19,120020,115699,4321,3.6
48311,8/1/19,894,878,16,1.8
48313,8/1/19,4585,4357,228,5
48315,8/1/19,4239,4053,186,4.4
48317,8/1/19,2938,2856,82,2.8
48319,8/1/19,1809,1752,57,3.2
48321,8/1/19,16722,15669,1053,6.3
48323,8/1/19,23059,21464,1595,6.9
48325,8/1/19,21896,21187,709,3.2
48327,8/1/19,887,855,32,3.6
48329,8/1/19,107772,105352,2420,2.2
48331,8/1/19,9816,9345,471,4.8
48333,8/1/19,1963,1903,60,3.1
48335,8/1/19,2339,2253,86,3.7
48337,8/1/19,9323,9042,281,3
48339,8/1/19,283152,272818,10334,3.6
48341,8/1/19,11063,10782,281,2.5
48343,8/1/19,4871,4596,275,5.6
48345,8/1/19,502,484,18,3.6
48347,8/1/19,27962,26790,1172,4.2
48349,8/1/19,24276,23473,803,3.3
48351,8/1/19,5167,4812,355,6.9
48353,8/1/19,7217,6992,225,3.1
48355,8/1/19,167056,159883,7173,4.3
48357,8/1/19,4296,4179,117,2.7
48359,8/1/19,932,903,29,3.1
48361,8/1/19,36124,34082,2042,5.7
48363,8/1/19,13575,13126,449,3.3
48365,8/1/19,10047,9620,427,4.3
48367,8/1/19,67381,65317,2064,3.1
48369,8/1/19,5042,4926,116,2.3
48371,8/1/19,6434,6220,214,3.3
48373,8/1/19,17968,17087,881,4.9
48375,8/1/19,55038,53432,1606,2.9
48377,8/1/19,3146,2941,205,6.5
48379,8/1/19,5961,5766,195,3.3
48381,8/1/19,71989,70096,1893,2.6
48383,8/1/19,1930,1879,51,2.6
48385,8/1/19,1136,1094,42,3.7
48387,8/1/19,5184,4918,266,5.1
48389,8/1/19,11358,11150,208,1.8
48391,8/1/19,3169,3048,121,3.8
48393,8/1/19,434,421,13,3
48395,8/1/19,7453,7168,285,3.8
48397,8/1/19,52223,50508,1715,3.3
48399,8/1/19,4646,4511,135,2.9
48401,8/1/19,23106,22239,867,3.8
48403,8/1/19,3783,3534,249,6.6
48405,8/1/19,3451,3289,162,4.7
48407,8/1/19,11663,11088,575,4.9
48409,8/1/19,29958,28222,1736,5.8
48411,8/1/19,2520,2444,76,3
48413,8/1/19,1304,1262,42,3.2
48415,8/1/19,6750,6528,222,3.3
48417,8/1/19,2000,1953,47,2.4
48419,8/1/19,11308,10840,468,4.1
48421,8/1/19,1404,1369,35,2.5
48423,8/1/19,107003,103185,3818,3.6
48425,8/1/19,4363,4202,161,3.7
48427,8/1/19,24796,22322,2474,10
48429,8/1/19,4045,3907,138,3.4
48431,8/1/19,619,600,19,3.1
48433,8/1/19,623,604,19,3
48435,8/1/19,1346,1287,59,4.4
48437,8/1/19,2673,2569,104,3.9
48439,8/1/19,1081348,1043832,37516,3.5
48441,8/1/19,66795,64751,2044,3.1
48443,8/1/19,376,361,15,4
48445,8/1/19,5070,4883,187,3.7
48447,8/1/19,682,651,31,4.5
48449,8/1/19,12989,12427,562,4.3
48451,8/1/19,54383,52639,1744,3.2
48453,8/1/19,739901,719674,20227,2.7
48455,8/1/19,5385,5125,260,4.8
48457,8/1/19,7265,6825,440,6.1
48459,8/1/19,17947,17243,704,3.9
48461,8/1/19,1729,1676,53,3.1
48463,8/1/19,11671,11215,456,3.9
48465,8/1/19,22836,22081,755,3.3
48467,8/1/19,26285,25374,911,3.5
48469,8/1/19,42647,41121,1526,3.6
48471,8/1/19,24100,23054,1046,4.3
48473,8/1/19,23479,22544,935,4
48475,8/1/19,7450,7263,187,2.5
48477,8/1/19,15220,14692,528,3.5
48479,8/1/19,118413,113959,4454,3.8
48481,8/1/19,21803,21016,787,3.6
48483,8/1/19,2343,2271,72,3.1
48485,8/1/19,56131,54251,1880,3.3
48487,8/1/19,4936,4749,187,3.8
48489,8/1/19,6551,6004,547,8.3
48491,8/1/19,313384,304103,9281,3
48493,8/1/19,24887,24154,733,2.9
48495,8/1/19,3992,3872,120,3
48497,8/1/19,31964,30880,1084,3.4
48499,8/1/19,17807,17090,717,4
48501,8/1/19,3766,3652,114,3
48503,8/1/19,8061,7805,256,3.2
48505,8/1/19,4812,4569,243,5
48507,8/1/19,3347,3041,306,9.1
49001,8/1/19,2787,2698,89,3.2
49003,8/1/19,26006,25327,679,2.6
49005,8/1/19,61194,59742,1452,2.4
49007,8/1/19,8588,8289,299,3.5
49009,8/1/19,434,421,13,3
49011,8/1/19,175542,171161,4381,2.5
49013,8/1/19,7701,7401,300,3.9
49015,8/1/19,4236,4076,160,3.8
49017,8/1/19,3112,3010,102,3.3
49019,8/1/19,6778,6633,145,2.1
49021,8/1/19,23466,22751,715,3
49023,8/1/19,5678,5543,135,2.4
49025,8/1/19,4176,4077,99,2.4
49027,8/1/19,5997,5836,161,2.7
49029,8/1/19,5613,5472,141,2.5
49031,8/1/19,463,441,22,4.8
49033,8/1/19,1529,1499,30,2
49035,8/1/19,641093,624581,16512,2.6
49037,8/1/19,5900,5648,252,4.3
49039,8/1/19,12149,11758,391,3.2
49041,8/1/19,9744,9473,271,2.8
49043,8/1/19,24793,24206,587,2.4
49045,8/1/19,34298,33284,1014,3
49047,8/1/19,13828,13268,560,4
49049,8/1/19,306532,298885,7647,2.5
49051,8/1/19,16509,16071,438,2.7
49053,8/1/19,77311,74913,2398,3.1
49055,8/1/19,1510,1460,50,3.3
49057,8/1/19,128434,124755,3679,2.9
50001,8/1/19,20899,20439,460,2.2
50003,8/1/19,18002,17494,508,2.8
50005,8/1/19,14580,14176,404,2.8
50007,8/1/19,97787,95943,1844,1.9
50009,8/1/19,2716,2633,83,3.1
50011,8/1/19,27444,26769,675,2.5
50013,8/1/19,4077,3975,102,2.5
50015,8/1/19,13917,13574,343,2.5
50017,8/1/19,16056,15736,320,2
50019,8/1/19,12943,12441,502,3.9
50021,8/1/19,30734,29899,835,2.7
50023,8/1/19,34517,33848,669,1.9
50025,8/1/19,21821,21278,543,2.5
50027,8/1/19,28873,28250,623,2.2
51001,8/1/19,17105,16545,560,3.3
51003,8/1/19,56785,55231,1554,2.7
51005,8/1/19,6833,6591,242,3.5
51007,8/1/19,6354,6152,202,3.2
51009,8/1/19,15151,14629,522,3.4
51011,8/1/19,7222,6959,263,3.6
51013,8/1/19,156045,152907,3138,2
51015,8/1/19,37609,36646,963,2.6
51017,8/1/19,2571,2505,66,2.6
51019,8/1/19,38719,37541,1178,3
51021,8/1/19,2803,2728,75,2.7
51023,8/1/19,17605,17123,482,2.7
51025,8/1/19,6004,5713,291,4.8
51027,8/1/19,6650,6226,424,6.4
51029,8/1/19,6367,6107,260,4.1
51031,8/1/19,26159,25292,867,3.3
51033,8/1/19,15415,14888,527,3.4
51035,8/1/19,13184,12717,467,3.5
51036,8/1/19,3704,3580,124,3.3
51037,8/1/19,5283,5089,194,3.7
51041,8/1/19,189326,183737,5589,3
51043,8/1/19,7716,7522,194,2.5
51045,8/1/19,2327,2250,77,3.3
51047,8/1/19,24938,24267,671,2.7
51049,8/1/19,4676,4524,152,3.3
51051,8/1/19,4684,4456,228,4.9
51053,8/1/19,13819,13349,470,3.4
51057,8/1/19,5520,5321,199,3.6
51059,8/1/19,642476,626970,15506,2.4
51061,8/1/19,37789,36837,952,2.5
51063,8/1/19,8254,8047,207,2.5
51065,8/1/19,13783,13427,356,2.6
51067,8/1/19,26675,25890,785,2.9
51069,8/1/19,48785,47562,1223,2.5
51071,8/1/19,7891,7650,241,3.1
51073,8/1/19,19881,19354,527,2.7
51075,8/1/19,11336,11009,327,2.9
51077,8/1/19,7808,7570,238,3
51079,8/1/19,10415,10145,270,2.6
51081,8/1/19,4305,4151,154,3.6
51083,8/1/19,15690,15017,673,4.3
51085,8/1/19,59839,58285,1554,2.6
51087,8/1/19,183788,178236,5552,3
51089,8/1/19,24065,23243,822,3.4
51091,8/1/19,1292,1258,34,2.6
51093,8/1/19,19763,19179,584,3
51095,8/1/19,37150,36100,1050,2.8
51097,8/1/19,3851,3737,114,3
51099,8/1/19,13608,13245,363,2.7
51101,8/1/19,9254,8992,262,2.8
51103,8/1/19,5522,5336,186,3.4
51105,8/1/19,8307,7888,419,5
51107,8/1/19,225159,219666,5493,2.4
51109,8/1/19,20077,19517,560,2.8
51111,8/1/19,5306,5115,191,3.6
51113,8/1/19,7438,7261,177,2.4
51115,8/1/19,4203,4078,125,3
51117,8/1/19,12387,11856,531,4.3
51119,8/1/19,5450,5307,143,2.6
51121,8/1/19,50206,48695,1511,3
51125,8/1/19,7429,7209,220,3
51127,8/1/19,12604,12286,318,2.5
51131,8/1/19,5779,5543,236,4.1
51133,8/1/19,5745,5544,201,3.5
51135,8/1/19,7242,7038,204,2.8
51137,8/1/19,17592,17029,563,3.2
51139,8/1/19,12066,11682,384,3.2
51141,8/1/19,7239,6981,258,3.6
51143,8/1/19,30025,28958,1067,3.6
51145,8/1/19,14289,13896,393,2.8
51147,8/1/19,10465,10049,416,4
51149,8/1/19,15248,14694,554,3.6
51153,8/1/19,248340,241733,6607,2.7
51155,8/1/19,16064,15520,544,3.4
51157,8/1/19,3761,3661,100,2.7
51159,8/1/19,4124,4002,122,3
51161,8/1/19,49824,48488,1336,2.7
51163,8/1/19,11006,10698,308,2.8
51165,8/1/19,41216,40158,1058,2.6
51167,8/1/19,11083,10592,491,4.4
51169,8/1/19,9192,8895,297,3.2
51171,8/1/19,22621,22035,586,2.6
51173,8/1/19,13961,13425,536,3.8
51175,8/1/19,9260,8977,283,3.1
51177,8/1/19,67867,65785,2082,3.1
51179,8/1/19,72837,70753,2084,2.9
51181,8/1/19,3733,3584,149,4
51183,8/1/19,3883,3708,175,4.5
51185,8/1/19,15365,14668,697,4.5
51187,8/1/19,20684,20074,610,2.9
51191,8/1/19,26894,25989,905,3.4
51193,8/1/19,9657,9328,329,3.4
51195,8/1/19,13331,12654,677,5.1
51197,8/1/19,13840,13379,461,3.3
51199,8/1/19,33210,32306,904,2.7
51510,8/1/19,102455,100169,2286,2.2
51520,8/1/19,7240,6957,283,3.9
51530,8/1/19,3437,3341,96,2.8
51540,8/1/19,26169,25469,700,2.7
51550,8/1/19,124559,120700,3859,3.1
51570,8/1/19,8883,8588,295,3.3
51580,8/1/19,2374,2262,112,4.7
51590,8/1/19,19164,18148,1016,5.3
51595,8/1/19,2312,2190,122,5.3
51600,8/1/19,13587,13296,291,2.1
51610,8/1/19,8699,8506,193,2.2
51620,8/1/19,3644,3492,152,4.2
51630,8/1/19,14313,13807,506,3.5
51640,8/1/19,2919,2818,101,3.5
51650,8/1/19,65303,62728,2575,3.9
51660,8/1/19,24486,23614,872,3.6
51670,8/1/19,9773,9333,440,4.5
51678,8/1/19,2074,1971,103,5
51680,8/1/19,36582,35129,1453,4
51683,8/1/19,22290,21711,579,2.6
51685,8/1/19,9469,9239,230,2.4
51690,8/1/19,5559,5301,258,4.6
51700,8/1/19,90065,86811,3254,3.6
51710,8/1/19,113288,109114,4174,3.7
51720,8/1/19,1681,1617,64,3.8
51730,8/1/19,13154,12388,766,5.8
51735,8/1/19,6490,6326,164,2.5
51740,8/1/19,44907,43082,1825,4.1
51750,8/1/19,8675,8327,348,4
51760,8/1/19,119539,115300,4239,3.5
51770,8/1/19,49683,48031,1652,3.3
51775,8/1/19,13099,12707,392,3
51790,8/1/19,12245,11892,353,2.9
51800,8/1/19,45305,43839,1466,3.2
51810,8/1/19,236402,229663,6739,2.9
51820,8/1/19,10695,10361,334,3.1
51830,8/1/19,6801,6512,289,4.2
51840,8/1/19,15004,14585,419,2.8
53001,8/1/19,11034,10588,446,4
53003,8/1/19,10279,9881,398,3.9
53005,8/1/19,104121,99190,4931,4.7
53007,8/1/19,47696,45644,2052,4.3
53009,8/1/19,28959,27197,1762,6.1
53011,8/1/19,240864,229108,11756,4.9
53013,8/1/19,1852,1765,87,4.7
53015,8/1/19,47709,44864,2845,6
53017,8/1/19,22419,21220,1199,5.3
53019,8/1/19,2495,2254,241,9.7
53021,8/1/19,45219,42870,2349,5.2
53023,8/1/19,965,923,42,4.4
53025,8/1/19,49109,46309,2800,5.7
53027,8/1/19,28896,27014,1882,6.5
53029,8/1/19,36015,34185,1830,5.1
53031,8/1/19,13091,12390,701,5.4
53033,8/1/19,1297538,1261969,35569,2.7
53035,8/1/19,128041,122293,5748,4.5
53037,8/1/19,21585,20438,1147,5.3
53039,8/1/19,10832,10288,544,5
53041,8/1/19,35169,33107,2062,5.9
53043,8/1/19,5218,4996,222,4.3
53045,8/1/19,24984,23505,1479,5.9
53047,8/1/19,21803,20630,1173,5.4
53049,8/1/19,8950,8406,544,6.1
53051,8/1/19,5059,4633,426,8.4
53053,8/1/19,440461,418147,22314,5.1
53055,8/1/19,9714,9427,287,3
53057,8/1/19,63724,60373,3351,5.3
53059,8/1/19,5545,5239,306,5.5
53061,8/1/19,442018,428834,13184,3
53063,8/1/19,251787,239196,12591,5
53065,8/1/19,18751,17613,1138,6.1
53067,8/1/19,141325,134594,6731,4.8
53069,8/1/19,1366,1286,80,5.9
53071,8/1/19,30254,28837,1417,4.7
53073,8/1/19,114378,108647,5731,5
53075,8/1/19,24190,23110,1080,4.5
53077,8/1/19,137152,128750,8402,6.1
54001,8/1/19,6931,6535,396,5.7
54003,8/1/19,58730,56551,2179,3.7
54005,8/1/19,7533,7126,407,5.4
54007,8/1/19,5254,4927,327,6.2
54009,8/1/19,10138,9639,499,4.9
54011,8/1/19,41907,40106,1801,4.3
54013,8/1/19,2425,2168,257,10.6
54015,8/1/19,3154,2926,228,7.2
54017,8/1/19,4072,3903,169,4.2
54019,8/1/19,16452,15567,885,5.4
54021,8/1/19,2320,2185,135,5.8
54023,8/1/19,6089,5772,317,5.2
54025,8/1/19,16837,16152,685,4.1
54027,8/1/19,11041,10618,423,3.8
54029,8/1/19,13255,12589,666,5
54031,8/1/19,5785,5515,270,4.7
54033,8/1/19,34848,33352,1496,4.3
54035,8/1/19,13908,13275,633,4.6
54037,8/1/19,30612,29579,1033,3.4
54039,8/1/19,83468,79641,3827,4.6
54041,8/1/19,6936,6536,400,5.8
54043,8/1/19,7220,6793,427,5.9
54045,8/1/19,11151,10486,665,6
54047,8/1/19,4449,4065,384,8.6
54049,8/1/19,25481,24208,1273,5
54051,8/1/19,14213,13417,796,5.6
54053,8/1/19,10039,9374,665,6.6
54055,8/1/19,20585,19358,1227,6
54057,8/1/19,12828,11963,865,6.7
54059,8/1/19,6878,6388,490,7.1
54061,8/1/19,54997,52939,2058,3.7
54063,8/1/19,6057,5808,249,4.1
54065,8/1/19,8389,8069,320,3.8
54067,8/1/19,9595,9050,545,5.7
54069,8/1/19,21377,20478,899,4.2
54071,8/1/19,3729,3599,130,3.5
54073,8/1/19,2840,2665,175,6.2
54075,8/1/19,3859,3690,169,4.4
54077,8/1/19,15755,15081,674,4.3
54079,8/1/19,26914,25786,1128,4.2
54081,8/1/19,30862,29449,1413,4.6
54083,8/1/19,12417,11757,660,5.3
54085,8/1/19,4399,4198,201,4.6
54087,8/1/19,5090,4714,376,7.4
54089,8/1/19,4447,4219,228,5.1
54091,8/1/19,7946,7563,383,4.8
54093,8/1/19,3393,3243,150,4.4
54095,8/1/19,3125,2895,230,7.4
54097,8/1/19,9620,9053,567,5.9
54099,8/1/19,15888,15061,827,5.2
54101,8/1/19,3392,3202,190,5.6
54103,8/1/19,6615,6173,442,6.7
54105,8/1/19,2305,2148,157,6.8
54107,8/1/19,36998,35175,1823,4.9
54109,8/1/19,6633,6198,435,6.6
55001,8/1/19,8278,7900,378,4.6
55003,8/1/19,8290,7888,402,4.8
55005,8/1/19,24252,23457,795,3.3
55007,8/1/19,7891,7501,390,4.9
55009,8/1/19,142281,137667,4614,3.2
55011,8/1/19,6363,6117,246,3.9
55013,8/1/19,7183,6843,340,4.7
55015,8/1/19,27731,26900,831,3
55017,8/1/19,32826,31769,1057,3.2
55019,8/1/19,17418,16886,532,3.1
55021,8/1/19,31632,30676,956,3
55023,8/1/19,7544,7262,282,3.7
55025,8/1/19,323442,315396,8046,2.5
55027,8/1/19,47892,46464,1428,3
55029,8/1/19,16988,16540,448,2.6
55031,8/1/19,22810,21861,949,4.2
55033,8/1/19,22795,22010,785,3.4
55035,8/1/19,58834,56910,1924,3.3
55037,8/1/19,2222,2128,94,4.2
55039,8/1/19,57481,55591,1890,3.3
55041,8/1/19,3982,3794,188,4.7
55043,8/1/19,26529,25674,855,3.2
55045,8/1/19,21015,20451,564,2.7
55047,8/1/19,9610,9263,347,3.6
55049,8/1/19,13659,13319,340,2.5
55051,8/1/19,2563,2411,152,5.9
55053,8/1/19,10318,9981,337,3.3
55055,8/1/19,46117,44708,1409,3.1
55057,8/1/19,13452,13040,412,3.1
55059,8/1/19,90588,86692,3896,4.3
55061,8/1/19,10979,10635,344,3.1
55063,8/1/19,65628,63733,1895,2.9
55065,8/1/19,9855,9585,270,2.7
55067,8/1/19,9241,8897,344,3.7
55069,8/1/19,15274,14662,612,4
55071,8/1/19,40964,39642,1322,3.2
55073,8/1/19,73651,71496,2155,2.9
55075,8/1/19,19533,18587,946,4.8
55077,8/1/19,7728,7473,255,3.3
55078,8/1/19,1719,1483,236,13.7
55079,8/1/19,471633,450677,20956,4.4
55081,8/1/19,23431,22778,653,2.8
55083,8/1/19,20522,19833,689,3.4
55085,8/1/19,18664,17958,706,3.8
55087,8/1/19,103788,100698,3090,3
55089,8/1/19,49457,47935,1522,3.1
55091,8/1/19,4145,4017,128,3.1
55093,8/1/19,25400,24653,747,2.9
55095,8/1/19,24315,23559,756,3.1
55097,8/1/19,37707,36537,1170,3.1
55099,8/1/19,6512,6259,253,3.9
55101,8/1/19,99792,95424,4368,4.4
55103,8/1/19,9169,8882,287,3.1
55105,8/1/19,86236,82804,3432,4
55107,8/1/19,6616,6332,284,4.3
55109,8/1/19,50656,49151,1505,3
55111,8/1/19,36538,35587,951,2.6
55113,8/1/19,8378,8022,356,4.2
55115,8/1/19,20867,20234,633,3
55117,8/1/19,63409,61651,1758,2.8
55119,8/1/19,10875,10572,303,2.8
55121,8/1/19,15712,15230,482,3.1
55123,8/1/19,14901,14492,409,2.7
55125,8/1/19,11244,10880,364,3.2
55127,8/1/19,57374,55462,1912,3.3
55129,8/1/19,8093,7794,299,3.7
55131,8/1/19,77591,75286,2305,3
55133,8/1/19,226414,219457,6957,3.1
55135,8/1/19,26030,25233,797,3.1
55137,8/1/19,11284,10855,429,3.8
55139,8/1/19,91648,88609,3039,3.3
55141,8/1/19,35118,33781,1337,3.8
56001,8/1/19,19023,18440,583,3.1
56003,8/1/19,5451,5250,201,3.7
56005,8/1/19,23407,22405,1002,4.3
56007,8/1/19,8495,8282,213,2.5
56009,8/1/19,9045,8824,221,2.4
56011,8/1/19,3802,3690,112,2.9
56013,8/1/19,18580,17845,735,4
56015,8/1/19,6610,6370,240,3.6
56017,8/1/19,2196,2122,74,3.4
56019,8/1/19,4275,4150,125,2.9
56021,8/1/19,48570,46925,1645,3.4
56023,8/1/19,9037,8783,254,2.8
56025,8/1/19,39398,37952,1446,3.7
56027,8/1/19,1223,1194,29,2.4
56029,8/1/19,16759,16230,529,3.2
56031,8/1/19,4503,4335,168,3.7
56033,8/1/19,15747,15278,469,3
56035,8/1/19,4249,4086,163,3.8
56037,8/1/19,21289,20562,727,3.4
56039,8/1/19,17714,17385,329,1.9
56041,8/1/19,9127,8802,325,3.6
56043,8/1/19,3891,3758,133,3.4
56045,8/1/19,3749,3649,100,2.7
72001,8/1/19,4044,3565,479,11.8
72003,8/1/19,11598,10695,903,7.8
72005,8/1/19,14286,13066,1220,8.5
72007,8/1/19,6471,5955,516,8
72009,8/1/19,6430,5864,566,8.8
72011,8/1/19,8718,8090,628,7.2
72013,8/1/19,23664,21763,1901,8
72015,8/1/19,4509,4002,507,11.2
72017,8/1/19,5833,5266,567,9.7
72019,8/1/19,7322,6753,569,7.8
72021,8/1/19,64733,61194,3539,5.5
72023,8/1/19,13357,12351,1006,7.5
72025,8/1/19,47233,44565,2668,5.6
72027,8/1/19,9443,8735,708,7.5
72029,8/1/19,15923,15002,921,5.8
72031,8/1/19,60963,57901,3062,5
72033,8/1/19,7753,7267,486,6.3
72035,8/1/19,15959,14988,971,6.1
72037,8/1/19,3657,3335,322,8.8
72039,8/1/19,3692,3311,381,10.3
72041,8/1/19,15330,14460,870,5.7
72043,8/1/19,9777,8718,1059,10.8
72045,8/1/19,4845,4477,368,7.6
72047,8/1/19,8870,8155,715,8.1
72049,8/1/19,913,889,24,2.6
72051,8/1/19,13077,12443,634,4.8
72053,8/1/19,10793,9818,975,9
72054,8/1/19,3257,2973,284,8.7
72055,8/1/19,3917,3386,531,13.6
72057,8/1/19,10777,9670,1107,10.3
72059,8/1/19,5148,4523,625,12.1
72061,8/1/19,37380,36024,1356,3.6
72063,8/1/19,17939,17053,886,4.9
72065,8/1/19,13080,11978,1102,8.4
72067,8/1/19,5293,4901,392,7.4
72069,8/1/19,16889,15492,1397,8.3
72071,8/1/19,12183,11264,919,7.5
72073,8/1/19,4172,3667,505,12.1
72075,8/1/19,14779,13484,1295,8.8
72077,8/1/19,12170,11271,899,7.4
72079,8/1/19,5115,4531,584,11.4
72081,8/1/19,6850,6082,768,11.2
72083,8/1/19,2615,2387,228,8.7
72085,8/1/19,11165,10303,862,7.7
72087,8/1/19,8330,7790,540,6.5
72089,8/1/19,6111,5608,503,8.2
72091,8/1/19,11360,10559,801,7.1
72093,8/1/19,1856,1670,186,10
72095,8/1/19,2839,2509,330,11.6
72097,8/1/19,21462,19487,1975,9.2
72099,8/1/19,10276,9412,864,8.4
72101,8/1/19,7892,7267,625,7.9
72103,8/1/19,8028,7431,597,7.4
72105,8/1/19,7034,6483,551,7.8
72107,8/1/19,4900,4458,442,9
72109,8/1/19,4120,3621,499,12.1
72111,8/1/19,5768,5051,717,12.4
72113,8/1/19,44773,40985,3788,8.5
72115,8/1/19,5904,5364,540,9.1
72117,8/1/19,4509,4107,402,8.9
72119,8/1/19,16741,15707,1034,6.2
72121,8/1/19,6047,5345,702,11.6
72123,8/1/19,6994,6089,905,12.9
72125,8/1/19,9511,8601,910,9.6
72127,8/1/19,132913,126543,6370,4.8
72129,8/1/19,11551,10687,864,7.5
72131,8/1/19,10011,8988,1023,10.2
72133,8/1/19,7750,6882,868,11.2
72135,8/1/19,26871,25567,1304,4.9
72137,8/1/19,28950,27522,1428,4.9
72139,8/1/19,26862,25742,1120,4.2
72141,8/1/19,6596,5951,645,9.8
72143,8/1/19,9632,8948,684,7.1
72145,8/1/19,13088,12014,1074,8.2
72147,8/1/19,2562,2427,135,5.3
72149,8/1/19,7200,6297,903,12.5
72151,8/1/19,8645,7691,954,11
72153,8/1/19,9598,8430,1168,12.2
1001,9/1/19,26010,25391,619,2.4
1003,9/1/19,96754,94510,2244,2.3
1005,9/1/19,8656,8376,280,3.2
1007,9/1/19,8655,8430,225,2.6
1009,9/1/19,25351,24763,588,2.3
1011,9/1/19,4951,4783,168,3.4
1013,9/1/19,9297,8999,298,3.2
1015,9/1/19,45820,44455,1365,3
1017,9/1/19,15763,15369,394,2.5
1019,9/1/19,11472,11194,278,2.4
1021,9/1/19,19885,19418,467,2.3
1023,9/1/19,4547,4349,198,4.4
1025,9/1/19,7456,7063,393,5.3
1027,9/1/19,6154,6008,146,2.4
1029,9/1/19,5811,5667,144,2.5
1031,9/1/19,21386,20849,537,2.5
1033,9/1/19,23668,22913,755,3.2
1035,9/1/19,4548,4389,159,3.5
1037,9/1/19,4562,4449,113,2.5
1039,9/1/19,15799,15353,446,2.8
1041,9/1/19,6597,6449,148,2.2
1043,9/1/19,38902,38037,865,2.2
1045,9/1/19,20774,20240,534,2.6
1047,9/1/19,14742,13981,761,5.2
1049,9/1/19,31301,30577,724,2.3
1051,9/1/19,37250,36408,842,2.3
1053,9/1/19,14819,14365,454,3.1
1055,9/1/19,42423,41196,1227,2.9
1057,9/1/19,6619,6435,184,2.8
1059,9/1/19,14759,14413,346,2.3
1061,9/1/19,11203,10939,264,2.4
1063,9/1/19,2886,2744,142,4.9
1065,9/1/19,6312,6097,215,3.4
1067,9/1/19,6957,6753,204,2.9
1069,9/1/19,46108,44951,1157,2.5
1071,9/1/19,23340,22692,648,2.8
1073,9/1/19,316826,308951,7875,2.5
1075,9/1/19,5887,5736,151,2.6
1077,9/1/19,42590,41381,1209,2.8
1079,9/1/19,14333,13967,366,2.6
1081,9/1/19,76841,75093,1748,2.3
1083,9/1/19,43818,42867,951,2.2
1085,9/1/19,3586,3404,182,5.1
1087,9/1/19,7882,7597,285,3.6
1089,9/1/19,184550,180634,3916,2.1
1091,9/1/19,7710,7470,240,3.1
1093,9/1/19,12936,12547,389,3
1095,9/1/19,44210,43292,918,2.1
1097,9/1/19,188658,182592,6066,3.2
1099,9/1/19,7394,7083,311,4.2
1101,9/1/19,104877,102046,2831,2.7
1103,9/1/19,58212,56959,1253,2.2
1105,9/1/19,3500,3335,165,4.7
1107,9/1/19,8047,7815,232,2.9
1109,9/1/19,15557,15113,444,2.9
1111,9/1/19,9786,9528,258,2.6
1113,9/1/19,23626,23035,591,2.5
1115,9/1/19,40335,39401,934,2.3
1117,9/1/19,115332,113154,2178,1.9
1119,9/1/19,4933,4748,185,3.8
1121,9/1/19,35615,34540,1075,3
1123,9/1/19,18751,18290,461,2.5
1125,9/1/19,105496,103116,2380,2.3
1127,9/1/19,25184,24488,696,2.8
1129,9/1/19,6835,6569,266,3.9
1131,9/1/19,2726,2558,168,6.2
1133,9/1/19,10187,9910,277,2.7
2013,9/1/19,3020,2959,61,2
2016,9/1/19,3675,3570,105,2.9
2020,9/1/19,145481,138354,7127,4.9
2050,9/1/19,6856,5972,884,12.9
2060,9/1/19,455,432,23,5.1
2068,9/1/19,1449,1390,59,4.1
2070,9/1/19,1840,1697,143,7.8
2090,9/1/19,44804,42641,2163,4.8
2100,9/1/19,1249,1186,63,5
2105,9/1/19,1306,1222,84,6.4
2110,9/1/19,17393,16716,677,3.9
2122,9/1/19,26293,24750,1543,5.9
2130,9/1/19,7466,7098,368,4.9
2150,9/1/19,5961,5698,263,4.4
2158,9/1/19,2787,2346,441,15.8
2164,9/1/19,746,687,59,7.9
2170,9/1/19,46102,43269,2833,6.1
2180,9/1/19,3939,3538,401,10.2
2185,9/1/19,3382,3137,245,7.2
2188,9/1/19,2896,2502,394,13.6
2195,9/1/19,1563,1462,101,6.5
2198,9/1/19,2916,2681,235,8.1
2220,9/1/19,4604,4439,165,3.6
2230,9/1/19,1004,974,30,3
2240,9/1/19,2775,2574,201,7.2
2261,9/1/19,5224,4942,282,5.4
2275,9/1/19,1010,949,61,6
2282,9/1/19,273,256,17,6.2
2290,9/1/19,2355,2077,278,11.8
4001,9/1/19,20752,18825,1927,9.3
4003,9/1/19,51109,48301,2808,5.5
4005,9/1/19,79489,75514,3975,5
4007,9/1/19,21934,20786,1148,5.2
4009,9/1/19,15694,15004,690,4.4
4011,9/1/19,4590,4426,164,3.6
4012,9/1/19,9465,8948,517,5.5
4013,9/1/19,2335044,2245452,89592,3.8
4015,9/1/19,88269,83388,4881,5.5
4017,9/1/19,41906,39095,2811,6.7
4019,9/1/19,503048,481627,21421,4.3
4021,9/1/19,189693,180755,8938,4.7
4023,9/1/19,19483,17297,2186,11.2
4025,9/1/19,108122,103538,4584,4.2
4027,9/1/19,102870,83080,19790,19.2
5001,9/1/19,9418,9173,245,2.6
5003,9/1/19,7591,7238,353,4.7
5005,9/1/19,16339,15745,594,3.6
5007,9/1/19,138373,134921,3452,2.5
5009,9/1/19,16078,15588,490,3
5011,9/1/19,4527,4368,159,3.5
5013,9/1/19,2442,2357,85,3.5
5015,9/1/19,13110,12761,349,2.7
5017,9/1/19,3289,3091,198,6
5019,9/1/19,9813,9467,346,3.5
5021,9/1/19,5672,5430,242,4.3
5023,9/1/19,9280,8885,395,4.3
5025,9/1/19,3216,3107,109,3.4
5027,9/1/19,9239,8858,381,4.1
5029,9/1/19,8372,8025,347,4.1
5031,9/1/19,56047,54599,1448,2.6
5033,9/1/19,26879,26036,843,3.1
5035,9/1/19,21402,20541,861,4
5037,9/1/19,7470,7186,284,3.8
5039,9/1/19,2820,2697,123,4.4
5041,9/1/19,5359,5138,221,4.1
5043,9/1/19,7923,7570,353,4.5
5045,9/1/19,62060,60266,1794,2.9
5047,9/1/19,7565,7320,245,3.2
5049,9/1/19,5036,4857,179,3.6
5051,9/1/19,41040,39588,1452,3.5
5053,9/1/19,8360,8105,255,3.1
5055,9/1/19,20142,19475,667,3.3
5057,9/1/19,9964,9615,349,3.5
5059,9/1/19,14025,13543,482,3.4
5061,9/1/19,5728,5568,160,2.8
5063,9/1/19,16639,16000,639,3.8
5065,9/1/19,4948,4700,248,5
5067,9/1/19,5812,5462,350,6
5069,9/1/19,27741,26306,1435,5.2
5071,9/1/19,10236,9822,414,4
5073,9/1/19,2443,2329,114,4.7
5075,9/1/19,6901,6634,267,3.9
5077,9/1/19,2827,2706,121,4.3
5079,9/1/19,3954,3796,158,4
5081,9/1/19,5507,5286,221,4
5083,9/1/19,8599,8219,380,4.4
5085,9/1/19,34427,33229,1198,3.5
5087,9/1/19,7503,7320,183,2.4
5089,9/1/19,6739,6477,262,3.9
5091,9/1/19,19693,18963,730,3.7
5093,9/1/19,17407,16634,773,4.4
5095,9/1/19,2776,2662,114,4.1
5097,9/1/19,2997,2868,129,4.3
5099,9/1/19,3670,3530,140,3.8
5101,9/1/19,3342,3234,108,3.2
5103,9/1/19,9813,9366,447,4.6
5105,9/1/19,4232,4085,147,3.5
5107,9/1/19,6317,5955,362,5.7
5109,9/1/19,4290,4142,148,3.4
5111,9/1/19,10359,10033,326,3.1
5113,9/1/19,8200,7847,353,4.3
5115,9/1/19,29000,27885,1115,3.8
5117,9/1/19,3639,3475,164,4.5
5119,9/1/19,189092,182855,6237,3.3
5121,9/1/19,7375,7132,243,3.3
5123,9/1/19,8193,7812,381,4.7
5125,9/1/19,58765,57163,1602,2.7
5127,9/1/19,4376,4233,143,3.3
5129,9/1/19,2964,2834,130,4.4
5131,9/1/19,56617,54828,1789,3.2
5133,9/1/19,5569,5313,256,4.6
5135,9/1/19,5782,5514,268,4.6
5137,9/1/19,4690,4510,180,3.8
5139,9/1/19,15826,15056,770,4.9
5141,9/1/19,5762,5502,260,4.5
5143,9/1/19,126003,123101,2902,2.3
5145,9/1/19,33834,32475,1359,4
5147,9/1/19,2798,2660,138,4.9
5149,9/1/19,8466,8170,296,3.5
6001,9/1/19,846894,824463,22431,2.6
6003,9/1/19,463,440,23,5
6005,9/1/19,15087,14618,469,3.1
6007,9/1/19,99693,95695,3998,4
6009,9/1/19,21733,21059,674,3.1
6011,9/1/19,11119,10359,760,6.8
6013,9/1/19,563330,547866,15464,2.7
6015,9/1/19,9835,9357,478,4.9
6017,9/1/19,92231,89502,2729,3
6019,9/1/19,452958,427545,25413,5.6
6021,9/1/19,13214,12605,609,4.6
6023,9/1/19,62790,60944,1846,2.9
6025,9/1/19,71373,57534,13839,19.4
6027,9/1/19,8824,8578,246,2.8
6029,9/1/19,397235,372625,24610,6.2
6031,9/1/19,57497,54053,3444,6
6033,9/1/19,29277,28110,1167,4
6035,9/1/19,9831,9497,334,3.4
6037,9/1/19,5152447,4929776,222671,4.3
6039,9/1/19,62493,59192,3301,5.3
6041,9/1/19,141022,138149,2873,2
6043,9/1/19,8056,7804,252,3.1
6045,9/1/19,39175,37961,1214,3.1
6047,9/1/19,117807,111001,6806,5.8
6049,9/1/19,3184,3039,145,4.6
6051,9/1/19,8327,8048,279,3.4
6053,9/1/19,228665,220561,8104,3.5
6055,9/1/19,75913,74198,1715,2.3
6057,9/1/19,48495,47139,1356,2.8
6059,9/1/19,1629470,1588476,40994,2.5
6061,9/1/19,188662,183483,5179,2.7
6063,9/1/19,8194,7810,384,4.7
6065,9/1/19,1105907,1061700,44207,4
6067,9/1/19,714699,691537,23162,3.2
6069,9/1/19,31349,30144,1205,3.8
6071,9/1/19,968925,935067,33858,3.5
6073,9/1/19,1593792,1548011,45781,2.9
6075,9/1/19,588121,576853,11268,1.9
6077,9/1/19,328532,312511,16021,4.9
6079,9/1/19,139872,136334,3538,2.5
6081,9/1/19,464123,455698,8425,1.8
6083,9/1/19,218504,212046,6458,3
6085,9/1/19,1056884,1032954,23930,2.3
6087,9/1/19,142734,138027,4707,3.3
6089,9/1/19,74740,71980,2760,3.7
6091,9/1/19,1385,1333,52,3.8
6093,9/1/19,17506,16717,789,4.5
6095,9/1/19,209933,203225,6708,3.2
6097,9/1/19,264030,258016,6014,2.3
6099,9/1/19,246178,234305,11873,4.8
6101,9/1/19,46098,43777,2321,5
6103,9/1/19,26114,24968,1146,4.4
6105,9/1/19,4755,4570,185,3.9
6107,9/1/19,204349,188111,16238,7.9
6109,9/1/19,21389,20618,771,3.6
6111,9/1/19,421441,407362,14079,3.3
6113,9/1/19,108824,105313,3511,3.2
6115,9/1/19,30366,28889,1477,4.9
8001,9/1/19,277989,270969,7020,2.5
8003,9/1/19,8824,8539,285,3.2
8005,9/1/19,372327,363438,8889,2.4
8007,9/1/19,7166,6990,176,2.5
8009,9/1/19,2209,2176,33,1.5
8011,9/1/19,1964,1917,47,2.4
8013,9/1/19,199949,195744,4205,2.1
8014,9/1/19,40908,40016,892,2.2
8015,9/1/19,9840,9646,194,2
8017,9/1/19,1197,1181,16,1.3
8019,9/1/19,6191,6049,142,2.3
8021,9/1/19,4228,4103,125,3
8023,9/1/19,1949,1893,56,2.9
8025,9/1/19,1539,1479,60,3.9
8027,9/1/19,2164,2108,56,2.6
8029,9/1/19,14893,14515,378,2.5
8031,9/1/19,425492,415503,9989,2.3
8033,9/1/19,1221,1195,26,2.1
8035,9/1/19,198361,194128,4233,2.1
8037,9/1/19,36332,35689,643,1.8
8039,9/1/19,15593,15308,285,1.8
8041,9/1/19,345755,335904,9851,2.8
8043,9/1/19,15275,14683,592,3.9
8045,9/1/19,32424,31704,720,2.2
8047,9/1/19,3866,3789,77,2
8049,9/1/19,9581,9409,172,1.8
8051,9/1/19,11872,11681,191,1.6
8053,9/1/19,501,480,21,4.2
8055,9/1/19,2588,2481,107,4.1
8057,9/1/19,1074,1058,16,1.5
8059,9/1/19,342313,334777,7536,2.2
8061,9/1/19,1005,993,12,1.2
8063,9/1/19,4455,4386,69,1.5
8065,9/1/19,4870,4766,104,2.1
8067,9/1/19,32716,32077,639,2
8069,9/1/19,209577,205334,4243,2
8071,9/1/19,6677,6464,213,3.2
8073,9/1/19,2417,2366,51,2.1
8075,9/1/19,11243,11019,224,2
8077,9/1/19,77499,75359,2140,2.8
8079,9/1/19,465,454,11,2.4
8081,9/1/19,7396,7215,181,2.4
8083,9/1/19,13286,12878,408,3.1
8085,9/1/19,22335,21795,540,2.4
8087,9/1/19,16713,16327,386,2.3
8089,9/1/19,8598,8315,283,3.3
8091,9/1/19,2578,2526,52,2
8093,9/1/19,11459,11228,231,2
8095,9/1/19,2710,2676,34,1.3
8097,9/1/19,11218,10951,267,2.4
8099,9/1/19,6555,6408,147,2.2
8101,9/1/19,76923,74192,2731,3.6
8103,9/1/19,3093,3004,89,2.9
8105,9/1/19,5638,5447,191,3.4
8107,9/1/19,16135,15849,286,1.8
8109,9/1/19,3696,3557,139,3.8
8111,9/1/19,686,674,12,1.7
8113,9/1/19,5900,5807,93,1.6
8115,9/1/19,1282,1260,22,1.7
8117,9/1/19,21317,20939,378,1.8
8119,9/1/19,12963,12626,337,2.6
8121,9/1/19,3023,2971,52,1.7
8123,9/1/19,172833,169054,3779,2.2
8125,9/1/19,6074,5987,87,1.4
9001,9/1/19,479513,463213,16300,3.4
9003,9/1/19,483751,465909,17842,3.7
9005,9/1/19,105188,102000,3188,3
9007,9/1/19,93980,91171,2809,3
9009,9/1/19,462538,445476,17062,3.7
9011,9/1/19,137212,132588,4624,3.4
9013,9/1/19,86971,84459,2512,2.9
9015,9/1/19,63954,61727,2227,3.5
10001,9/1/19,78818,75393,3425,4.3
10003,9/1/19,297006,285272,11734,4
10005,9/1/19,108531,104781,3750,3.5
11001,9/1/19,407988,386102,21886,5.4
12001,9/1/19,142833,138948,3885,2.7
12003,9/1/19,12024,11694,330,2.7
12005,9/1/19,85601,82964,2637,3.1
12007,9/1/19,11367,11034,333,2.9
12009,9/1/19,288086,279637,8449,2.9
12011,9/1/19,1054173,1024315,29858,2.8
12013,9/1/19,4896,4718,178,3.6
12015,9/1/19,71697,69183,2514,3.5
12017,9/1/19,47643,45542,2101,4.4
12019,9/1/19,109436,106394,3042,2.8
12021,9/1/19,177330,171611,5719,3.2
12023,9/1/19,30393,29485,908,3
12027,9/1/19,13864,13403,461,3.3
12029,9/1/19,6088,5882,206,3.4
12031,9/1/19,499809,484615,15194,3
12033,9/1/19,147795,143453,4342,2.9
12035,9/1/19,47459,45791,1668,3.5
12037,9/1/19,4717,4581,136,2.9
12039,9/1/19,19216,18466,750,3.9
12041,9/1/19,7342,7118,224,3.1
12043,9/1/19,5183,4976,207,4
12045,9/1/19,5852,5625,227,3.9
12047,9/1/19,4379,4209,170,3.9
12049,9/1/19,8505,8066,439,5.2
12051,9/1/19,15621,14507,1114,7.1
12053,9/1/19,72983,70152,2831,3.9
12055,9/1/19,35809,34267,1542,4.3
12057,9/1/19,760926,738870,22056,2.9
12059,9/1/19,7139,6907,232,3.2
12061,9/1/19,64959,62494,2465,3.8
12063,9/1/19,17568,17031,537,3.1
12065,9/1/19,5724,5552,172,3
12067,9/1/19,2895,2810,85,2.9
12069,9/1/19,161049,156335,4714,2.9
12071,9/1/19,348608,338282,10326,3
12073,9/1/19,158252,153685,4567,2.9
12075,9/1/19,16945,16377,568,3.4
12077,9/1/19,2673,2596,77,2.9
12079,9/1/19,7620,7339,281,3.7
12081,9/1/19,180409,175035,5374,3
12083,9/1/19,139064,134160,4904,3.5
12085,9/1/19,74620,72413,2207,3
12086,9/1/19,1384761,1353065,31696,2.3
12087,9/1/19,45951,45072,879,1.9
12089,9/1/19,41832,40711,1121,2.7
12091,9/1/19,98076,95724,2352,2.4
12093,9/1/19,17981,17364,617,3.4
12095,9/1/19,774223,752975,21248,2.7
12097,9/1/19,187142,181281,5861,3.1
12099,9/1/19,737841,714200,23641,3.2
12101,9/1/19,241597,233774,7823,3.2
12103,9/1/19,501846,488211,13635,2.7
12105,9/1/19,310844,299922,10922,3.5
12107,9/1/19,26770,25720,1050,3.9
12109,9/1/19,134391,131160,3231,2.4
12111,9/1/19,146187,140698,5489,3.8
12113,9/1/19,83984,81754,2230,2.7
12115,9/1/19,189659,184249,5410,2.9
12117,9/1/19,259142,252145,6997,2.7
12119,9/1/19,32911,31571,1340,4.1
12121,9/1/19,18299,17709,590,3.2
12123,9/1/19,8373,8094,279,3.3
12125,9/1/19,4766,4639,127,2.7
12127,9/1/19,256846,248670,8176,3.2
12129,9/1/19,15188,14789,399,2.6
12131,9/1/19,31888,31086,802,2.5
12133,9/1/19,9844,9552,292,3
13001,9/1/19,9455,9119,336,3.6
13003,9/1/19,4629,4523,106,2.3
13005,9/1/19,4892,4748,144,2.9
13007,9/1/19,1156,1109,47,4.1
13009,9/1/19,17489,16840,649,3.7
13011,9/1/19,9607,9380,227,2.4
13013,9/1/19,40500,39509,991,2.4
13015,9/1/19,50665,49214,1451,2.9
13017,9/1/19,5379,5122,257,4.8
13019,9/1/19,7408,7150,258,3.5
13021,9/1/19,67664,65292,2372,3.5
13023,9/1/19,4457,4250,207,4.6
13025,9/1/19,7326,7046,280,3.8
13027,9/1/19,6898,6695,203,2.9
13029,9/1/19,18163,17661,502,2.8
13031,9/1/19,36477,35257,1220,3.3
13033,9/1/19,9099,8668,431,4.7
13035,9/1/19,10746,10442,304,2.8
13037,9/1/19,2263,2184,79,3.5
13039,9/1/19,20750,20063,687,3.3
13043,9/1/19,5635,5489,146,2.6
13045,9/1/19,55450,53777,1673,3
13047,9/1/19,33756,32904,852,2.5
13049,9/1/19,4783,4616,167,3.5
13051,9/1/19,138515,134342,4173,3
13053,9/1/19,1966,1893,73,3.7
13055,9/1/19,10097,9750,347,3.4
13057,9/1/19,136552,133276,3276,2.4
13059,9/1/19,59053,57175,1878,3.2
13061,9/1/19,893,836,57,6.4
13063,9/1/19,138102,132810,5292,3.8
13065,9/1/19,2489,2399,90,3.6
13067,9/1/19,427185,416004,11181,2.6
13069,9/1/19,18868,18279,589,3.1
13071,9/1/19,21042,20448,594,2.8
13073,9/1/19,75007,72987,2020,2.7
13075,9/1/19,8005,7773,232,2.9
13077,9/1/19,74816,72918,1898,2.5
13079,9/1/19,5583,5403,180,3.2
13081,9/1/19,9400,9088,312,3.3
13083,9/1/19,8339,8107,232,2.8
13085,9/1/19,12401,12105,296,2.4
13087,9/1/19,11461,11056,405,3.5
13089,9/1/19,400810,388609,12201,3
13091,9/1/19,7117,6763,354,5
13093,9/1/19,5070,4907,163,3.2
13095,9/1/19,38579,36895,1684,4.4
13097,9/1/19,73529,71191,2338,3.2
13099,9/1/19,4420,4278,142,3.2
13101,9/1/19,1892,1848,44,2.3
13103,9/1/19,30606,29801,805,2.6
13105,9/1/19,7674,7413,261,3.4
13107,9/1/19,8305,7889,416,5
13109,9/1/19,4901,4750,151,3.1
13111,9/1/19,11499,11161,338,2.9
13113,9/1/19,58178,56644,1534,2.6
13115,9/1/19,44060,42609,1451,3.3
13117,9/1/19,122624,119655,2969,2.4
13119,9/1/19,9854,9549,305,3.1
13121,9/1/19,559050,541672,17378,3.1
13123,9/1/19,12011,11652,359,3
13125,9/1/19,1271,1227,44,3.5
13127,9/1/19,39568,38235,1333,3.4
13129,9/1/19,27976,27191,785,2.8
13131,9/1/19,10366,10044,322,3.1
13133,9/1/19,6965,6732,233,3.3
13135,9/1/19,492265,479079,13186,2.7
13137,9/1/19,19054,18508,546,2.9
13139,9/1/19,102502,100012,2490,2.4
13141,9/1/19,2448,2321,127,5.2
13143,9/1/19,12631,12257,374,3
13145,9/1/19,16561,16102,459,2.8
13147,9/1/19,10980,10647,333,3
13149,9/1/19,5257,5112,145,2.8
13151,9/1/19,115633,111980,3653,3.2
13153,9/1/19,70304,68269,2035,2.9
13155,9/1/19,3348,3210,138,4.1
13157,9/1/19,36568,35733,835,2.3
13159,9/1/19,6966,6782,184,2.6
13161,9/1/19,5984,5730,254,4.2
13163,9/1/19,6562,6286,276,4.2
13165,9/1/19,3166,3010,156,4.9
13167,9/1/19,3956,3837,119,3
13169,9/1/19,13657,13277,380,2.8
13171,9/1/19,8299,7995,304,3.7
13173,9/1/19,3738,3618,120,3.2
13175,9/1/19,18859,18040,819,4.3
13177,9/1/19,14832,14422,410,2.8
13179,9/1/19,26107,25183,924,3.5
13181,9/1/19,3536,3416,120,3.4
13183,9/1/19,8147,7869,278,3.4
13185,9/1/19,51061,49462,1599,3.1
13187,9/1/19,16934,16482,452,2.7
13189,9/1/19,8825,8397,428,4.8
13191,9/1/19,6190,5965,225,3.6
13193,9/1/19,4657,4458,199,4.3
13195,9/1/19,13327,12959,368,2.8
13197,9/1/19,3290,3164,126,3.8
13199,9/1/19,8942,8588,354,4
13201,9/1/19,2742,2660,82,3
13205,9/1/19,8489,8135,354,4.2
13207,9/1/19,12983,12613,370,2.8
13209,9/1/19,3823,3627,196,5.1
13211,9/1/19,9311,9050,261,2.8
13213,9/1/19,15480,14786,694,4.5
13215,9/1/19,76938,73764,3174,4.1
13217,9/1/19,52337,50534,1803,3.4
13219,9/1/19,19558,19132,426,2.2
13221,9/1/19,6917,6722,195,2.8
13223,9/1/19,86163,83937,2226,2.6
13225,9/1/19,11835,11405,430,3.6
13227,9/1/19,15324,14927,397,2.6
13229,9/1/19,8667,8411,256,3
13231,9/1/19,8950,8712,238,2.7
13233,9/1/19,18492,17924,568,3.1
13235,9/1/19,4047,3919,128,3.2
13237,9/1/19,8193,7889,304,3.7
13239,9/1/19,801,766,35,4.4
13241,9/1/19,7318,7116,202,2.8
13243,9/1/19,2490,2379,111,4.5
13245,9/1/19,84577,81153,3424,4
13247,9/1/19,44881,43393,1488,3.3
13249,9/1/19,2229,2156,73,3.3
13251,9/1/19,5262,4835,427,8.1
13253,9/1/19,3048,2932,116,3.8
13255,9/1/19,28746,27733,1013,3.5
13257,9/1/19,10674,10320,354,3.3
13259,9/1/19,2404,2314,90,3.7
13261,9/1/19,12843,12283,560,4.4
13263,9/1/19,2791,2692,99,3.5
13265,9/1/19,567,537,30,5.3
13267,9/1/19,9609,9287,322,3.4
13269,9/1/19,3138,3033,105,3.3
13271,9/1/19,3892,3489,403,10.4
13273,9/1/19,3510,3368,142,4
13275,9/1/19,16422,15828,594,3.6
13277,9/1/19,19770,19188,582,2.9
13279,9/1/19,11752,11166,586,5
13281,9/1/19,3967,3801,166,4.2
13283,9/1/19,2584,2444,140,5.4
13285,9/1/19,37271,36196,1075,2.9
13287,9/1/19,3104,3005,99,3.2
13289,9/1/19,2844,2709,135,4.7
13291,9/1/19,10285,10020,265,2.6
13293,9/1/19,11387,11015,372,3.3
13295,9/1/19,31467,30587,880,2.8
13297,9/1/19,46153,44900,1253,2.7
13299,9/1/19,15487,14974,513,3.3
13301,9/1/19,2840,2724,116,4.1
13303,9/1/19,7015,6782,233,3.3
13305,9/1/19,11292,10858,434,3.8
13307,9/1/19,1011,965,46,4.5
13309,9/1/19,1589,1474,115,7.2
13311,9/1/19,16503,16147,356,2.2
13313,9/1/19,43373,41816,1557,3.6
13315,9/1/19,2675,2569,106,4
13317,9/1/19,3802,3640,162,4.3
13319,9/1/19,3937,3809,128,3.3
13321,9/1/19,8982,8627,355,4
15001,9/1/19,91579,88379,3200,3.5
15003,9/1/19,447922,435639,12283,2.7
15007,9/1/19,36588,35589,999,2.7
15009,9/1/19,86453,84094,2359,2.7
16001,9/1/19,254732,249208,5524,2.2
16003,9/1/19,1744,1672,72,4.1
16005,9/1/19,42462,41461,1001,2.4
16007,9/1/19,3004,2943,61,2
16009,9/1/19,4121,3994,127,3.1
16011,9/1/19,24918,24396,522,2.1
16013,9/1/19,12240,12000,240,2
16015,9/1/19,3503,3387,116,3.3
16017,9/1/19,20018,19407,611,3.1
16019,9/1/19,57102,55911,1191,2.1
16021,9/1/19,5386,5219,167,3.1
16023,9/1/19,1408,1376,32,2.3
16025,9/1/19,723,706,17,2.4
16027,9/1/19,105626,102862,2764,2.6
16029,9/1/19,4168,4068,100,2.4
16031,9/1/19,12596,12343,253,2
16033,9/1/19,388,375,13,3.4
16035,9/1/19,2886,2763,123,4.3
16037,9/1/19,2409,2334,75,3.1
16039,9/1/19,11798,11501,297,2.5
16041,9/1/19,7098,6975,123,1.7
16043,9/1/19,7421,7290,131,1.8
16045,9/1/19,8379,8160,219,2.6
16047,9/1/19,8273,8105,168,2
16049,9/1/19,6659,6453,206,3.1
16051,9/1/19,14103,13830,273,1.9
16053,9/1/19,12263,12023,240,2
16055,9/1/19,80050,77926,2124,2.7
16057,9/1/19,21028,20580,448,2.1
16059,9/1/19,3646,3536,110,3
16061,9/1/19,1681,1617,64,3.8
16063,9/1/19,2759,2691,68,2.5
16065,9/1/19,20619,20244,375,1.8
16067,9/1/19,11901,11680,221,1.9
16069,9/1/19,20903,20446,457,2.2
16071,9/1/19,2328,2293,35,1.5
16073,9/1/19,5532,5397,135,2.4
16075,9/1/19,11882,11541,341,2.9
16077,9/1/19,4489,4396,93,2.1
16079,9/1/19,5041,4829,212,4.2
16081,9/1/19,6972,6863,109,1.6
16083,9/1/19,41613,40669,944,2.3
16085,9/1/19,5641,5506,135,2.4
16087,9/1/19,4692,4543,149,3.2
17001,9/1/19,32168,31142,1026,3.2
17003,9/1/19,2046,1929,117,5.7
17005,9/1/19,7850,7593,257,3.3
17007,9/1/19,26077,24886,1191,4.6
17009,9/1/19,3035,2965,70,2.3
17011,9/1/19,17370,16713,657,3.8
17013,9/1/19,2333,2239,94,4
17015,9/1/19,7387,7137,250,3.4
17017,9/1/19,6095,5888,207,3.4
17019,9/1/19,110714,107047,3667,3.3
17021,9/1/19,14341,13733,608,4.2
17023,9/1/19,7632,7330,302,4
17025,9/1/19,6476,6221,255,3.9
17027,9/1/19,20617,20066,551,2.7
17029,9/1/19,24253,23384,869,3.6
17031,9/1/19,2579265,2493164,86101,3.3
17033,9/1/19,8730,8383,347,4
17035,9/1/19,6140,5966,174,2.8
17037,9/1/19,55436,53466,1970,3.6
17039,9/1/19,7488,7211,277,3.7
17041,9/1/19,10278,9944,334,3.2
17043,9/1/19,505330,492409,12921,2.6
17045,9/1/19,8826,8486,340,3.9
17047,9/1/19,2659,2561,98,3.7
17049,9/1/19,19330,18779,551,2.9
17051,9/1/19,9885,9518,367,3.7
17053,9/1/19,6538,6301,237,3.6
17055,9/1/19,16483,15693,790,4.8
17057,9/1/19,15335,14559,776,5.1
17059,9/1/19,2333,2226,107,4.6
17061,9/1/19,6040,5812,228,3.8
17063,9/1/19,25145,24281,864,3.4
17065,9/1/19,4436,4289,147,3.3
17067,9/1/19,8477,8091,386,4.6
17069,9/1/19,1321,1246,75,5.7
17071,9/1/19,3620,3467,153,4.2
17073,9/1/19,25224,24137,1087,4.3
17075,9/1/19,14376,13854,522,3.6
17077,9/1/19,28244,27282,962,3.4
17079,9/1/19,4651,4468,183,3.9
17081,9/1/19,17438,16714,724,4.2
17083,9/1/19,11041,10631,410,3.7
17085,9/1/19,10923,10573,350,3.2
17087,9/1/19,4179,3967,212,5.1
17089,9/1/19,274086,264058,10028,3.7
17091,9/1/19,56319,54005,2314,4.1
17093,9/1/19,68257,66396,1861,2.7
17095,9/1/19,21993,21010,983,4.5
17097,9/1/19,378397,365501,12896,3.4
17099,9/1/19,54814,52458,2356,4.3
17101,9/1/19,5885,5610,275,4.7
17103,9/1/19,17752,17155,597,3.4
17105,9/1/19,16789,16202,587,3.5
17107,9/1/19,12781,12269,512,4
17109,9/1/19,14016,13294,722,5.2
17111,9/1/19,164263,159863,4400,2.7
17113,9/1/19,88942,85880,3062,3.4
17115,9/1/19,48723,46335,2388,4.9
17117,9/1/19,23157,22298,859,3.7
17119,9/1/19,135668,130860,4808,3.5
17121,9/1/19,17512,16766,746,4.3
17123,9/1/19,5333,5116,217,4.1
17125,9/1/19,6387,6095,292,4.6
17127,9/1/19,5675,5382,293,5.2
17129,9/1/19,6494,6296,198,3
17131,9/1/19,8133,7794,339,4.2
17133,9/1/19,19026,18479,547,2.9
17135,9/1/19,11766,11261,505,4.3
17137,9/1/19,16610,16037,573,3.4
17139,9/1/19,7626,7393,233,3.1
17141,9/1/19,24922,23882,1040,4.2
17143,9/1/19,85452,81523,3929,4.6
17145,9/1/19,8302,7930,372,4.5
17147,9/1/19,8732,8462,270,3.1
17149,9/1/19,7027,6779,248,3.5
17151,9/1/19,1683,1596,87,5.2
17153,9/1/19,2042,1935,107,5.2
17155,9/1/19,3048,2931,117,3.8
17157,9/1/19,14318,13875,443,3.1
17159,9/1/19,7253,6985,268,3.7
17161,9/1/19,72182,68772,3410,4.7
17163,9/1/19,128007,122746,5261,4.1
17165,9/1/19,9621,9156,465,4.8
17167,9/1/19,101252,97631,3621,3.6
17169,9/1/19,3294,3170,124,3.8
17171,9/1/19,2533,2440,93,3.7
17173,9/1/19,10606,10251,355,3.3
17175,9/1/19,2533,2414,119,4.7
17177,9/1/19,21847,20950,897,4.1
17179,9/1/19,64187,61671,2516,3.9
17181,9/1/19,7547,7208,339,4.5
17183,9/1/19,33300,31719,1581,4.7
17185,9/1/19,5985,5774,211,3.5
17187,9/1/19,8460,8153,307,3.6
17189,9/1/19,10313,10082,231,2.2
17191,9/1/19,7079,6774,305,4.3
17193,9/1/19,6642,6411,231,3.5
17195,9/1/19,28757,27617,1140,4
17197,9/1/19,354884,343699,11185,3.2
17199,9/1/19,32336,31088,1248,3.9
17201,9/1/19,139626,132266,7360,5.3
17203,9/1/19,18893,18248,645,3.4
18001,9/1/19,17024,16635,389,2.3
18003,9/1/19,185894,180899,4995,2.7
18005,9/1/19,44791,43880,911,2
18007,9/1/19,4484,4372,112,2.5
18009,9/1/19,4894,4735,159,3.2
18011,9/1/19,36325,35590,735,2
18013,9/1/19,7719,7534,185,2.4
18015,9/1/19,10141,9895,246,2.4
18017,9/1/19,17683,17206,477,2.7
18019,9/1/19,61760,59976,1784,2.9
18021,9/1/19,12043,11685,358,3
18023,9/1/19,17047,16664,383,2.2
18025,9/1/19,4841,4692,149,3.1
18027,9/1/19,16593,16243,350,2.1
18029,9/1/19,25829,25039,790,3.1
18031,9/1/19,14499,14157,342,2.4
18033,9/1/19,22540,22004,536,2.4
18035,9/1/19,53971,52268,1703,3.2
18037,9/1/19,22753,22317,436,1.9
18039,9/1/19,111450,108358,3092,2.8
18041,9/1/19,8620,8229,391,4.5
18043,9/1/19,41691,40554,1137,2.7
18045,9/1/19,7940,7720,220,2.8
18047,9/1/19,11358,11044,314,2.8
18049,9/1/19,9762,9514,248,2.5
18051,9/1/19,19494,19085,409,2.1
18053,9/1/19,31186,30182,1004,3.2
18055,9/1/19,13670,13226,444,3.2
18057,9/1/19,184544,180609,3935,2.1
18059,9/1/19,40387,39395,992,2.5
18061,9/1/19,20275,19752,523,2.6
18063,9/1/19,90373,88279,2094,2.3
18065,9/1/19,22102,21501,601,2.7
18067,9/1/19,36857,35671,1186,3.2
18069,9/1/19,18253,17801,452,2.5
18071,9/1/19,22821,22310,511,2.2
18073,9/1/19,16239,15754,485,3
18075,9/1/19,9382,9158,224,2.4
18077,9/1/19,15009,14565,444,3
18079,9/1/19,13583,13251,332,2.4
18081,9/1/19,83232,81338,1894,2.3
18083,9/1/19,18404,17919,485,2.6
18085,9/1/19,42011,41025,986,2.3
18087,9/1/19,19826,19378,448,2.3
18089,9/1/19,231582,221784,9798,4.2
18091,9/1/19,47777,46082,1695,3.5
18093,9/1/19,21311,20665,646,3
18095,9/1/19,59168,57373,1795,3
18097,9/1/19,493075,478775,14300,2.9
18099,9/1/19,22955,22350,605,2.6
18101,9/1/19,5328,5212,116,2.2
18103,9/1/19,15267,14768,499,3.3
18105,9/1/19,71317,69480,1837,2.6
18107,9/1/19,18801,18302,499,2.7
18109,9/1/19,36397,35480,917,2.5
18111,9/1/19,6931,6703,228,3.3
18113,9/1/19,23534,22923,611,2.6
18115,9/1/19,3194,3098,96,3
18117,9/1/19,8569,8325,244,2.8
18119,9/1/19,9489,9192,297,3.1
18121,9/1/19,7078,6862,216,3.1
18123,9/1/19,9283,9022,261,2.8
18125,9/1/19,6119,5952,167,2.7
18127,9/1/19,87387,84541,2846,3.3
18129,9/1/19,13579,13253,326,2.4
18131,9/1/19,6402,6239,163,2.5
18133,9/1/19,16742,16290,452,2.7
18135,9/1/19,11204,10848,356,3.2
18137,9/1/19,14198,13813,385,2.7
18139,9/1/19,8824,8628,196,2.2
18141,9/1/19,136904,132518,4386,3.2
18143,9/1/19,10551,10237,314,3
18145,9/1/19,23208,22632,576,2.5
18147,9/1/19,10877,10588,289,2.7
18149,9/1/19,9863,9509,354,3.6
18151,9/1/19,21065,20605,460,2.2
18153,9/1/19,8340,8049,291,3.5
18155,9/1/19,4975,4830,145,2.9
18157,9/1/19,98964,96583,2381,2.4
18159,9/1/19,9180,8991,189,2.1
18161,9/1/19,3543,3445,98,2.8
18163,9/1/19,94661,92117,2544,2.7
18165,9/1/19,6941,6650,291,4.2
18167,9/1/19,48246,46511,1735,3.6
18169,9/1/19,15020,14645,375,2.5
18171,9/1/19,4152,4042,110,2.6
18173,9/1/19,33056,32258,798,2.4
18175,9/1/19,13609,13226,383,2.8
18177,9/1/19,30522,29589,933,3.1
18179,9/1/19,14344,14040,304,2.1
18181,9/1/19,13464,13161,303,2.3
18183,9/1/19,17737,17309,428,2.4
19001,9/1/19,4268,4186,82,1.9
19003,9/1/19,2202,2169,33,1.5
19005,9/1/19,7492,7323,169,2.3
19007,9/1/19,5778,5567,211,3.7
19009,9/1/19,3103,3038,65,2.1
19011,9/1/19,13740,13404,336,2.4
19013,9/1/19,70839,68808,2031,2.9
19015,9/1/19,15319,15035,284,1.9
19017,9/1/19,14188,13904,284,2
19019,9/1/19,11570,11327,243,2.1
19021,9/1/19,11939,11717,222,1.9
19023,9/1/19,8076,7880,196,2.4
19025,9/1/19,4300,4215,85,2
19027,9/1/19,11128,10926,202,1.8
19029,9/1/19,6967,6811,156,2.2
19031,9/1/19,11014,10801,213,1.9
19033,9/1/19,23981,23407,574,2.4
19035,9/1/19,6277,6127,150,2.4
19037,9/1/19,6594,6441,153,2.3
19039,9/1/19,4903,4794,109,2.2
19041,9/1/19,8605,8415,190,2.2
19043,9/1/19,10292,10064,228,2.2
19045,9/1/19,23238,22384,854,3.7
19047,9/1/19,8246,8033,213,2.6
19049,9/1/19,50680,49801,879,1.7
19051,9/1/19,4293,4144,149,3.5
19053,9/1/19,4530,4448,82,1.8
19055,9/1/19,10736,10536,200,1.9
19057,9/1/19,19476,18755,721,3.7
19059,9/1/19,10540,10323,217,2.1
19061,9/1/19,57141,55915,1226,2.1
19063,9/1/19,5349,5250,99,1.9
19065,9/1/19,10826,10541,285,2.6
19067,9/1/19,8760,8418,342,3.9
19069,9/1/19,5736,5634,102,1.8
19071,9/1/19,3744,3662,82,2.2
19073,9/1/19,5515,5412,103,1.9
19075,9/1/19,6646,6485,161,2.4
19077,9/1/19,5690,5562,128,2.2
19079,9/1/19,7013,6852,161,2.3
19081,9/1/19,5972,5842,130,2.2
19083,9/1/19,8166,7959,207,2.5
19085,9/1/19,7469,7325,144,1.9
19087,9/1/19,10003,9760,243,2.4
19089,9/1/19,5203,5102,101,1.9
19091,9/1/19,5223,5103,120,2.3
19093,9/1/19,4164,4104,60,1.4
19095,9/1/19,10677,10504,173,1.6
19097,9/1/19,11093,10822,271,2.4
19099,9/1/19,20221,19739,482,2.4
19101,9/1/19,10358,10112,246,2.4
19103,9/1/19,88492,86799,1693,1.9
19105,9/1/19,10828,10578,250,2.3
19107,9/1/19,5268,5112,156,3
19109,9/1/19,8496,8322,174,2
19111,9/1/19,16443,15855,588,3.6
19113,9/1/19,124906,121569,3337,2.7
19115,9/1/19,6160,5995,165,2.7
19117,9/1/19,4629,4535,94,2
19119,9/1/19,7142,7054,88,1.2
19121,9/1/19,8701,8469,232,2.7
19123,9/1/19,12186,11892,294,2.4
19125,9/1/19,18886,18541,345,1.8
19127,9/1/19,17962,17414,548,3.1
19129,9/1/19,7520,7367,153,2
19131,9/1/19,7116,7014,102,1.4
19133,9/1/19,4497,4384,113,2.5
19135,9/1/19,4145,4015,130,3.1
19137,9/1/19,5017,4908,109,2.2
19139,9/1/19,22325,21786,539,2.4
19141,9/1/19,8387,8235,152,1.8
19143,9/1/19,3530,3470,60,1.7
19145,9/1/19,6428,6270,158,2.5
19147,9/1/19,4866,4781,85,1.7
19149,9/1/19,15146,14815,331,2.2
19151,9/1/19,4924,4852,72,1.5
19153,9/1/19,275103,268338,6765,2.5
19155,9/1/19,49443,48403,1040,2.1
19157,9/1/19,10815,10600,215,2
19159,9/1/19,2514,2455,59,2.3
19161,9/1/19,5358,5257,101,1.9
19163,9/1/19,91467,88607,2860,3.1
19165,9/1/19,6770,6651,119,1.8
19167,9/1/19,21556,21262,294,1.4
19169,9/1/19,61172,60174,998,1.6
19171,9/1/19,9510,9288,222,2.3
19173,9/1/19,3231,3173,58,1.8
19175,9/1/19,6395,6226,169,2.6
19177,9/1/19,3381,3283,98,2.9
19179,9/1/19,18277,17484,793,4.3
19181,9/1/19,28926,28318,608,2.1
19183,9/1/19,12243,12001,242,2
19185,9/1/19,2841,2769,72,2.5
19187,9/1/19,19889,19405,484,2.4
19189,9/1/19,5247,5123,124,2.4
19191,9/1/19,12585,12349,236,1.9
19193,9/1/19,56833,55551,1282,2.3
19195,9/1/19,4293,4200,93,2.2
19197,9/1/19,7147,6981,166,2.3
20001,9/1/19,6404,6217,187,2.9
20003,9/1/19,4231,4116,115,2.7
20005,9/1/19,7081,6733,348,4.9
20007,9/1/19,2392,2337,55,2.3
20009,9/1/19,13434,13058,376,2.8
20011,9/1/19,6492,6263,229,3.5
20013,9/1/19,5396,5261,135,2.5
20015,9/1/19,32385,31469,916,2.8
20017,9/1/19,1531,1501,30,2
20019,9/1/19,1450,1407,43,3
20021,9/1/19,10137,9838,299,2.9
20023,9/1/19,1375,1350,25,1.8
20025,9/1/19,1118,1096,22,2
20027,9/1/19,3927,3832,95,2.4
20029,9/1/19,3832,3725,107,2.8
20031,9/1/19,4181,4046,135,3.2
20033,9/1/19,881,859,22,2.5
20035,9/1/19,16317,15844,473,2.9
20037,9/1/19,18482,17849,633,3.4
20039,9/1/19,1277,1242,35,2.7
20041,9/1/19,8859,8597,262,3
20043,9/1/19,4153,4046,107,2.6
20045,9/1/19,65602,63967,1635,2.5
20047,9/1/19,1513,1480,33,2.2
20049,9/1/19,1198,1158,40,3.3
20051,9/1/19,17184,16866,318,1.9
20053,9/1/19,2780,2715,65,2.3
20055,9/1/19,20725,20300,425,2.1
20057,9/1/19,17284,16905,379,2.2
20059,9/1/19,14032,13653,379,2.7
20061,9/1/19,11280,10840,440,3.9
20063,9/1/19,1537,1510,27,1.8
20065,9/1/19,1157,1127,30,2.6
20067,9/1/19,3375,3301,74,2.2
20069,9/1/19,3446,3388,58,1.7
20071,9/1/19,849,829,20,2.4
20073,9/1/19,3285,3200,85,2.6
20075,9/1/19,1763,1738,25,1.4
20077,9/1/19,2844,2780,64,2.3
20079,9/1/19,16984,16546,438,2.6
20081,9/1/19,2299,2259,40,1.7
20083,9/1/19,1042,1020,22,2.1
20085,9/1/19,7111,6942,169,2.4
20087,9/1/19,10019,9780,239,2.4
20089,9/1/19,1330,1300,30,2.3
20091,9/1/19,336257,328245,8012,2.4
20093,9/1/19,2131,2093,38,1.8
20095,9/1/19,3507,3417,90,2.6
20097,9/1/19,1362,1337,25,1.8
20099,9/1/19,9888,9570,318,3.2
20101,9/1/19,828,806,22,2.7
20103,9/1/19,36207,35146,1061,2.9
20105,9/1/19,1734,1701,33,1.9
20107,9/1/19,4420,4211,209,4.7
20109,9/1/19,1715,1683,32,1.9
20111,9/1/19,16624,16154,470,2.8
20113,9/1/19,17210,16876,334,1.9
20115,9/1/19,6093,5944,149,2.4
20117,9/1/19,5610,5485,125,2.2
20119,9/1/19,2265,2223,42,1.9
20121,9/1/19,17331,16863,468,2.7
20123,9/1/19,3340,3275,65,1.9
20125,9/1/19,14573,14067,506,3.5
20127,9/1/19,3077,3012,65,2.1
20129,9/1/19,1182,1149,33,2.8
20131,9/1/19,5507,5372,135,2.5
20133,9/1/19,6212,5953,259,4.2
20135,9/1/19,1409,1379,30,2.1
20137,9/1/19,2764,2714,50,1.8
20139,9/1/19,7921,7690,231,2.9
20141,9/1/19,2104,2071,33,1.6
20143,9/1/19,3040,2971,69,2.3
20145,9/1/19,3004,2935,69,2.3
20147,9/1/19,2720,2665,55,2
20149,9/1/19,12622,12341,281,2.2
20151,9/1/19,4979,4884,95,1.9
20153,9/1/19,1594,1566,28,1.8
20155,9/1/19,30012,29215,797,2.7
20157,9/1/19,2356,2308,48,2
20159,9/1/19,5279,5157,122,2.3
20161,9/1/19,35535,34686,849,2.4
20163,9/1/19,2590,2516,74,2.9
20165,9/1/19,1651,1614,37,2.2
20167,9/1/19,3260,3173,87,2.7
20169,9/1/19,29890,29118,772,2.6
20171,9/1/19,2965,2918,47,1.6
20173,9/1/19,249392,241829,7563,3
20175,9/1/19,9558,9287,271,2.8
20177,9/1/19,89127,86573,2554,2.9
20179,9/1/19,1493,1466,27,1.8
20181,9/1/19,2889,2820,69,2.4
20183,9/1/19,2033,1991,42,2.1
20185,9/1/19,2106,2059,47,2.2
20187,9/1/19,1041,1018,23,2.2
20189,9/1/19,2714,2650,64,2.4
20191,9/1/19,10962,10638,324,3
20193,9/1/19,4391,4309,82,1.9
20195,9/1/19,1461,1429,32,2.2
20197,9/1/19,3680,3586,94,2.6
20199,9/1/19,873,858,15,1.7
20201,9/1/19,3044,2986,58,1.9
20203,9/1/19,1317,1295,22,1.7
20205,9/1/19,3981,3851,130,3.3
20207,9/1/19,1575,1520,55,3.5
20209,9/1/19,76393,73694,2699,3.5
21001,9/1/19,7131,6814,317,4.4
21003,9/1/19,9055,8718,337,3.7
21005,9/1/19,12142,11763,379,3.1
21007,9/1/19,3493,3331,162,4.6
21009,9/1/19,18819,18087,732,3.9
21011,9/1/19,4580,4346,234,5.1
21013,9/1/19,8357,7821,536,6.4
21015,9/1/19,71669,69482,2187,3.1
21017,9/1/19,9735,9399,336,3.5
21019,9/1/19,17888,17003,885,4.9
21021,9/1/19,12427,11904,523,4.2
21023,9/1/19,3810,3665,145,3.8
21025,9/1/19,3378,3156,222,6.6
21027,9/1/19,7809,7455,354,4.5
21029,9/1/19,43172,41565,1607,3.7
21031,9/1/19,5108,4908,200,3.9
21033,9/1/19,5428,5181,247,4.6
21035,9/1/19,18778,18116,662,3.5
21037,9/1/19,51241,49662,1579,3.1
21039,9/1/19,2281,2199,82,3.6
21041,9/1/19,5271,5076,195,3.7
21043,9/1/19,9820,9115,705,7.2
21045,9/1/19,6658,6396,262,3.9
21047,9/1/19,25239,23886,1353,5.4
21049,9/1/19,17283,16666,617,3.6
21051,9/1/19,5199,4863,336,6.5
21053,9/1/19,3973,3798,175,4.4
21055,9/1/19,3760,3601,159,4.2
21057,9/1/19,3206,3109,97,3
21059,9/1/19,47641,46005,1636,3.4
21061,9/1/19,4837,4648,189,3.9
21063,9/1/19,2037,1883,154,7.6
21065,9/1/19,5403,5169,234,4.3
21067,9/1/19,176388,171207,5181,2.9
21069,9/1/19,6087,5805,282,4.6
21071,9/1/19,10968,10343,625,5.7
21073,9/1/19,25474,24635,839,3.3
21075,9/1/19,2052,1952,100,4.9
21077,9/1/19,4104,3962,142,3.5
21079,9/1/19,7698,7377,321,4.2
21081,9/1/19,11784,11371,413,3.5
21083,9/1/19,15754,15107,647,4.1
21085,9/1/19,11002,10511,491,4.5
21087,9/1/19,5103,4899,204,4
21089,9/1/19,13458,12651,807,6
21091,9/1/19,4001,3864,137,3.4
21093,9/1/19,49131,47303,1828,3.7
21095,9/1/19,6786,5959,827,12.2
21097,9/1/19,8898,8550,348,3.9
21099,9/1/19,7786,7475,311,4
21101,9/1/19,22079,21337,742,3.4
21103,9/1/19,8238,7979,259,3.1
21105,9/1/19,1707,1637,70,4.1
21107,9/1/19,18511,17786,725,3.9
21109,9/1/19,4157,3920,237,5.7
21111,9/1/19,403436,388763,14673,3.6
21113,9/1/19,26712,25845,867,3.2
21115,9/1/19,6723,6329,394,5.9
21117,9/1/19,88699,85857,2842,3.2
21119,9/1/19,4470,4196,274,6.1
21121,9/1/19,9882,9352,530,5.4
21123,9/1/19,5945,5704,241,4.1
21125,9/1/19,24618,23489,1129,4.6
21127,9/1/19,5258,4915,343,6.5
21129,9/1/19,2034,1937,97,4.8
21131,9/1/19,2738,2482,256,9.3
21133,9/1/19,6420,5912,508,7.9
21135,9/1/19,4563,4220,343,7.5
21137,9/1/19,9203,8807,396,4.3
21139,9/1/19,3640,3481,159,4.4
21141,9/1/19,12564,12084,480,3.8
21143,9/1/19,3102,2983,119,3.8
21145,9/1/19,29297,27985,1312,4.5
21147,9/1/19,4661,4409,252,5.4
21149,9/1/19,4213,4053,160,3.8
21151,9/1/19,47497,45895,1602,3.4
21153,9/1/19,3175,2859,316,10
21155,9/1/19,9714,9375,339,3.5
21157,9/1/19,15293,14727,566,3.7
21159,9/1/19,2762,2590,172,6.2
21161,9/1/19,7054,6673,381,5.4
21163,9/1/19,12293,11773,520,4.2
21165,9/1/19,2314,2185,129,5.6
21167,9/1/19,10048,9639,409,4.1
21169,9/1/19,4091,3901,190,4.6
21171,9/1/19,4708,4553,155,3.3
21173,9/1/19,11702,11171,531,4.5
21175,9/1/19,4557,4362,195,4.3
21177,9/1/19,10397,9812,585,5.6
21179,9/1/19,23204,22285,919,4
21181,9/1/19,3321,3186,135,4.1
21183,9/1/19,9836,9398,438,4.5
21185,9/1/19,33523,32564,959,2.9
21187,9/1/19,5202,5005,197,3.8
21189,9/1/19,1115,1045,70,6.3
21191,9/1/19,6999,6780,219,3.1
21193,9/1/19,8296,7808,488,5.9
21195,9/1/19,19914,18940,974,4.9
21197,9/1/19,5035,4814,221,4.4
21199,9/1/19,26824,25693,1131,4.2
21201,9/1/19,824,789,35,4.2
21203,9/1/19,6709,6417,292,4.4
21205,9/1/19,10468,10000,468,4.5
21207,9/1/19,6237,5933,304,4.9
21209,9/1/19,29382,28446,936,3.2
21211,9/1/19,25676,24857,819,3.2
21213,9/1/19,8957,8529,428,4.8
21215,9/1/19,10287,9951,336,3.3
21217,9/1/19,12692,12191,501,3.9
21219,9/1/19,5456,5274,182,3.3
21221,9/1/19,6012,5776,236,3.9
21223,9/1/19,3892,3742,150,3.9
21225,9/1/19,6103,5869,234,3.8
21227,9/1/19,65784,63620,2164,3.3
21229,9/1/19,6223,6004,219,3.5
21231,9/1/19,7386,7015,371,5
21233,9/1/19,5730,5528,202,3.5
21235,9/1/19,13699,13054,645,4.7
21237,9/1/19,1982,1867,115,5.8
21239,9/1/19,14850,14427,423,2.8
22001,9/1/19,24053,22718,1335,5.6
22003,9/1/19,8928,8427,501,5.6
22005,9/1/19,63677,60924,2753,4.3
22007,9/1/19,8933,8392,541,6.1
22009,9/1/19,15254,14365,889,5.8
22011,9/1/19,14699,13938,761,5.2
22013,9/1/19,5535,5209,326,5.9
22015,9/1/19,57416,54860,2556,4.5
22017,9/1/19,102984,97334,5650,5.5
22019,9/1/19,105274,100733,4541,4.3
22021,9/1/19,3808,3578,230,6
22023,9/1/19,3905,3755,150,3.8
22025,9/1/19,3546,3327,219,6.2
22027,9/1/19,5840,5503,337,5.8
22029,9/1/19,7254,6803,451,6.2
22031,9/1/19,10863,10171,692,6.4
22033,9/1/19,229560,218879,10681,4.7
22035,9/1/19,1917,1734,183,9.5
22037,9/1/19,7964,7584,380,4.8
22039,9/1/19,11965,11246,719,6
22041,9/1/19,7532,6987,545,7.2
22043,9/1/19,8198,7728,470,5.7
22045,9/1/19,28297,26732,1565,5.5
22047,9/1/19,14037,13173,864,6.2
22049,9/1/19,6887,6556,331,4.8
22051,9/1/19,213041,203835,9206,4.3
22053,9/1/19,13317,12674,643,4.8
22055,9/1/19,113688,108580,5108,4.5
22057,9/1/19,42490,40540,1950,4.6
22059,9/1/19,6792,6496,296,4.4
22061,9/1/19,22125,20836,1289,5.8
22063,9/1/19,68552,65613,2939,4.3
22065,9/1/19,3597,3313,284,7.9
22067,9/1/19,10019,9220,799,8
22069,9/1/19,16861,15808,1053,6.2
22071,9/1/19,178350,169432,8918,5
22073,9/1/19,69869,66063,3806,5.4
22075,9/1/19,10125,9668,457,4.5
22077,9/1/19,9933,9383,550,5.5
22079,9/1/19,55265,52356,2909,5.3
22081,9/1/19,3788,3591,197,5.2
22083,9/1/19,8286,7766,520,6.3
22085,9/1/19,9367,8869,498,5.3
22087,9/1/19,19894,18881,1013,5.1
22089,9/1/19,25081,23940,1141,4.5
22091,9/1/19,4252,4005,247,5.8
22093,9/1/19,9203,8643,560,6.1
22095,9/1/19,19544,18436,1108,5.7
22097,9/1/19,32079,30013,2066,6.4
22099,9/1/19,22201,21068,1133,5.1
22101,9/1/19,19948,18766,1182,5.9
22103,9/1/19,119187,113973,5214,4.4
22105,9/1/19,55006,51904,3102,5.6
22107,9/1/19,1485,1372,113,7.6
22109,9/1/19,46873,44660,2213,4.7
22111,9/1/19,9144,8621,523,5.7
22113,9/1/19,24232,22992,1240,5.1
22115,9/1/19,16162,15185,977,6
22117,9/1/19,16618,15603,1015,6.1
22119,9/1/19,14447,13545,902,6.2
22121,9/1/19,13563,12933,630,4.6
22123,9/1/19,3681,3352,329,8.9
22125,9/1/19,5384,5154,230,4.3
22127,9/1/19,4948,4639,309,6.2
23001,9/1/19,55002,53705,1297,2.4
23003,9/1/19,29453,28468,985,3.3
23005,9/1/19,165786,162492,3294,2
23007,9/1/19,13885,13449,436,3.1
23009,9/1/19,30168,29549,619,2.1
23011,9/1/19,61705,60269,1436,2.3
23013,9/1/19,20078,19655,423,2.1
23015,9/1/19,17085,16720,365,2.1
23017,9/1/19,25851,25140,711,2.8
23019,9/1/19,76909,75018,1891,2.5
23021,9/1/19,7219,7025,194,2.7
23023,9/1/19,19462,19091,371,1.9
23025,9/1/19,22145,21395,750,3.4
23027,9/1/19,20539,20072,467,2.3
23029,9/1/19,13113,12672,441,3.4
23031,9/1/19,114203,111858,2345,2.1
24001,9/1/19,32578,30988,1590,4.9
24003,9/1/19,318034,309103,8931,2.8
24005,9/1/19,457967,442271,15696,3.4
24009,9/1/19,50675,49233,1442,2.8
24011,9/1/19,18048,17505,543,3
24013,9/1/19,95837,93338,2499,2.6
24015,9/1/19,53095,51198,1897,3.6
24017,9/1/19,88418,85471,2947,3.3
24019,9/1/19,15657,15037,620,4
24021,9/1/19,135504,131535,3969,2.9
24023,9/1/19,15872,15290,582,3.7
24025,9/1/19,141916,137554,4362,3.1
24027,9/1/19,189509,184705,4804,2.5
24029,9/1/19,9813,9478,335,3.4
24031,9/1/19,568637,553284,15353,2.7
24033,9/1/19,516247,498088,18159,3.5
24035,9/1/19,27639,26868,771,2.8
24037,9/1/19,57334,55654,1680,2.9
24039,9/1/19,9092,8608,484,5.3
24041,9/1/19,19093,18555,538,2.8
24043,9/1/19,74728,72161,2567,3.4
24045,9/1/19,52541,50457,2084,4
24047,9/1/19,25534,24360,1174,4.6
24510,9/1/19,290883,277012,13871,4.8
25001,9/1/19,117049,113991,3058,2.6
25003,9/1/19,64397,62472,1925,3
25005,9/1/19,302483,292607,9876,3.3
25007,9/1/19,10322,10094,228,2.2
25009,9/1/19,427239,415427,11812,2.8
25011,9/1/19,40967,40022,945,2.3
25013,9/1/19,228994,220407,8587,3.7
25015,9/1/19,90699,88335,2364,2.6
25017,9/1/19,923831,903375,20456,2.2
25019,9/1/19,8561,8417,144,1.7
25021,9/1/19,393391,383756,9635,2.4
25023,9/1/19,285174,277281,7893,2.8
25025,9/1/19,458696,447011,11685,2.5
25027,9/1/19,446865,433951,12914,2.9
26001,9/1/19,3926,3751,175,4.5
26003,9/1/19,3289,3127,162,4.9
26005,9/1/19,62057,60483,1574,2.5
26007,9/1/19,13253,12791,462,3.5
26009,9/1/19,10369,9998,371,3.6
26011,9/1/19,6065,5787,278,4.6
26013,9/1/19,3173,3035,138,4.3
26015,9/1/19,31306,30478,828,2.6
26017,9/1/19,49502,47725,1777,3.6
26019,9/1/19,8851,8547,304,3.4
26021,9/1/19,72828,70455,2373,3.3
26023,9/1/19,19329,18684,645,3.3
26025,9/1/19,61399,59207,2192,3.6
26027,9/1/19,24368,23508,860,3.5
26029,9/1/19,12848,12432,416,3.2
26031,9/1/19,10713,10387,326,3
26033,9/1/19,16045,15409,636,4
26035,9/1/19,11661,11155,506,4.3
26037,9/1/19,40875,39841,1034,2.5
26039,9/1/19,5581,5350,231,4.1
26041,9/1/19,17192,16584,608,3.5
26043,9/1/19,12112,11725,387,3.2
26045,9/1/19,56555,54989,1566,2.8
26047,9/1/19,17872,17288,584,3.3
26049,9/1/19,180056,173035,7021,3.9
26051,9/1/19,9909,9456,453,4.6
26053,9/1/19,5916,5671,245,4.1
26055,9/1/19,49992,48683,1309,2.6
26057,9/1/19,17761,17155,606,3.4
26059,9/1/19,20372,19668,704,3.5
26061,9/1/19,16493,15867,626,3.8
26063,9/1/19,15509,15037,472,3
26065,9/1/19,149632,145115,4517,3
26067,9/1/19,30166,29355,811,2.7
26069,9/1/19,10354,9941,413,4
26071,9/1/19,5101,4903,198,3.9
26073,9/1/19,34691,33540,1151,3.3
26075,9/1/19,72954,70668,2286,3.1
26077,9/1/19,132591,128632,3959,3
26079,9/1/19,7884,7579,305,3.9
26081,9/1/19,355687,346580,9107,2.6
26083,9/1/19,890,851,39,4.4
26085,9/1/19,3669,3482,187,5.1
26087,9/1/19,41561,39784,1777,4.3
26089,9/1/19,10589,10311,278,2.6
26091,9/1/19,46094,44677,1417,3.1
26093,9/1/19,105180,101907,3273,3.1
26095,9/1/19,2301,2204,97,4.2
26097,9/1/19,5765,5619,146,2.5
26099,9/1/19,453633,436149,17484,3.9
26101,9/1/19,10585,10160,425,4
26103,9/1/19,32698,31558,1140,3.5
26105,9/1/19,13672,13163,509,3.7
26107,9/1/19,18301,17605,696,3.8
26109,9/1/19,10955,10609,346,3.2
26111,9/1/19,39783,38558,1225,3.1
26113,9/1/19,6970,6725,245,3.5
26115,9/1/19,74172,71902,2270,3.1
26117,9/1/19,27914,27049,865,3.1
26119,9/1/19,2966,2805,161,5.4
26121,9/1/19,76013,73228,2785,3.7
26123,9/1/19,23350,22603,747,3.2
26125,9/1/19,686212,663726,22486,3.3
26127,9/1/19,12405,11929,476,3.8
26129,9/1/19,8073,7709,364,4.5
26131,9/1/19,2094,1997,97,4.6
26133,9/1/19,11183,10849,334,3
26135,9/1/19,3127,2982,145,4.6
26137,9/1/19,11529,11100,429,3.7
26139,9/1/19,159659,155671,3988,2.5
26141,9/1/19,4975,4748,227,4.6
26143,9/1/19,7805,7402,403,5.2
26145,9/1/19,85602,82415,3187,3.7
26147,9/1/19,76567,73377,3190,4.2
26149,9/1/19,27566,26633,933,3.4
26151,9/1/19,19517,18829,688,3.5
26153,9/1/19,3284,3130,154,4.7
26155,9/1/19,33094,31999,1095,3.3
26157,9/1/19,23619,22757,862,3.6
26159,9/1/19,34919,33680,1239,3.5
26161,9/1/19,197583,192220,5363,2.7
26163,9/1/19,813948,775810,38138,4.7
26165,9/1/19,14699,14192,507,3.4
27001,9/1/19,7124,6883,241,3.4
27003,9/1/19,199444,194323,5121,2.6
27005,9/1/19,18653,18179,474,2.5
27007,9/1/19,24647,23906,741,3
27009,9/1/19,22089,21477,612,2.8
27011,9/1/19,2512,2455,57,2.3
27013,9/1/19,41181,40199,982,2.4
27015,9/1/19,14443,14084,359,2.5
27017,9/1/19,17778,17209,569,3.2
27019,9/1/19,59237,57782,1455,2.5
27021,9/1/19,14761,14299,462,3.1
27023,9/1/19,6942,6756,186,2.7
27025,9/1/19,30062,29273,789,2.6
27027,9/1/19,36460,35585,875,2.4
27029,9/1/19,4433,4252,181,4.1
27031,9/1/19,3349,3272,77,2.3
27033,9/1/19,5924,5734,190,3.2
27035,9/1/19,32600,31658,942,2.9
27037,9/1/19,244138,238024,6114,2.5
27039,9/1/19,11911,11629,282,2.4
27041,9/1/19,21057,20577,480,2.3
27043,9/1/19,7171,6967,204,2.8
27045,9/1/19,11587,11329,258,2.2
27047,9/1/19,16174,15772,402,2.5
27049,9/1/19,27241,26636,605,2.2
27051,9/1/19,3275,3175,100,3.1
27053,9/1/19,714824,696773,18051,2.5
27055,9/1/19,10380,10113,267,2.6
27057,9/1/19,10147,9817,330,3.3
27059,9/1/19,21346,20741,605,2.8
27061,9/1/19,21753,20866,887,4.1
27063,9/1/19,5724,5590,134,2.3
27065,9/1/19,8914,8667,247,2.8
27067,9/1/19,24429,23827,602,2.5
27069,9/1/19,2372,2309,63,2.7
27071,9/1/19,5972,5673,299,5
27073,9/1/19,3538,3455,83,2.3
27075,9/1/19,5593,5452,141,2.5
27077,9/1/19,2417,2353,64,2.6
27079,9/1/19,16063,15661,402,2.5
27081,9/1/19,3283,3203,80,2.4
27083,9/1/19,14593,14245,348,2.4
27085,9/1/19,19287,18751,536,2.8
27087,9/1/19,2285,2207,78,3.4
27089,9/1/19,5360,5205,155,2.9
27091,9/1/19,9960,9668,292,2.9
27093,9/1/19,13328,12995,333,2.5
27095,9/1/19,12830,12416,414,3.2
27097,9/1/19,17328,16817,511,2.9
27099,9/1/19,20416,19906,510,2.5
27101,9/1/19,4847,4707,140,2.9
27103,9/1/19,21267,20802,465,2.2
27105,9/1/19,11349,11054,295,2.6
27107,9/1/19,3191,3104,87,2.7
27109,9/1/19,89276,87376,1900,2.1
27111,9/1/19,31582,30776,806,2.6
27113,9/1/19,8596,8396,200,2.3
27115,9/1/19,14979,14486,493,3.3
27117,9/1/19,4980,4871,109,2.2
27119,9/1/19,16601,16162,439,2.6
27121,9/1/19,6559,6407,152,2.3
27123,9/1/19,292994,284985,8009,2.7
27125,9/1/19,2193,2119,74,3.4
27127,9/1/19,7635,7439,196,2.6
27129,9/1/19,8644,8391,253,2.9
27131,9/1/19,37381,36460,921,2.5
27133,9/1/19,5678,5572,106,1.9
27135,9/1/19,7793,7586,207,2.7
27137,9/1/19,101910,98753,3157,3.1
27139,9/1/19,84421,82403,2018,2.4
27141,9/1/19,52652,51327,1325,2.5
27143,9/1/19,8594,8368,226,2.6
27145,9/1/19,91328,89033,2295,2.5
27147,9/1/19,21389,20843,546,2.6
27149,9/1/19,5445,5330,115,2.1
27151,9/1/19,4905,4742,163,3.3
27153,9/1/19,13494,13146,348,2.6
27155,9/1/19,1745,1702,43,2.5
27157,9/1/19,12372,12074,298,2.4
27159,9/1/19,5860,5656,204,3.5
27161,9/1/19,9161,8908,253,2.8
27163,9/1/19,144850,141277,3573,2.5
27165,9/1/19,6319,6142,177,2.8
27167,9/1/19,3477,3397,80,2.3
27169,9/1/19,28912,28195,717,2.5
27171,9/1/19,76126,74292,1834,2.4
27173,9/1/19,5359,5218,141,2.6
28001,9/1/19,11296,10531,765,6.8
28003,9/1/19,15778,15024,754,4.8
28005,9/1/19,4410,4101,309,7
28007,9/1/19,7028,6618,410,5.8
28009,9/1/19,3068,2871,197,6.4
28011,9/1/19,12197,11377,820,6.7
28013,9/1/19,5641,5335,306,5.4
28015,9/1/19,3486,3260,226,6.5
28017,9/1/19,6913,6526,387,5.6
28019,9/1/19,3743,3549,194,5.2
28021,9/1/19,3031,2711,320,10.6
28023,9/1/19,5889,5524,365,6.2
28025,9/1/19,7812,7253,559,7.2
28027,9/1/19,8321,7727,594,7.1
28029,9/1/19,11185,10466,719,6.4
28031,9/1/19,8190,7791,399,4.9
28033,9/1/19,91572,87516,4056,4.4
28035,9/1/19,33292,31617,1675,5
28037,9/1/19,2788,2589,199,7.1
28039,9/1/19,8827,8172,655,7.4
28041,9/1/19,4338,4010,328,7.6
28043,9/1/19,9358,8865,493,5.3
28045,9/1/19,18742,17724,1018,5.4
28047,9/1/19,86343,81864,4479,5.2
28049,9/1/19,106949,101404,5545,5.2
28051,9/1/19,5674,5126,548,9.7
28053,9/1/19,2208,2000,208,9.4
28055,9/1/19,383,348,35,9.1
28057,9/1/19,10562,10067,495,4.7
28059,9/1/19,58361,54907,3454,5.9
28061,9/1/19,6149,5747,402,6.5
28063,9/1/19,2022,1718,304,15
28065,9/1/19,4105,3838,267,6.5
28067,9/1/19,26211,24805,1406,5.4
28069,9/1/19,3533,3242,291,8.2
28071,9/1/19,29418,28134,1284,4.4
28073,9/1/19,30742,29477,1265,4.1
28075,9/1/19,30335,28679,1656,5.5
28077,9/1/19,4615,4309,306,6.6
28079,9/1/19,7918,7481,437,5.5
28081,9/1/19,41420,39571,1849,4.5
28083,9/1/19,9992,9276,716,7.2
28085,9/1/19,14603,13822,781,5.3
28087,9/1/19,25704,24410,1294,5
28089,9/1/19,53268,50961,2307,4.3
28091,9/1/19,9930,9402,528,5.3
28093,9/1/19,14553,13700,853,5.9
28095,9/1/19,15628,14784,844,5.4
28097,9/1/19,3905,3673,232,5.9
28099,9/1/19,10291,9678,613,6
28101,9/1/19,8858,8386,472,5.3
28103,9/1/19,3785,3503,282,7.5
28105,9/1/19,23094,21816,1278,5.5
28107,9/1/19,12556,11767,789,6.3
28109,9/1/19,23748,22531,1217,5.1
28111,9/1/19,4293,4008,285,6.6
28113,9/1/19,14508,13576,932,6.4
28115,9/1/19,14859,14201,658,4.4
28117,9/1/19,11340,10796,544,4.8
28119,9/1/19,2360,2177,183,7.8
28121,9/1/19,76162,73133,3029,4
28123,9/1/19,12617,12058,559,4.4
28125,9/1/19,1595,1478,117,7.3
28127,9/1/19,10728,10190,538,5
28129,9/1/19,6789,6451,338,5
28131,9/1/19,6863,6418,445,6.5
28133,9/1/19,7692,7039,653,8.5
28135,9/1/19,5185,4911,274,5.3
28137,9/1/19,12417,11706,711,5.7
28139,9/1/19,9407,8930,477,5.1
28141,9/1/19,8504,8065,439,5.2
28143,9/1/19,4432,4174,258,5.8
28145,9/1/19,14312,13708,604,4.2
28147,9/1/19,4890,4535,355,7.3
28149,9/1/19,20317,19143,1174,5.8
28151,9/1/19,16887,15680,1207,7.1
28153,9/1/19,7451,6991,460,6.2
28155,9/1/19,4007,3789,218,5.4
28157,9/1/19,2827,2536,291,10.3
28159,9/1/19,7421,7014,407,5.5
28161,9/1/19,5019,4747,272,5.4
28163,9/1/19,9388,8805,583,6.2
29001,9/1/19,10238,9938,300,2.9
29003,9/1/19,9679,9484,195,2
29005,9/1/19,2603,2539,64,2.5
29007,9/1/19,10529,10253,276,2.6
29009,9/1/19,15405,14958,447,2.9
29011,9/1/19,5127,4995,132,2.6
29013,9/1/19,7813,7562,251,3.2
29015,9/1/19,7226,6867,359,5
29017,9/1/19,5409,5247,162,3
29019,9/1/19,99063,97222,1841,1.9
29021,9/1/19,44469,43410,1059,2.4
29023,9/1/19,17983,17383,600,3.3
29025,9/1/19,4304,4206,98,2.3
29027,9/1/19,21251,20786,465,2.2
29029,9/1/19,19198,18539,659,3.4
29031,9/1/19,40816,39793,1023,2.5
29033,9/1/19,4624,4512,112,2.4
29035,9/1/19,2575,2483,92,3.6
29037,9/1/19,54836,53566,1270,2.3
29039,9/1/19,5760,5593,167,2.9
29041,9/1/19,3665,3585,80,2.2
29043,9/1/19,45135,44164,971,2.2
29045,9/1/19,3137,3063,74,2.4
29047,9/1/19,136805,133724,3081,2.3
29049,9/1/19,10673,10432,241,2.3
29051,9/1/19,38934,38175,759,1.9
29053,9/1/19,7507,7318,189,2.5
29055,9/1/19,10988,10668,320,2.9
29057,9/1/19,3514,3417,97,2.8
29059,9/1/19,7090,6761,329,4.6
29061,9/1/19,4028,3936,92,2.3
29063,9/1/19,4755,4649,106,2.2
29065,9/1/19,6302,6126,176,2.8
29067,9/1/19,5320,4743,577,10.8
29069,9/1/19,11277,10809,468,4.2
29071,9/1/19,53179,51896,1283,2.4
29073,9/1/19,7694,7517,177,2.3
29075,9/1/19,3389,3316,73,2.2
29077,9/1/19,152156,148785,3371,2.2
29079,9/1/19,4300,4189,111,2.6
29081,9/1/19,3672,3569,103,2.8
29083,9/1/19,9638,9374,264,2.7
29085,9/1/19,3949,3801,148,3.7
29087,9/1/19,2501,2449,52,2.1
29089,9/1/19,4856,4739,117,2.4
29091,9/1/19,16678,15983,695,4.2
29093,9/1/19,3471,3348,123,3.5
29095,9/1/19,363860,352946,10914,3
29097,9/1/19,57220,55802,1418,2.5
29099,9/1/19,118438,115599,2839,2.4
29101,9/1/19,23254,22593,661,2.8
29103,9/1/19,1740,1705,35,2
29105,9/1/19,18102,16095,2007,11.1
29107,9/1/19,16726,16335,391,2.3
29109,9/1/19,17910,17433,477,2.7
29111,9/1/19,4943,4813,130,2.6
29113,9/1/19,28366,27665,701,2.5
29115,9/1/19,5037,4849,188,3.7
29117,9/1/19,7202,7063,139,1.9
29119,9/1/19,10695,10413,282,2.6
29121,9/1/19,7419,7230,189,2.5
29123,9/1/19,5434,5292,142,2.6
29125,9/1/19,3821,3726,95,2.5
29127,9/1/19,14545,14203,342,2.4
29129,9/1/19,1809,1767,42,2.3
29131,9/1/19,12398,12086,312,2.5
29133,9/1/19,5685,5500,185,3.3
29135,9/1/19,7194,7035,159,2.2
29137,9/1/19,3890,3769,121,3.1
29139,9/1/19,5716,5590,126,2.2
29141,9/1/19,8051,7795,256,3.2
29143,9/1/19,8064,7784,280,3.5
29145,9/1/19,27218,26515,703,2.6
29147,9/1/19,10900,10649,251,2.3
29149,9/1/19,4012,3848,164,4.1
29151,9/1/19,7018,6903,115,1.6
29153,9/1/19,3434,3249,185,5.4
29155,9/1/19,6301,6056,245,3.9
29157,9/1/19,9847,9642,205,2.1
29159,9/1/19,20862,20323,539,2.6
29161,9/1/19,19791,19276,515,2.6
29163,9/1/19,7419,7198,221,3
29165,9/1/19,58901,57659,1242,2.1
29167,9/1/19,14589,14116,473,3.2
29169,9/1/19,14680,14091,589,4
29171,9/1/19,2186,2116,70,3.2
29173,9/1/19,5623,5500,123,2.2
29175,9/1/19,10401,10071,330,3.2
29177,9/1/19,10984,10687,297,2.7
29179,9/1/19,3041,2953,88,2.9
29181,9/1/19,4974,4800,174,3.5
29183,9/1/19,227777,223159,4618,2
29185,9/1/19,3656,3520,136,3.7
29186,9/1/19,9176,8997,179,2
29187,9/1/19,26498,25728,770,2.9
29189,9/1/19,534934,521484,13450,2.5
29195,9/1/19,10476,10228,248,2.4
29197,9/1/19,1898,1830,68,3.6
29199,9/1/19,2338,2283,55,2.4
29201,9/1/19,19765,19191,574,2.9
29203,9/1/19,3169,3048,121,3.8
29205,9/1/19,3010,2955,55,1.8
29207,9/1/19,12896,12446,450,3.5
29209,9/1/19,13938,13526,412,3
29211,9/1/19,2600,2526,74,2.8
29213,9/1/19,27258,26466,792,2.9
29215,9/1/19,8965,8636,329,3.7
29217,9/1/19,9238,8987,251,2.7
29219,9/1/19,17943,17557,386,2.2
29221,9/1/19,10252,9916,336,3.3
29223,9/1/19,5234,5051,183,3.5
29225,9/1/19,17285,16731,554,3.2
29227,9/1/19,1137,1114,23,2
29229,9/1/19,7566,7072,494,6.5
29510,9/1/19,153343,148480,4863,3.2
30001,9/1/19,5056,4932,124,2.5
30003,9/1/19,4854,4546,308,6.3
30005,9/1/19,2509,2435,74,2.9
30007,9/1/19,2577,2491,86,3.3
30009,9/1/19,5485,5340,145,2.6
30011,9/1/19,661,646,15,2.3
30013,9/1/19,37879,36721,1158,3.1
30015,9/1/19,2460,2400,60,2.4
30017,9/1/19,6085,5937,148,2.4
30019,9/1/19,883,866,17,1.9
30021,9/1/19,4534,4421,113,2.5
30023,9/1/19,5001,4865,136,2.7
30025,9/1/19,1696,1667,29,1.7
30027,9/1/19,6037,5891,146,2.4
30029,9/1/19,47813,46049,1764,3.7
30031,9/1/19,69274,67923,1351,2
30033,9/1/19,749,732,17,2.3
30035,9/1/19,5929,5591,338,5.7
30037,9/1/19,371,357,14,3.8
30039,9/1/19,1635,1564,71,4.3
30041,9/1/19,7678,7421,257,3.3
30043,9/1/19,5661,5499,162,2.9
30045,9/1/19,1002,978,24,2.4
30047,9/1/19,13298,12815,483,3.6
30049,9/1/19,35586,34633,953,2.7
30051,9/1/19,967,943,24,2.5
30053,9/1/19,8132,7646,486,6
30055,9/1/19,970,950,20,2.1
30057,9/1/19,4455,4331,124,2.8
30059,9/1/19,930,904,26,2.8
30061,9/1/19,1793,1710,83,4.6
30063,9/1/19,64326,62579,1747,2.7
30065,9/1/19,2272,2189,83,3.7
30067,9/1/19,9105,8878,227,2.5
30069,9/1/19,283,275,8,2.8
30071,9/1/19,1902,1849,53,2.8
30073,9/1/19,2643,2560,83,3.1
30075,9/1/19,984,963,21,2.1
30077,9/1/19,3025,2928,97,3.2
30079,9/1/19,485,465,20,4.1
30081,9/1/19,20279,19613,666,3.3
30083,9/1/19,5833,5664,169,2.9
30085,9/1/19,4455,4292,163,3.7
30087,9/1/19,3831,3669,162,4.2
30089,9/1/19,4891,4675,216,4.4
30091,9/1/19,1738,1700,38,2.2
30093,9/1/19,17009,16465,544,3.2
30095,9/1/19,5301,5164,137,2.6
30097,9/1/19,1830,1788,42,2.3
30099,9/1/19,2762,2686,76,2.8
30101,9/1/19,2112,2065,47,2.2
30103,9/1/19,341,333,8,2.3
30105,9/1/19,4101,3968,133,3.2
30107,9/1/19,798,774,24,3
30109,9/1/19,462,447,15,3.2
30111,9/1/19,81865,79527,2338,2.9
31001,9/1/19,16777,16314,463,2.8
31003,9/1/19,3496,3416,80,2.3
31005,9/1/19,215,202,13,6
31007,9/1/19,376,363,13,3.5
31009,9/1/19,252,241,11,4.4
31011,9/1/19,2881,2812,69,2.4
31013,9/1/19,5381,5221,160,3
31015,9/1/19,1062,1035,27,2.5
31017,9/1/19,1349,1309,40,3
31019,9/1/19,27472,26802,670,2.4
31021,9/1/19,3403,3312,91,2.7
31023,9/1/19,4536,4423,113,2.5
31025,9/1/19,13453,13070,383,2.8
31027,9/1/19,4441,4336,105,2.4
31029,9/1/19,2201,2150,51,2.3
31031,9/1/19,3325,3254,71,2.1
31033,9/1/19,4339,4177,162,3.7
31035,9/1/19,3244,3160,84,2.6
31037,9/1/19,5526,5384,142,2.6
31039,9/1/19,4589,4475,114,2.5
31041,9/1/19,6243,6096,147,2.4
31043,9/1/19,10721,10396,325,3
31045,9/1/19,5004,4871,133,2.7
31047,9/1/19,12923,12578,345,2.7
31049,9/1/19,941,903,38,4
31051,9/1/19,2986,2910,76,2.5
31053,9/1/19,19438,18926,512,2.6
31055,9/1/19,298502,289683,8819,3
31057,9/1/19,1140,1111,29,2.5
31059,9/1/19,3066,2995,71,2.3
31061,9/1/19,1402,1355,47,3.4
31063,9/1/19,1590,1537,53,3.3
31065,9/1/19,2517,2450,67,2.7
31067,9/1/19,10909,10589,320,2.9
31069,9/1/19,1047,1013,34,3.2
31071,9/1/19,1173,1146,27,2.3
31073,9/1/19,1054,1025,29,2.8
31075,9/1/19,413,400,13,3.1
31077,9/1/19,1175,1142,33,2.8
31079,9/1/19,31813,30894,919,2.9
31081,9/1/19,4745,4598,147,3.1
31083,9/1/19,1780,1731,49,2.8
31085,9/1/19,614,599,15,2.4
31087,9/1/19,1244,1208,36,2.9
31089,9/1/19,5603,5474,129,2.3
31091,9/1/19,433,420,13,3
31093,9/1/19,3326,3233,93,2.8
31095,9/1/19,4036,3936,100,2.5
31097,9/1/19,2028,1966,62,3.1
31099,9/1/19,3771,3687,84,2.2
31101,9/1/19,4613,4419,194,4.2
31103,9/1/19,566,550,16,2.8
31105,9/1/19,1996,1938,58,2.9
31107,9/1/19,4465,4352,113,2.5
31109,9/1/19,177441,172868,4573,2.6
31111,9/1/19,18274,17671,603,3.3
31113,9/1/19,465,447,18,3.9
31115,9/1/19,401,385,16,4
31117,9/1/19,445,434,11,2.5
31119,9/1/19,19791,19308,483,2.4
31121,9/1/19,3977,3864,113,2.8
31123,9/1/19,2562,2497,65,2.5
31125,9/1/19,1932,1885,47,2.4
31127,9/1/19,3579,3466,113,3.2
31129,9/1/19,2359,2301,58,2.5
31131,9/1/19,8362,8137,225,2.7
31133,9/1/19,1425,1391,34,2.4
31135,9/1/19,1772,1736,36,2
31137,9/1/19,4863,4736,127,2.6
31139,9/1/19,4059,3959,100,2.5
31141,9/1/19,17693,17234,459,2.6
31143,9/1/19,2873,2797,76,2.6
31145,9/1/19,5765,5622,143,2.5
31147,9/1/19,4192,4078,114,2.7
31149,9/1/19,865,840,25,2.9
31151,9/1/19,7210,7008,202,2.8
31153,9/1/19,96399,93794,2605,2.7
31155,9/1/19,11061,10780,281,2.5
31157,9/1/19,18178,17604,574,3.2
31159,9/1/19,8860,8622,238,2.7
31161,9/1/19,2610,2543,67,2.6
31163,9/1/19,1635,1588,47,2.9
31165,9/1/19,729,711,18,2.5
31167,9/1/19,3491,3415,76,2.2
31169,9/1/19,2681,2612,69,2.6
31171,9/1/19,414,401,13,3.1
31173,9/1/19,3048,2921,127,4.2
31175,9/1/19,2067,2011,56,2.7
31177,9/1/19,11203,10913,290,2.6
31179,9/1/19,5751,5615,136,2.4
31181,9/1/19,1647,1591,56,3.4
31183,9/1/19,507,491,16,3.2
31185,9/1/19,7290,7112,178,2.4
32001,9/1/19,11247,10900,347,3.1
32003,9/1/19,1138060,1093454,44606,3.9
32005,9/1/19,23532,22742,790,3.4
32007,9/1/19,27151,26436,715,2.6
32009,9/1/19,475,457,18,3.8
32011,9/1/19,1150,1122,28,2.4
32013,9/1/19,8428,8204,224,2.7
32015,9/1/19,3232,3138,94,2.9
32017,9/1/19,2189,2115,74,3.4
32019,9/1/19,23357,22345,1012,4.3
32021,9/1/19,2037,1964,73,3.6
32023,9/1/19,17607,16738,869,4.9
32027,9/1/19,2631,2540,91,3.5
32029,9/1/19,2052,1986,66,3.2
32031,9/1/19,258102,250421,7681,3
32033,9/1/19,4762,4645,117,2.5
32510,9/1/19,26399,25466,933,3.5
33001,9/1/19,32001,31283,718,2.2
33003,9/1/19,24332,23791,541,2.2
33005,9/1/19,40703,39724,979,2.4
33007,9/1/19,14824,14464,360,2.4
33009,9/1/19,49738,48697,1041,2.1
33011,9/1/19,241396,235651,5745,2.4
33013,9/1/19,83562,81820,1742,2.1
33015,9/1/19,188414,183863,4551,2.4
33017,9/1/19,74686,73035,1651,2.2
33019,9/1/19,23034,22529,505,2.2
34001,9/1/19,121817,116272,5545,4.6
34003,9/1/19,482308,468519,13789,2.9
34005,9/1/19,231555,224312,7243,3.1
34007,9/1/19,253913,244006,9907,3.9
34009,9/1/19,48624,46586,2038,4.2
34011,9/1/19,65097,61869,3228,5
34013,9/1/19,368035,351848,16187,4.4
34015,9/1/19,150205,144950,5255,3.5
34017,9/1/19,361011,349459,11552,3.2
34019,9/1/19,64508,62817,1691,2.6
34021,9/1/19,202650,196325,6325,3.1
34023,9/1/19,439020,425770,13250,3
34025,9/1/19,329152,319337,9815,3
34027,9/1/19,256177,249190,6987,2.7
34029,9/1/19,275085,265782,9303,3.4
34031,9/1/19,241585,231823,9762,4
34033,9/1/19,29154,27814,1340,4.6
34035,9/1/19,170987,165955,5032,2.9
34037,9/1/19,73777,71465,2312,3.1
34039,9/1/19,275394,265593,9801,3.6
34041,9/1/19,56153,54449,1704,3
35001,9/1/19,334563,320103,14460,4.3
35003,9/1/19,1198,1138,60,5
35005,9/1/19,27033,25729,1304,4.8
35006,9/1/19,8968,8425,543,6.1
35007,9/1/19,5225,4978,247,4.7
35009,9/1/19,21651,20749,902,4.2
35011,9/1/19,787,757,30,3.8
35013,9/1/19,97576,92545,5031,5.2
35015,9/1/19,34794,33743,1051,3
35017,9/1/19,12059,11497,562,4.7
35019,9/1/19,1560,1488,72,4.6
35021,9/1/19,271,257,14,5.2
35023,9/1/19,2111,2017,94,4.5
35025,9/1/19,31041,29844,1197,3.9
35027,9/1/19,9049,8674,375,4.1
35028,9/1/19,9739,9456,283,2.9
35029,9/1/19,10585,9715,870,8.2
35031,9/1/19,24162,22543,1619,6.7
35033,9/1/19,2210,2095,115,5.2
35035,9/1/19,24671,23532,1139,4.6
35037,9/1/19,3218,3061,157,4.9
35039,9/1/19,17035,16207,828,4.9
35041,9/1/19,7999,7653,346,4.3
35043,9/1/19,66598,63463,3135,4.7
35045,9/1/19,52136,49271,2865,5.5
35047,9/1/19,10878,10264,614,5.6
35049,9/1/19,75124,72339,2785,3.7
35051,9/1/19,3860,3631,229,5.9
35053,9/1/19,6449,6080,369,5.7
35055,9/1/19,14913,14065,848,5.7
35057,9/1/19,5759,5402,357,6.2
35059,9/1/19,1861,1801,60,3.2
35061,9/1/19,30809,29182,1627,5.3
36001,9/1/19,157582,152030,5552,3.5
36003,9/1/19,19825,18931,894,4.5
36005,9/1/19,595001,566480,28521,4.8
36007,9/1/19,83254,79680,3574,4.3
36009,9/1/19,33925,32479,1446,4.3
36011,9/1/19,36142,34851,1291,3.6
36013,9/1/19,54596,52329,2267,4.2
36015,9/1/19,35206,33825,1381,3.9
36017,9/1/19,22104,21284,820,3.7
36019,9/1/19,36488,35086,1402,3.8
36021,9/1/19,31551,30662,889,2.8
36023,9/1/19,22996,22089,907,3.9
36025,9/1/19,19222,18462,760,4
36027,9/1/19,143854,138774,5080,3.5
36029,9/1/19,442364,425114,17250,3.9
36031,9/1/19,17045,16444,601,3.5
36033,9/1/19,19788,18985,803,4.1
36035,9/1/19,22681,21677,1004,4.4
36037,9/1/19,29914,28928,986,3.3
36039,9/1/19,20198,19416,782,3.9
36041,9/1/19,2271,2187,84,3.7
36043,9/1/19,27668,26579,1089,3.9
36045,9/1/19,43876,41812,2064,4.7
36047,9/1/19,1193642,1150503,43139,3.6
36049,9/1/19,11695,11218,477,4.1
36051,9/1/19,30866,29724,1142,3.7
36053,9/1/19,32947,31648,1299,3.9
36055,9/1/19,361831,347428,14403,4
36057,9/1/19,22438,21452,986,4.4
36059,9/1/19,708021,684035,23986,3.4
36061,9/1/19,908764,880362,28402,3.1
36063,9/1/19,98734,94581,4153,4.2
36065,9/1/19,100627,96678,3949,3.9
36067,9/1/19,221432,213134,8298,3.7
36069,9/1/19,55463,53554,1909,3.4
36071,9/1/19,185148,178250,6898,3.7
36073,9/1/19,17666,16972,694,3.9
36075,9/1/19,52945,50444,2501,4.7
36077,9/1/19,28203,27195,1008,3.6
36079,9/1/19,51080,49241,1839,3.6
36081,9/1/19,1136055,1101224,34831,3.1
36083,9/1/19,81051,78230,2821,3.5
36085,9/1/19,221536,214030,7506,3.4
36087,9/1/19,155035,149597,5438,3.5
36089,9/1/19,43961,41913,2048,4.7
36091,9/1/19,118958,115224,3734,3.1
36093,9/1/19,76000,73267,2733,3.6
36095,9/1/19,14637,14080,557,3.8
36097,9/1/19,8220,7940,280,3.4
36099,9/1/19,16118,15580,538,3.3
36101,9/1/19,42832,41170,1662,3.9
36103,9/1/19,776821,750203,26618,3.4
36105,9/1/19,37070,35761,1309,3.5
36107,9/1/19,22668,21843,825,3.6
36109,9/1/19,49325,47512,1813,3.7
36111,9/1/19,88179,85113,3066,3.5
36113,9/1/19,31343,30221,1122,3.6
36115,9/1/19,28132,27187,945,3.4
36117,9/1/19,44053,42516,1537,3.5
36119,9/1/19,483459,465664,17795,3.7
36121,9/1/19,18310,17701,609,3.3
36123,9/1/19,12014,11636,378,3.1
37001,9/1/19,82832,80042,2790,3.4
37003,9/1/19,18129,17595,534,2.9
37005,9/1/19,4455,4276,179,4
37007,9/1/19,10773,10359,414,3.8
37009,9/1/19,13064,12673,391,3
37011,9/1/19,7757,7522,235,3
37013,9/1/19,19432,18627,805,4.1
37015,9/1/19,7716,7385,331,4.3
37017,9/1/19,14591,13958,633,4.3
37019,9/1/19,54829,52338,2491,4.5
37021,9/1/19,142784,139040,3744,2.6
37023,9/1/19,41351,39970,1381,3.3
37025,9/1/19,110458,106902,3556,3.2
37027,9/1/19,36870,35555,1315,3.6
37029,9/1/19,4614,4467,147,3.2
37031,9/1/19,32289,31192,1097,3.4
37033,9/1/19,9909,9515,394,4
37035,9/1/19,79613,77079,2534,3.2
37037,9/1/19,35986,34928,1058,2.9
37039,9/1/19,11243,10806,437,3.9
37041,9/1/19,5435,5211,224,4.1
37043,9/1/19,4174,4007,167,4
37045,9/1/19,48598,46805,1793,3.7
37047,9/1/19,23085,22080,1005,4.4
37049,9/1/19,42152,40655,1497,3.6
37051,9/1/19,128690,122832,5858,4.6
37053,9/1/19,14132,13691,441,3.1
37055,9/1/19,20965,20291,674,3.2
37057,9/1/19,82033,79337,2696,3.3
37059,9/1/19,20920,20282,638,3
37061,9/1/19,25195,24312,883,3.5
37063,9/1/19,172846,167627,5219,3
37065,9/1/19,21184,20052,1132,5.3
37067,9/1/19,190453,184139,6314,3.3
37069,9/1/19,31685,30560,1125,3.6
37071,9/1/19,112459,108603,3856,3.4
37073,9/1/19,5345,5150,195,3.6
37075,9/1/19,3280,3133,147,4.5
37077,9/1/19,30080,29167,913,3
37079,9/1/19,9494,9180,314,3.3
37081,9/1/19,265865,256117,9748,3.7
37083,9/1/19,20307,19217,1090,5.4
37085,9/1/19,53923,51739,2184,4.1
37087,9/1/19,30392,29511,881,2.9
37089,9/1/19,55879,54288,1591,2.8
37091,9/1/19,9172,8751,421,4.6
37093,9/1/19,20287,19364,923,4.5
37095,9/1/19,1916,1806,110,5.7
37097,9/1/19,90628,87695,2933,3.2
37099,9/1/19,20530,19839,691,3.4
37101,9/1/19,100262,97030,3232,3.2
37103,9/1/19,4380,4236,144,3.3
37105,9/1/19,26089,25042,1047,4
37107,9/1/19,27903,26955,948,3.4
37109,9/1/19,44014,42657,1357,3.1
37111,9/1/19,20909,20178,731,3.5
37113,9/1/19,15905,15387,518,3.3
37115,9/1/19,10324,9988,336,3.3
37117,9/1/19,9038,8634,404,4.5
37119,9/1/19,630299,609739,20560,3.3
37121,9/1/19,6134,5900,234,3.8
37123,9/1/19,11589,11162,427,3.7
37125,9/1/19,43122,41690,1432,3.3
37127,9/1/19,43237,41332,1905,4.4
37129,9/1/19,125763,121912,3851,3.1
37131,9/1/19,7695,7326,369,4.8
37133,9/1/19,65232,62598,2634,4
37135,9/1/19,79657,77388,2269,2.8
37137,9/1/19,5368,5193,175,3.3
37139,9/1/19,16695,16041,654,3.9
37141,9/1/19,29177,28187,990,3.4
37143,9/1/19,4937,4720,217,4.4
37145,9/1/19,18572,17869,703,3.8
37147,9/1/19,91113,87651,3462,3.8
37149,9/1/19,9209,8897,312,3.4
37151,9/1/19,66966,64744,2222,3.3
37153,9/1/19,16680,15882,798,4.8
37155,9/1/19,50113,47674,2439,4.9
37157,9/1/19,40574,38995,1579,3.9
37159,9/1/19,66998,64622,2376,3.5
37161,9/1/19,25431,24314,1117,4.4
37163,9/1/19,28740,27755,985,3.4
37165,9/1/19,11441,10755,686,6
37167,9/1/19,30499,29449,1050,3.4
37169,9/1/19,22001,21313,688,3.1
37171,9/1/19,34171,33044,1127,3.3
37173,9/1/19,7167,6937,230,3.2
37175,9/1/19,14797,14323,474,3.2
37177,9/1/19,1518,1445,73,4.8
37179,9/1/19,125377,121539,3838,3.1
37181,9/1/19,17534,16594,940,5.4
37183,9/1/19,604029,586183,17846,3
37185,9/1/19,6641,6300,341,5.1
37187,9/1/19,4471,4247,224,5
37189,9/1/19,30275,29374,901,3
37191,9/1/19,51747,49852,1895,3.7
37193,9/1/19,29384,28322,1062,3.6
37195,9/1/19,35032,33156,1876,5.4
37197,9/1/19,17904,17370,534,3
37199,9/1/19,8586,8307,279,3.2
38001,9/1/19,1071,1051,20,1.9
38003,9/1/19,5151,5052,99,1.9
38005,9/1/19,2306,2234,72,3.1
38007,9/1/19,500,491,9,1.8
38009,9/1/19,2939,2877,62,2.1
38011,9/1/19,1710,1686,24,1.4
38013,9/1/19,1039,1019,20,1.9
38015,9/1/19,48800,47912,888,1.8
38017,9/1/19,102572,100831,1741,1.7
38019,9/1/19,1914,1878,36,1.9
38021,9/1/19,2278,2238,40,1.8
38023,9/1/19,1417,1397,20,1.4
38025,9/1/19,3217,3173,44,1.4
38027,9/1/19,1224,1190,34,2.8
38029,9/1/19,1427,1392,35,2.5
38031,9/1/19,1489,1459,30,2
38033,9/1/19,825,812,13,1.6
38035,9/1/19,37117,36499,618,1.7
38037,9/1/19,1183,1165,18,1.5
38039,9/1/19,1021,1002,19,1.9
38041,9/1/19,1370,1347,23,1.7
38043,9/1/19,1230,1202,28,2.3
38045,9/1/19,2064,2033,31,1.5
38047,9/1/19,871,858,13,1.5
38049,9/1/19,3034,2966,68,2.2
38051,9/1/19,1107,1082,25,2.3
38053,9/1/19,10430,10271,159,1.5
38055,9/1/19,4647,4544,103,2.2
38057,9/1/19,3509,3412,97,2.8
38059,9/1/19,16016,15677,339,2.1
38061,9/1/19,7450,7362,88,1.2
38063,9/1/19,1387,1356,31,2.2
38065,9/1/19,852,832,20,2.3
38067,9/1/19,3347,3260,87,2.6
38069,9/1/19,1651,1611,40,2.4
38071,9/1/19,5558,5441,117,2.1
38073,9/1/19,2796,2758,38,1.4
38075,9/1/19,1216,1193,23,1.9
38077,9/1/19,8498,8349,149,1.8
38079,9/1/19,4486,4250,236,5.3
38081,9/1/19,2639,2599,40,1.5
38083,9/1/19,671,652,19,2.8
38085,9/1/19,1233,1189,44,3.6
38087,9/1/19,402,393,9,2.2
38089,9/1/19,18404,18095,309,1.7
38091,9/1/19,974,958,16,1.6
38093,9/1/19,10144,9971,173,1.7
38095,9/1/19,1111,1085,26,2.3
38097,9/1/19,4356,4266,90,2.1
38099,9/1/19,5104,4976,128,2.5
38101,9/1/19,31367,30762,605,1.9
38103,9/1/19,1900,1855,45,2.4
38105,9/1/19,24873,24499,374,1.5
39001,9/1/19,10592,9974,618,5.8
39003,9/1/19,47614,45771,1843,3.9
39005,9/1/19,26733,25730,1003,3.8
39007,9/1/19,44533,42612,1921,4.3
39009,9/1/19,28992,27577,1415,4.9
39011,9/1/19,24703,23966,737,3
39013,9/1/19,29965,28441,1524,5.1
39015,9/1/19,19624,18735,889,4.5
39017,9/1/19,195975,188665,7310,3.7
39019,9/1/19,12860,12317,543,4.2
39021,9/1/19,19864,19156,708,3.6
39023,9/1/19,62697,60167,2530,4
39025,9/1/19,107288,103469,3819,3.6
39027,9/1/19,17679,16902,777,4.4
39029,9/1/19,47472,45333,2139,4.5
39031,9/1/19,14351,13568,783,5.5
39033,9/1/19,18157,17365,792,4.4
39035,9/1/19,616686,592833,23853,3.9
39037,9/1/19,25520,24622,898,3.5
39039,9/1/19,17999,17288,711,4
39041,9/1/19,110819,107286,3533,3.2
39043,9/1/19,37862,36335,1527,4
39045,9/1/19,78036,75246,2790,3.6
39047,9/1/19,13676,13162,514,3.8
39049,9/1/19,699910,675266,24644,3.5
39051,9/1/19,22275,21487,788,3.5
39053,9/1/19,11746,11155,591,5
39055,9/1/19,49543,48012,1531,3.1
39057,9/1/19,83272,80211,3061,3.7
39059,9/1/19,18450,17570,880,4.8
39061,9/1/19,418568,402842,15726,3.8
39063,9/1/19,41688,40391,1297,3.1
39065,9/1/19,13639,13060,579,4.2
39067,9/1/19,6743,6406,337,5
39069,9/1/19,13176,12689,487,3.7
39071,9/1/19,16876,16063,813,4.8
39073,9/1/19,13054,12541,513,3.9
39075,9/1/19,20666,20047,619,3
39077,9/1/19,27697,26431,1266,4.6
39079,9/1/19,12486,11821,665,5.3
39081,9/1/19,27828,26257,1571,5.6
39083,9/1/19,31499,30344,1155,3.7
39085,9/1/19,126873,122764,4109,3.2
39087,9/1/19,23911,22720,1191,5
39089,9/1/19,90693,87408,3285,3.6
39091,9/1/19,22469,21659,810,3.6
39093,9/1/19,154252,148348,5904,3.8
39095,9/1/19,209791,200898,8893,4.2
39097,9/1/19,20724,20046,678,3.3
39099,9/1/19,102850,97378,5472,5.3
39101,9/1/19,28073,26988,1085,3.9
39103,9/1/19,98161,95058,3103,3.2
39105,9/1/19,9009,8466,543,6
39107,9/1/19,23036,22423,613,2.7
39109,9/1/19,54037,52113,1924,3.6
39111,9/1/19,5234,4885,349,6.7
39113,9/1/19,252762,242424,10338,4.1
39115,9/1/19,6599,6259,340,5.2
39117,9/1/19,16776,16173,603,3.6
39119,9/1/19,39457,37770,1687,4.3
39121,9/1/19,4653,4390,263,5.7
39123,9/1/19,21388,20528,860,4
39125,9/1/19,8560,8240,320,3.7
39127,9/1/19,15826,15098,728,4.6
39129,9/1/19,26412,25424,988,3.7
39131,9/1/19,10722,10136,586,5.5
39133,9/1/19,87404,83991,3413,3.9
39135,9/1/19,21030,20283,747,3.6
39137,9/1/19,18548,18031,517,2.8
39139,9/1/19,51969,49782,2187,4.2
39141,9/1/19,35047,33701,1346,3.8
39143,9/1/19,30223,29053,1170,3.9
39145,9/1/19,28862,27247,1615,5.6
39147,9/1/19,27089,26040,1049,3.9
39149,9/1/19,23959,23132,827,3.5
39151,9/1/19,185249,177604,7645,4.1
39153,9/1/19,272833,261832,11001,4
39155,9/1/19,86574,81673,4901,5.7
39157,9/1/19,44797,43021,1776,4
39159,9/1/19,29017,28062,955,3.3
39161,9/1/19,14958,14471,487,3.3
39163,9/1/19,5516,5251,265,4.8
39165,9/1/19,119810,115644,4166,3.5
39167,9/1/19,27385,26083,1302,4.8
39169,9/1/19,61540,59596,1944,3.2
39171,9/1/19,18917,18305,612,3.2
39173,9/1/19,71159,68651,2508,3.5
39175,9/1/19,12811,12434,377,2.9
40001,9/1/19,8108,7814,294,3.6
40003,9/1/19,2831,2770,61,2.2
40005,9/1/19,4923,4722,201,4.1
40007,9/1/19,2913,2861,52,1.8
40009,9/1/19,10235,9876,359,3.5
40011,9/1/19,4759,4666,93,2
40013,9/1/19,21267,20667,600,2.8
40015,9/1/19,11742,11321,421,3.6
40017,9/1/19,74647,72554,2093,2.8
40019,9/1/19,21501,20799,702,3.3
40021,9/1/19,18836,18135,701,3.7
40023,9/1/19,5421,5192,229,4.2
40025,9/1/19,1325,1302,23,1.7
40027,9/1/19,143455,139592,3863,2.7
40029,9/1/19,2345,2254,91,3.9
40031,9/1/19,47980,46247,1733,3.6
40033,9/1/19,2707,2625,82,3
40035,9/1/19,5915,5709,206,3.5
40037,9/1/19,31689,30576,1113,3.5
40039,9/1/19,15660,15267,393,2.5
40041,9/1/19,18117,17499,618,3.4
40043,9/1/19,2840,2777,63,2.2
40045,9/1/19,2112,2057,55,2.6
40047,9/1/19,26835,26058,777,2.9
40049,9/1/19,12350,11975,375,3
40051,9/1/19,26617,25802,815,3.1
40053,9/1/19,2616,2566,50,1.9
40055,9/1/19,1836,1768,68,3.7
40057,9/1/19,1176,1143,33,2.8
40059,9/1/19,1769,1717,52,2.9
40061,9/1/19,4209,3991,218,5.2
40063,9/1/19,5288,5050,238,4.5
40065,9/1/19,10656,10357,299,2.8
40067,9/1/19,2521,2441,80,3.2
40069,9/1/19,3694,3529,165,4.5
40071,9/1/19,18297,17590,707,3.9
40073,9/1/19,9016,8843,173,1.9
40075,9/1/19,3485,3350,135,3.9
40077,9/1/19,3131,2938,193,6.2
40079,9/1/19,18973,18132,841,4.4
40081,9/1/19,15827,15299,528,3.3
40083,9/1/19,22184,21568,616,2.8
40085,9/1/19,6174,6031,143,2.3
40087,9/1/19,19723,19195,528,2.7
40089,9/1/19,14648,13897,751,5.1
40091,9/1/19,7066,6694,372,5.3
40093,9/1/19,3797,3712,85,2.2
40095,9/1/19,6934,6710,224,3.2
40097,9/1/19,19700,19133,567,2.9
40099,9/1/19,6364,6184,180,2.8
40101,9/1/19,29936,28855,1081,3.6
40103,9/1/19,5620,5480,140,2.5
40105,9/1/19,4606,4469,137,3
40107,9/1/19,4615,4415,200,4.3
40109,9/1/19,386360,374779,11581,3
40111,9/1/19,15726,15001,725,4.6
40113,9/1/19,20721,20001,720,3.5
40115,9/1/19,14048,13605,443,3.2
40117,9/1/19,7356,7098,258,3.5
40119,9/1/19,37600,36560,1040,2.8
40121,9/1/19,16919,16169,750,4.4
40123,9/1/19,19247,18715,532,2.8
40125,9/1/19,32457,31356,1101,3.4
40127,9/1/19,4269,4069,200,4.7
40129,9/1/19,1861,1799,62,3.3
40131,9/1/19,45268,43940,1328,2.9
40133,9/1/19,9505,9075,430,4.5
40135,9/1/19,16114,15491,623,3.9
40137,9/1/19,18403,17576,827,4.5
40139,9/1/19,11254,11045,209,1.9
40141,9/1/19,2975,2882,93,3.1
40143,9/1/19,324296,314557,9739,3
40145,9/1/19,38096,36946,1150,3
40147,9/1/19,22156,21454,702,3.2
40149,9/1/19,5241,5067,174,3.3
40151,9/1/19,4652,4557,95,2
40153,9/1/19,8898,8629,269,3
41001,9/1/19,7171,6938,233,3.2
41003,9/1/19,47015,45697,1318,2.8
41005,9/1/19,219773,213403,6370,2.9
41007,9/1/19,19849,19268,581,2.9
41009,9/1/19,24384,23436,948,3.9
41011,9/1/19,26057,25057,1000,3.8
41013,9/1/19,9751,9383,368,3.8
41015,9/1/19,9170,8816,354,3.9
41017,9/1/19,96932,94109,2823,2.9
41019,9/1/19,46645,44806,1839,3.9
41021,9/1/19,912,882,30,3.3
41023,9/1/19,3240,3127,113,3.5
41025,9/1/19,3616,3501,115,3.2
41027,9/1/19,15474,15124,350,2.3
41029,9/1/19,104447,101039,3408,3.3
41031,9/1/19,10118,9762,356,3.5
41033,9/1/19,35985,34610,1375,3.8
41035,9/1/19,29479,28057,1422,4.8
41037,9/1/19,3770,3645,125,3.3
41039,9/1/19,179020,172882,6138,3.4
41041,9/1/19,21243,20525,718,3.4
41043,9/1/19,58338,56235,2103,3.6
41045,9/1/19,12515,12135,380,3
41047,9/1/19,163333,158076,5257,3.2
41049,9/1/19,5917,5744,173,2.9
41051,9/1/19,455572,442923,12649,2.8
41053,9/1/19,40057,38677,1380,3.4
41055,9/1/19,976,948,28,2.9
41057,9/1/19,12041,11669,372,3.1
41059,9/1/19,37625,36349,1276,3.4
41061,9/1/19,11804,11393,411,3.5
41063,9/1/19,3517,3403,114,3.2
41065,9/1/19,12648,12222,426,3.4
41067,9/1/19,325157,316392,8765,2.7
41069,9/1/19,739,714,25,3.4
41071,9/1/19,55063,53469,1594,2.9
42001,9/1/19,55672,53978,1694,3
42003,9/1/19,651554,625768,25786,4
42005,9/1/19,32170,30844,1326,4.1
42007,9/1/19,84266,80737,3529,4.2
42009,9/1/19,23701,22761,940,4
42011,9/1/19,216562,207475,9087,4.2
42013,9/1/19,59563,57042,2521,4.2
42015,9/1/19,29031,27872,1159,4
42017,9/1/19,346206,333268,12938,3.7
42019,9/1/19,100048,96574,3474,3.5
42021,9/1/19,57805,55068,2737,4.7
42023,9/1/19,2081,1980,101,4.9
42025,9/1/19,32188,30544,1644,5.1
42027,9/1/19,81121,78480,2641,3.3
42029,9/1/19,288026,279027,8999,3.1
42031,9/1/19,17318,16593,725,4.2
42033,9/1/19,35859,34207,1652,4.6
42035,9/1/19,18307,17447,860,4.7
42037,9/1/19,33766,32374,1392,4.1
42039,9/1/19,38485,36867,1618,4.2
42041,9/1/19,132817,128402,4415,3.3
42043,9/1/19,145064,139162,5902,4.1
42045,9/1/19,301297,288999,12298,4.1
42047,9/1/19,15437,14730,707,4.6
42049,9/1/19,129126,123832,5294,4.1
42051,9/1/19,57073,54139,2934,5.1
42053,9/1/19,1811,1705,106,5.9
42055,9/1/19,78005,75195,2810,3.6
42057,9/1/19,7860,7561,299,3.8
42059,9/1/19,16661,15879,782,4.7
42061,9/1/19,20109,19090,1019,5.1
42063,9/1/19,39735,38020,1715,4.3
42065,9/1/19,20554,19704,850,4.1
42067,9/1/19,12750,12268,482,3.8
42069,9/1/19,105175,100378,4797,4.6
42071,9/1/19,287049,277601,9448,3.3
42073,9/1/19,40718,38957,1761,4.3
42075,9/1/19,72909,70109,2800,3.8
42077,9/1/19,193213,184773,8440,4.4
42079,9/1/19,157533,149206,8327,5.3
42081,9/1/19,57022,54466,2556,4.5
42083,9/1/19,17342,16497,845,4.9
42085,9/1/19,49222,47011,2211,4.5
42087,9/1/19,21040,20209,831,3.9
42089,9/1/19,82865,78548,4317,5.2
42091,9/1/19,457737,441874,15863,3.5
42093,9/1/19,9203,8910,293,3.2
42095,9/1/19,161635,154734,6901,4.3
42097,9/1/19,43433,41318,2115,4.9
42099,9/1/19,24592,23770,822,3.3
42101,9/1/19,725705,685263,40442,5.6
42103,9/1/19,25239,23874,1365,5.4
42105,9/1/19,7248,6902,346,4.8
42107,9/1/19,66587,63222,3365,5.1
42109,9/1/19,20103,19094,1009,5
42111,9/1/19,33414,31920,1494,4.5
42113,9/1/19,2693,2569,124,4.6
42115,9/1/19,20625,19855,770,3.7
42117,9/1/19,19357,18518,839,4.3
42119,9/1/19,20158,19390,768,3.8
42121,9/1/19,22287,21288,999,4.5
42123,9/1/19,18881,18109,772,4.1
42125,9/1/19,107540,102969,4571,4.3
42127,9/1/19,22178,21325,853,3.8
42129,9/1/19,181458,174155,7303,4
42131,9/1/19,13598,13018,580,4.3
42133,9/1/19,236323,227562,8761,3.7
44001,9/1/19,26060,25363,697,2.7
44003,9/1/19,90793,88292,2501,2.8
44005,9/1/19,44209,43139,1070,2.4
44007,9/1/19,326001,314627,11374,3.5
44009,9/1/19,69261,67409,1852,2.7
45001,9/1/19,9971,9723,248,2.5
45003,9/1/19,74177,72647,1530,2.1
45005,9/1/19,2597,2481,116,4.5
45007,9/1/19,91258,89517,1741,1.9
45009,9/1/19,4857,4623,234,4.8
45011,9/1/19,8122,7845,277,3.4
45013,9/1/19,77235,75848,1387,1.8
45015,9/1/19,104291,102437,1854,1.8
45017,9/1/19,6557,6374,183,2.8
45019,9/1/19,211700,208376,3324,1.6
45021,9/1/19,25220,24655,565,2.2
45023,9/1/19,13366,12959,407,3
45025,9/1/19,21738,21292,446,2.1
45027,9/1/19,12553,12199,354,2.8
45029,9/1/19,16720,16328,392,2.3
45031,9/1/19,30267,29490,777,2.6
45033,9/1/19,12884,12491,393,3.1
45035,9/1/19,78280,76934,1346,1.7
45037,9/1/19,10546,10334,212,2
45039,9/1/19,9551,9231,320,3.4
45041,9/1/19,66789,65397,1392,2.1
45043,9/1/19,25643,24999,644,2.5
45045,9/1/19,255332,250979,4353,1.7
45047,9/1/19,31096,30392,704,2.3
45049,9/1/19,8270,8113,157,1.9
45051,9/1/19,148074,144679,3395,2.3
45053,9/1/19,12518,12304,214,1.7
45055,9/1/19,29216,28561,655,2.2
45057,9/1/19,41201,40188,1013,2.5
45059,9/1/19,30143,29479,664,2.2
45061,9/1/19,6578,6358,220,3.3
45063,9/1/19,150085,147642,2443,1.6
45065,9/1/19,3341,3272,69,2.1
45067,9/1/19,12871,12469,402,3.1
45069,9/1/19,9154,8864,290,3.2
45071,9/1/19,18849,18447,402,2.1
45073,9/1/19,35048,34377,671,1.9
45075,9/1/19,34361,32919,1442,4.2
45077,9/1/19,57479,56334,1145,2
45079,9/1/19,199327,195343,3984,2
45081,9/1/19,8718,8545,173,2
45083,9/1/19,153637,150884,2753,1.8
45085,9/1/19,43401,42339,1062,2.4
45087,9/1/19,11667,11366,301,2.6
45089,9/1/19,11847,11443,404,3.4
45091,9/1/19,140400,137612,2788,2
46003,9/1/19,1519,1470,49,3.2
46005,9/1/19,9449,9170,279,3
46007,9/1/19,1093,1033,60,5.5
46009,9/1/19,2881,2796,85,3
46011,9/1/19,19110,18555,555,2.9
46013,9/1/19,20572,19970,602,2.9
46015,9/1/19,2441,2364,77,3.2
46017,9/1/19,664,613,51,7.7
46019,9/1/19,5011,4854,157,3.1
46021,9/1/19,779,754,25,3.2
46023,9/1/19,3758,3632,126,3.4
46025,9/1/19,1908,1840,68,3.6
46027,9/1/19,7475,7258,217,2.9
46029,9/1/19,15494,15064,430,2.8
46031,9/1/19,1379,1298,81,5.9
46033,9/1/19,4036,3883,153,3.8
46035,9/1/19,10989,10695,294,2.7
46037,9/1/19,2764,2668,96,3.5
46039,9/1/19,2196,2117,79,3.6
46041,9/1/19,2247,2077,170,7.6
46043,9/1/19,1580,1540,40,2.5
46045,9/1/19,2036,1976,60,2.9
46047,9/1/19,2964,2845,119,4
46049,9/1/19,1055,1021,34,3.2
46051,9/1/19,4423,4308,115,2.6
46053,9/1/19,2046,1982,64,3.1
46055,9/1/19,1031,1003,28,2.7
46057,9/1/19,3355,3266,89,2.7
46059,9/1/19,1747,1700,47,2.7
46061,9/1/19,1722,1660,62,3.6
46063,9/1/19,743,722,21,2.8
46065,9/1/19,9952,9709,243,2.4
46067,9/1/19,3584,3484,100,2.8
46069,9/1/19,691,668,23,3.3
46071,9/1/19,1327,1261,66,5
46073,9/1/19,1125,1095,30,2.7
46075,9/1/19,568,553,15,2.6
46077,9/1/19,2624,2556,68,2.6
46079,9/1/19,6665,6437,228,3.4
46081,9/1/19,13649,13240,409,3
46083,9/1/19,34422,33583,839,2.4
46085,9/1/19,1696,1628,68,4
46087,9/1/19,3068,2989,79,2.6
46089,9/1/19,1027,986,41,4
46091,9/1/19,2393,2310,83,3.5
46093,9/1/19,14255,13791,464,3.3
46095,9/1/19,736,702,34,4.6
46097,9/1/19,1168,1132,36,3.1
46099,9/1/19,112380,109417,2963,2.6
46101,9/1/19,4059,3925,134,3.3
46102,9/1/19,3524,3188,336,9.5
46103,9/1/19,57324,55496,1828,3.2
46105,9/1/19,1430,1387,43,3
46107,9/1/19,1046,1014,32,3.1
46109,9/1/19,4952,4790,162,3.3
46111,9/1/19,1158,1124,34,2.9
46115,9/1/19,3161,3063,98,3.1
46117,9/1/19,1838,1793,45,2.4
46119,9/1/19,806,783,23,2.9
46121,9/1/19,3095,2921,174,5.6
46123,9/1/19,3039,2948,91,3
46125,9/1/19,4686,4554,132,2.8
46127,9/1/19,8453,8164,289,3.4
46129,9/1/19,2110,2014,96,4.5
46135,9/1/19,11776,11452,324,2.8
46137,9/1/19,945,896,49,5.2
47001,9/1/19,34971,33829,1142,3.3
47003,9/1/19,21183,20430,753,3.6
47005,9/1/19,6972,6682,290,4.2
47007,9/1/19,4426,4218,208,4.7
47009,9/1/19,64179,62327,1852,2.9
47011,9/1/19,53123,51397,1726,3.2
47013,9/1/19,14950,14351,599,4
47015,9/1/19,6721,6525,196,2.9
47017,9/1/19,12160,11640,520,4.3
47019,9/1/19,24252,23359,893,3.7
47021,9/1/19,22285,21752,533,2.4
47023,9/1/19,8658,8368,290,3.3
47025,9/1/19,13129,12631,498,3.8
47027,9/1/19,2841,2688,153,5.4
47029,9/1/19,15178,14599,579,3.8
47031,9/1/19,25767,24927,840,3.3
47033,9/1/19,7093,6865,228,3.2
47035,9/1/19,23863,22924,939,3.9
47037,9/1/19,411570,401782,9788,2.4
47039,9/1/19,4601,4388,213,4.6
47041,9/1/19,7845,7545,300,3.8
47043,9/1/19,27540,26756,784,2.8
47045,9/1/19,16647,15863,784,4.7
47047,9/1/19,19428,18689,739,3.8
47049,9/1/19,7617,7317,300,3.9
47051,9/1/19,20285,19631,654,3.2
47053,9/1/19,22341,21442,899,4
47055,9/1/19,15054,14536,518,3.4
47057,9/1/19,9600,9272,328,3.4
47059,9/1/19,29893,28518,1375,4.6
47061,9/1/19,5019,4828,191,3.8
47063,9/1/19,28389,27361,1028,3.6
47065,9/1/19,185618,179916,5702,3.1
47067,9/1/19,2153,2044,109,5.1
47069,9/1/19,9625,9110,515,5.4
47071,9/1/19,10544,10156,388,3.7
47073,9/1/19,23862,22898,964,4
47075,9/1/19,7792,7436,356,4.6
47077,9/1/19,12364,11895,469,3.8
47079,9/1/19,14312,13764,548,3.8
47081,9/1/19,11661,11323,338,2.9
47083,9/1/19,3330,3183,147,4.4
47085,9/1/19,9085,8752,333,3.7
47087,9/1/19,4722,4537,185,3.9
47089,9/1/19,24778,23943,835,3.4
47091,9/1/19,7752,7514,238,3.1
47093,9/1/19,246586,239948,6638,2.7
47095,9/1/19,1761,1675,86,4.9
47097,9/1/19,9802,9309,493,5
47099,9/1/19,19544,18806,738,3.8
47101,9/1/19,5249,5081,168,3.2
47103,9/1/19,16955,16457,498,2.9
47105,9/1/19,23748,23015,733,3.1
47107,9/1/19,23883,23058,825,3.5
47109,9/1/19,8655,8257,398,4.6
47111,9/1/19,11509,11187,322,2.8
47113,9/1/19,49559,47808,1751,3.5
47115,9/1/19,12605,12095,510,4
47117,9/1/19,15792,15313,479,3
47119,9/1/19,50156,48872,1284,2.6
47121,9/1/19,5251,5046,205,3.9
47123,9/1/19,20322,19659,663,3.3
47125,9/1/19,86708,83574,3134,3.6
47127,9/1/19,3673,3567,106,2.9
47129,9/1/19,7960,7665,295,3.7
47131,9/1/19,12528,12028,500,4
47133,9/1/19,10179,9856,323,3.2
47135,9/1/19,3093,2982,111,3.6
47137,9/1/19,2440,2349,91,3.7
47139,9/1/19,7670,7384,286,3.7
47141,9/1/19,35737,34580,1157,3.2
47143,9/1/19,13611,12934,677,5
47145,9/1/19,23631,22750,881,3.7
47147,9/1/19,38738,37703,1035,2.7
47149,9/1/19,187430,182923,4507,2.4
47151,9/1/19,8332,7989,343,4.1
47153,9/1/19,6268,6011,257,4.1
47155,9/1/19,55505,54191,1314,2.4
47157,9/1/19,448743,431318,17425,3.9
47159,9/1/19,9629,9367,262,2.7
47161,9/1/19,5572,5359,213,3.8
47163,9/1/19,70484,68048,2436,3.5
47165,9/1/19,104275,101639,2636,2.5
47167,9/1/19,28413,27345,1068,3.8
47169,9/1/19,5525,5372,153,2.8
47171,9/1/19,7181,6859,322,4.5
47173,9/1/19,7691,7422,269,3.5
47175,9/1/19,2086,2003,83,4
47177,9/1/19,16808,16171,637,3.8
47179,9/1/19,61083,59084,1999,3.3
47181,9/1/19,6253,6004,249,4
47183,9/1/19,16256,15695,561,3.5
47185,9/1/19,12350,11919,431,3.5
47187,9/1/19,130866,127857,3009,2.3
47189,9/1/19,78064,76102,1962,2.5
48001,9/1/19,24091,23431,660,2.7
48003,9/1/19,9906,9677,229,2.3
48005,9/1/19,36136,34723,1413,3.9
48007,9/1/19,9369,9001,368,3.9
48009,9/1/19,4147,4034,113,2.7
48011,9/1/19,930,906,24,2.6
48013,9/1/19,21811,21042,769,3.5
48015,9/1/19,14136,13670,466,3.3
48017,9/1/19,2489,2405,84,3.4
48019,9/1/19,10126,9791,335,3.3
48021,9/1/19,43122,41855,1267,2.9
48023,9/1/19,1780,1740,40,2.2
48025,9/1/19,9887,9452,435,4.4
48027,9/1/19,144386,139037,5349,3.7
48029,9/1/19,954352,925042,29310,3.1
48031,9/1/19,6472,6321,151,2.3
48033,9/1/19,416,405,11,2.6
48035,9/1/19,8359,8076,283,3.4
48037,9/1/19,40095,38384,1711,4.3
48039,9/1/19,180499,172774,7725,4.3
48041,9/1/19,120591,117445,3146,2.6
48043,9/1/19,4209,4087,122,2.9
48045,9/1/19,573,552,21,3.7
48047,9/1/19,2575,2445,130,5
48049,9/1/19,15663,15066,597,3.8
48051,9/1/19,8455,8209,246,2.9
48053,9/1/19,23598,22964,634,2.7
48055,9/1/19,19776,19124,652,3.3
48057,9/1/19,12109,11737,372,3.1
48059,9/1/19,6180,5996,184,3
48061,9/1/19,167073,158398,8675,5.2
48063,9/1/19,5026,4822,204,4.1
48065,9/1/19,3011,2942,69,2.3
48067,9/1/19,12435,11910,525,4.2
48069,9/1/19,3438,3350,88,2.6
48071,9/1/19,19510,18685,825,4.2
48073,9/1/19,20806,20036,770,3.7
48075,9/1/19,2958,2879,79,2.7
48077,9/1/19,4946,4796,150,3
48079,9/1/19,1121,1088,33,2.9
48081,9/1/19,1484,1439,45,3
48083,9/1/19,2891,2775,116,4
48085,9/1/19,568636,551551,17085,3
48087,9/1/19,1153,1113,40,3.5
48089,9/1/19,9885,9592,293,3
48091,9/1/19,73664,71527,2137,2.9
48093,9/1/19,5660,5487,173,3.1
48095,9/1/19,1353,1311,42,3.1
48097,9/1/19,19688,19152,536,2.7
48099,9/1/19,24193,23284,909,3.8
48101,9/1/19,540,517,23,4.3
48103,9/1/19,1590,1525,65,4.1
48105,9/1/19,1628,1574,54,3.3
48107,9/1/19,2508,2410,98,3.9
48109,9/1/19,1066,1022,44,4.1
48111,9/1/19,3891,3820,71,1.8
48113,9/1/19,1375918,1329943,45975,3.3
48115,9/1/19,4584,4400,184,4
48117,9/1/19,8553,8325,228,2.7
48119,9/1/19,2456,2371,85,3.5
48121,9/1/19,499067,484662,14405,2.9
48123,9/1/19,9856,9607,249,2.5
48125,9/1/19,674,644,30,4.5
48127,9/1/19,7226,7045,181,2.5
48129,9/1/19,1389,1342,47,3.4
48131,9/1/19,4919,4714,205,4.2
48133,9/1/19,8134,7871,263,3.2
48135,9/1/19,88187,85802,2385,2.7
48137,9/1/19,1140,1117,23,2
48139,9/1/19,93455,90667,2788,3
48141,9/1/19,365193,351539,13654,3.7
48143,9/1/19,20705,20036,669,3.2
48145,9/1/19,6601,6393,208,3.2
48147,9/1/19,17459,16991,468,2.7
48149,9/1/19,12099,11786,313,2.6
48151,9/1/19,1627,1575,52,3.2
48153,9/1/19,2562,2460,102,4
48155,9/1/19,593,573,20,3.4
48157,9/1/19,393742,380281,13461,3.4
48159,9/1/19,4657,4496,161,3.5
48161,9/1/19,6448,6144,304,4.7
48163,9/1/19,10431,10188,243,2.3
48165,9/1/19,9818,9587,231,2.4
48167,9/1/19,165994,159490,6504,3.9
48169,9/1/19,2160,2103,57,2.6
48171,9/1/19,13479,13162,317,2.4
48173,9/1/19,798,781,17,2.1
48175,9/1/19,3260,3158,102,3.1
48177,9/1/19,9630,9381,249,2.6
48179,9/1/19,8124,7840,284,3.5
48181,9/1/19,64164,62209,1955,3
48183,9/1/19,58637,56470,2167,3.7
48185,9/1/19,11231,10794,437,3.9
48187,9/1/19,81896,79552,2344,2.9
48189,9/1/19,12070,11562,508,4.2
48191,9/1/19,1067,1025,42,3.9
48193,9/1/19,3674,3561,113,3.1
48195,9/1/19,2770,2709,61,2.2
48197,9/1/19,1759,1708,51,2.9
48199,9/1/19,25328,24223,1105,4.4
48201,9/1/19,2324803,2238007,86796,3.7
48203,9/1/19,29753,28570,1183,4
48205,9/1/19,2788,2740,48,1.7
48207,9/1/19,2308,2233,75,3.2
48209,9/1/19,120597,117278,3319,2.8
48211,9/1/19,1922,1874,48,2.5
48213,9/1/19,36769,35509,1260,3.4
48215,9/1/19,352630,331530,21100,6
48217,9/1/19,16604,16070,534,3.2
48219,9/1/19,11219,10903,316,2.8
48221,9/1/19,27753,26820,933,3.4
48223,9/1/19,17661,17153,508,2.9
48225,9/1/19,10453,10140,313,3
48227,9/1/19,14099,13657,442,3.1
48229,9/1/19,1850,1761,89,4.8
48231,9/1/19,43756,42260,1496,3.4
48233,9/1/19,8727,8342,385,4.4
48235,9/1/19,761,743,18,2.4
48237,9/1/19,3488,3378,110,3.2
48239,9/1/19,7664,7446,218,2.8
48241,9/1/19,12841,12094,747,5.8
48243,9/1/19,1017,986,31,3
48245,9/1/19,107197,101003,6194,5.8
48247,9/1/19,1882,1801,81,4.3
48249,9/1/19,16671,15936,735,4.4
48251,9/1/19,82758,80164,2594,3.1
48253,9/1/19,5806,5565,241,4.2
48255,9/1/19,7247,7064,183,2.5
48257,9/1/19,65157,63093,2064,3.2
48259,9/1/19,22236,21640,596,2.7
48261,9/1/19,200,192,8,4
48263,9/1/19,488,477,11,2.3
48265,9/1/19,22208,21553,655,2.9
48267,9/1/19,1838,1779,59,3.2
48269,9/1/19,251,247,4,1.6
48271,9/1/19,1399,1358,41,2.9
48273,9/1/19,13392,12815,577,4.3
48275,9/1/19,1439,1394,45,3.1
48277,9/1/19,24371,23581,790,3.2
48279,9/1/19,5340,5142,198,3.7
48281,9/1/19,9235,8948,287,3.1
48283,9/1/19,4354,4241,113,2.6
48285,9/1/19,8508,8257,251,3
48287,9/1/19,10137,9879,258,2.5
48289,9/1/19,6390,6100,290,4.5
48291,9/1/19,33174,31565,1609,4.9
48293,9/1/19,8616,8299,317,3.7
48295,9/1/19,1625,1585,40,2.5
48297,9/1/19,5656,5489,167,3
48299,9/1/19,8796,8503,293,3.3
48301,9/1/19,615,611,4,0.7
48303,9/1/19,158475,154172,4303,2.7
48305,9/1/19,2787,2702,85,3
48307,9/1/19,3381,3193,188,5.6
48309,9/1/19,120169,116311,3858,3.2
48311,9/1/19,892,878,14,1.6
48313,9/1/19,4561,4361,200,4.4
48315,9/1/19,4227,4059,168,4
48317,9/1/19,2898,2823,75,2.6
48319,9/1/19,1753,1699,54,3.1
48321,9/1/19,16756,15803,953,5.7
48323,9/1/19,23399,21917,1482,6.3
48325,9/1/19,21943,21259,684,3.1
48327,9/1/19,882,852,30,3.4
48329,9/1/19,107830,105609,2221,2.1
48331,9/1/19,9791,9354,437,4.5
48333,9/1/19,1915,1860,55,2.9
48335,9/1/19,2333,2249,84,3.6
48337,9/1/19,9406,9136,270,2.9
48339,9/1/19,285075,275545,9530,3.3
48341,9/1/19,10969,10713,256,2.3
48343,9/1/19,4853,4607,246,5.1
48345,9/1/19,483,467,16,3.3
48347,9/1/19,28278,27249,1029,3.6
48349,9/1/19,24369,23644,725,3
48351,9/1/19,5183,4870,313,6
48353,9/1/19,7241,7032,209,2.9
48355,9/1/19,166828,160207,6621,4
48357,9/1/19,4336,4221,115,2.7
48359,9/1/19,918,893,25,2.7
48361,9/1/19,36458,34607,1851,5.1
48363,9/1/19,13632,13217,415,3
48365,9/1/19,10046,9640,406,4
48367,9/1/19,67801,65879,1922,2.8
48369,9/1/19,4873,4768,105,2.2
48371,9/1/19,6335,6134,201,3.2
48373,9/1/19,18051,17243,808,4.5
48375,9/1/19,55314,53821,1493,2.7
48377,9/1/19,3124,2915,209,6.7
48379,9/1/19,5996,5819,177,3
48381,9/1/19,72262,70541,1721,2.4
48383,9/1/19,1915,1863,52,2.7
48385,9/1/19,1003,962,41,4.1
48387,9/1/19,5148,4919,229,4.4
48389,9/1/19,11259,11047,212,1.9
48391,9/1/19,3149,3033,116,3.7
48393,9/1/19,423,412,11,2.6
48395,9/1/19,7745,7482,263,3.4
48397,9/1/19,52557,50955,1602,3
48399,9/1/19,4632,4507,125,2.7
48401,9/1/19,23185,22361,824,3.6
48403,9/1/19,3716,3487,229,6.2
48405,9/1/19,3393,3234,159,4.7
48407,9/1/19,11784,11252,532,4.5
48409,9/1/19,29821,28226,1595,5.3
48411,9/1/19,2538,2464,74,2.9
48413,9/1/19,1295,1255,40,3.1
48415,9/1/19,6709,6505,204,3
48417,9/1/19,1897,1856,41,2.2
48419,9/1/19,11311,10885,426,3.8
48421,9/1/19,1385,1354,31,2.2
48423,9/1/19,107227,103720,3507,3.3
48425,9/1/19,4393,4240,153,3.5
48427,9/1/19,24613,22213,2400,9.8
48429,9/1/19,4062,3937,125,3.1
48431,9/1/19,580,563,17,2.9
48433,9/1/19,595,578,17,2.9
48435,9/1/19,1319,1267,52,3.9
48437,9/1/19,2611,2519,92,3.5
48439,9/1/19,1089878,1055280,34598,3.2
48441,9/1/19,67755,65871,1884,2.8
48443,9/1/19,377,360,17,4.5
48445,9/1/19,4944,4774,170,3.4
48447,9/1/19,657,630,27,4.1
48449,9/1/19,13169,12659,510,3.9
48451,9/1/19,54658,53057,1601,2.9
48453,9/1/19,745227,726312,18915,2.5
48455,9/1/19,5382,5133,249,4.6
48457,9/1/19,7134,6738,396,5.6
48459,9/1/19,17976,17338,638,3.5
48461,9/1/19,1675,1630,45,2.7
48463,9/1/19,11533,11121,412,3.6
48465,9/1/19,23094,22374,720,3.1
48467,9/1/19,26105,25271,834,3.2
48469,9/1/19,42784,41345,1439,3.4
48471,9/1/19,24434,23494,940,3.8
48473,9/1/19,23555,22694,861,3.7
48475,9/1/19,7414,7248,166,2.2
48477,9/1/19,15408,14938,470,3.1
48479,9/1/19,118808,114749,4059,3.4
48481,9/1/19,21840,21108,732,3.4
48483,9/1/19,2275,2203,72,3.2
48485,9/1/19,56397,54683,1714,3
48487,9/1/19,4974,4814,160,3.2
48489,9/1/19,6672,6172,500,7.5
48491,9/1/19,315801,307030,8771,2.8
48493,9/1/19,24979,24308,671,2.7
48495,9/1/19,4041,3922,119,2.9
48497,9/1/19,32075,31101,974,3
48499,9/1/19,17866,17187,679,3.8
48501,9/1/19,3725,3613,112,3
48503,9/1/19,8083,7848,235,2.9
48505,9/1/19,4844,4612,232,4.8
48507,9/1/19,3292,3023,269,8.2
49001,9/1/19,2813,2747,66,2.3
49003,9/1/19,25903,25354,549,2.1
49005,9/1/19,64726,63571,1155,1.8
49007,9/1/19,8511,8255,256,3
49009,9/1/19,431,420,11,2.6
49011,9/1/19,174336,170783,3553,2
49013,9/1/19,7756,7511,245,3.2
49015,9/1/19,4187,4053,134,3.2
49017,9/1/19,3031,2944,87,2.9
49019,9/1/19,6550,6440,110,1.7
49021,9/1/19,24549,23974,575,2.3
49023,9/1/19,5762,5651,111,1.9
49025,9/1/19,3989,3910,79,2
49027,9/1/19,5946,5815,131,2.2
49029,9/1/19,5579,5465,114,2
49031,9/1/19,491,472,19,3.9
49033,9/1/19,1298,1272,26,2
49035,9/1/19,637283,623667,13616,2.1
49037,9/1/19,5881,5667,214,3.6
49039,9/1/19,12471,12160,311,2.5
49041,9/1/19,9733,9515,218,2.2
49043,9/1/19,23979,23486,493,2.1
49045,9/1/19,34088,33257,831,2.4
49047,9/1/19,13653,13178,475,3.5
49049,9/1/19,310720,304539,6181,2
49051,9/1/19,16127,15768,359,2.2
49053,9/1/19,77038,75109,1929,2.5
49055,9/1/19,1494,1450,44,2.9
49057,9/1/19,127547,124577,2970,2.3
50001,9/1/19,20394,19930,464,2.3
50003,9/1/19,17564,17076,488,2.8
50005,9/1/19,14464,14090,374,2.6
50007,9/1/19,96689,94783,1906,2
50009,9/1/19,2668,2588,80,3
50011,9/1/19,27116,26531,585,2.2
50013,9/1/19,4013,3928,85,2.1
50015,9/1/19,13765,13402,363,2.6
50017,9/1/19,15800,15465,335,2.1
50019,9/1/19,12997,12536,461,3.5
50021,9/1/19,29988,29168,820,2.7
50023,9/1/19,34071,33377,694,2
50025,9/1/19,21333,20779,554,2.6
50027,9/1/19,28104,27478,626,2.2
51001,9/1/19,16605,16122,483,2.9
51003,9/1/19,58797,57444,1353,2.3
51005,9/1/19,6915,6697,218,3.2
51007,9/1/19,6295,6129,166,2.6
51009,9/1/19,15185,14732,453,3
51011,9/1/19,7228,6996,232,3.2
51013,9/1/19,156199,153388,2811,1.8
51015,9/1/19,37889,37041,848,2.2
51017,9/1/19,2566,2509,57,2.2
51019,9/1/19,38843,37771,1072,2.8
51021,9/1/19,2859,2787,72,2.5
51023,9/1/19,17551,17117,434,2.5
51025,9/1/19,6025,5769,256,4.2
51027,9/1/19,6638,6249,389,5.9
51029,9/1/19,6543,6335,208,3.2
51031,9/1/19,26242,25483,759,2.9
51033,9/1/19,15344,14904,440,2.9
51035,9/1/19,13236,12819,417,3.2
51036,9/1/19,3683,3574,109,3
51037,9/1/19,5267,5100,167,3.2
51041,9/1/19,189081,184176,4905,2.6
51043,9/1/19,7663,7494,169,2.2
51045,9/1/19,2309,2243,66,2.9
51047,9/1/19,24801,24207,594,2.4
51049,9/1/19,4657,4530,127,2.7
51051,9/1/19,4807,4596,211,4.4
51053,9/1/19,13735,13321,414,3
51057,9/1/19,5438,5274,164,3
51059,9/1/19,642000,628309,13691,2.1
51061,9/1/19,37595,36762,833,2.2
51063,9/1/19,8282,8089,193,2.3
51065,9/1/19,14293,13992,301,2.1
51067,9/1/19,26554,25812,742,2.8
51069,9/1/19,48571,47521,1050,2.2
51071,9/1/19,7982,7758,224,2.8
51073,9/1/19,19714,19246,468,2.4
51075,9/1/19,11278,10988,290,2.6
51077,9/1/19,7939,7742,197,2.5
51079,9/1/19,10787,10543,244,2.3
51081,9/1/19,4279,4143,136,3.2
51083,9/1/19,15690,15107,583,3.7
51085,9/1/19,59741,58375,1366,2.3
51087,9/1/19,183553,178761,4792,2.6
51089,9/1/19,23733,23003,730,3.1
51091,9/1/19,1205,1175,30,2.5
51093,9/1/19,19552,19059,493,2.5
51095,9/1/19,36845,35945,900,2.4
51097,9/1/19,3828,3729,99,2.6
51099,9/1/19,13619,13286,333,2.4
51101,9/1/19,9212,8974,238,2.6
51103,9/1/19,5464,5306,158,2.9
51105,9/1/19,8349,7978,371,4.4
51107,9/1/19,225145,220318,4827,2.1
51109,9/1/19,20205,19710,495,2.4
51111,9/1/19,5279,5116,163,3.1
51113,9/1/19,7525,7370,155,2.1
51115,9/1/19,4165,4057,108,2.6
51117,9/1/19,12363,11888,475,3.8
51119,9/1/19,5306,5180,126,2.4
51121,9/1/19,50949,49592,1357,2.7
51125,9/1/19,7600,7415,185,2.4
51127,9/1/19,12564,12292,272,2.2
51131,9/1/19,5460,5267,193,3.5
51133,9/1/19,5637,5468,169,3
51135,9/1/19,7266,7081,185,2.5
51137,9/1/19,17557,17062,495,2.8
51139,9/1/19,12094,11756,338,2.8
51141,9/1/19,7208,6982,226,3.1
51143,9/1/19,30089,29135,954,3.2
51145,9/1/19,14241,13900,341,2.4
51147,9/1/19,10272,9922,350,3.4
51149,9/1/19,15220,14731,489,3.2
51153,9/1/19,248369,242540,5829,2.3
51155,9/1/19,16262,15787,475,2.9
51157,9/1/19,3710,3625,85,2.3
51159,9/1/19,4066,3961,105,2.6
51161,9/1/19,49719,48530,1189,2.4
51163,9/1/19,10854,10576,278,2.6
51165,9/1/19,42625,41726,899,2.1
51167,9/1/19,11278,10846,432,3.8
51169,9/1/19,9140,8880,260,2.8
51171,9/1/19,22473,21947,526,2.3
51173,9/1/19,13866,13379,487,3.5
51175,9/1/19,9129,8888,241,2.6
51177,9/1/19,67761,65945,1816,2.7
51179,9/1/19,72905,71050,1855,2.5
51181,9/1/19,3714,3602,112,3
51183,9/1/19,3839,3670,169,4.4
51185,9/1/19,15638,14994,644,4.1
51187,9/1/19,20622,20081,541,2.6
51191,9/1/19,26781,25975,806,3
51193,9/1/19,9488,9205,283,3
51195,9/1/19,13498,12893,605,4.5
51197,9/1/19,13792,13355,437,3.2
51199,9/1/19,33040,32221,819,2.5
51510,9/1/19,102455,100464,1991,1.9
51520,9/1/19,7196,6945,251,3.5
51530,9/1/19,3547,3462,85,2.4
51540,9/1/19,27168,26615,553,2
51550,9/1/19,123785,120415,3370,2.7
51570,9/1/19,8872,8610,262,3
51580,9/1/19,2398,2305,93,3.9
51590,9/1/19,19125,18213,912,4.8
51595,9/1/19,2272,2170,102,4.5
51600,9/1/19,13580,13321,259,1.9
51610,9/1/19,8694,8524,170,2
51620,9/1/19,3593,3455,138,3.8
51630,9/1/19,14313,13864,449,3.1
51640,9/1/19,2924,2834,90,3.1
51650,9/1/19,64826,62592,2234,3.4
51660,9/1/19,25475,24724,751,2.9
51670,9/1/19,9773,9369,404,4.1
51678,9/1/19,2116,2025,91,4.3
51680,9/1/19,36714,35455,1259,3.4
51683,9/1/19,22282,21772,510,2.3
51685,9/1/19,9458,9250,208,2.2
51690,9/1/19,5483,5272,211,3.8
51700,9/1/19,89518,86655,2863,3.2
51710,9/1/19,112499,108918,3581,3.2
51720,9/1/19,1694,1634,60,3.5
51730,9/1/19,13097,12426,671,5.1
51735,9/1/19,6440,6290,150,2.3
51740,9/1/19,44611,42990,1621,3.6
51750,9/1/19,8790,8501,289,3.3
51760,9/1/19,119235,115553,3682,3.1
51770,9/1/19,49451,48077,1374,2.8
51775,9/1/19,13082,12735,347,2.7
51790,9/1/19,12366,12068,298,2.4
51800,9/1/19,45044,43742,1302,2.9
51810,9/1/19,234938,228986,5952,2.5
51820,9/1/19,10815,10526,289,2.7
51830,9/1/19,6751,6494,257,3.8
51840,9/1/19,14921,14549,372,2.5
53001,9/1/19,10830,10448,382,3.5
53003,9/1/19,10343,9996,347,3.4
53005,9/1/19,104357,100156,4201,4
53007,9/1/19,46573,44974,1599,3.4
53009,9/1/19,28756,27213,1543,5.4
53011,9/1/19,240483,230467,10016,4.2
53013,9/1/19,1835,1756,79,4.3
53015,9/1/19,47521,45078,2443,5.1
53017,9/1/19,22620,21742,878,3.9
53019,9/1/19,2437,2226,211,8.7
53021,9/1/19,43639,41721,1918,4.4
53023,9/1/19,929,892,37,4
53025,9/1/19,48829,46608,2221,4.5
53027,9/1/19,28578,26931,1647,5.8
53029,9/1/19,35896,34301,1595,4.4
53031,9/1/19,13073,12463,610,4.7
53033,9/1/19,1302772,1266525,36247,2.8
53035,9/1/19,127763,122770,4993,3.9
53037,9/1/19,23199,22186,1013,4.4
53039,9/1/19,10394,9945,449,4.3
53041,9/1/19,34740,32995,1745,5
53043,9/1/19,5101,4903,198,3.9
53045,9/1/19,24795,23464,1331,5.4
53047,9/1/19,21356,20451,905,4.2
53049,9/1/19,8733,8259,474,5.4
53051,9/1/19,5036,4694,342,6.8
53053,9/1/19,441240,422011,19229,4.4
53055,9/1/19,9226,8952,274,3
53057,9/1/19,62815,59933,2882,4.6
53059,9/1/19,5511,5276,235,4.3
53061,9/1/19,443684,430248,13436,3
53063,9/1/19,253277,242651,10626,4.2
53065,9/1/19,18782,17838,944,5
53067,9/1/19,142510,136572,5938,4.2
53069,9/1/19,1382,1299,83,6
53071,9/1/19,30473,29260,1213,4
53073,9/1/19,113899,108937,4962,4.4
53075,9/1/19,24835,23870,965,3.9
53077,9/1/19,139342,133205,6137,4.4
54001,9/1/19,7253,6893,360,5
54003,9/1/19,58885,56951,1934,3.3
54005,9/1/19,7489,7111,378,5
54007,9/1/19,5290,4986,304,5.7
54009,9/1/19,10133,9637,496,4.9
54011,9/1/19,42128,40543,1585,3.8
54013,9/1/19,2520,2288,232,9.2
54015,9/1/19,3123,2919,204,6.5
54017,9/1/19,4049,3898,151,3.7
54019,9/1/19,16406,15615,791,4.8
54021,9/1/19,2370,2241,129,5.4
54023,9/1/19,6030,5744,286,4.7
54025,9/1/19,16371,15727,644,3.9
54027,9/1/19,11000,10612,388,3.5
54029,9/1/19,13270,12588,682,5.1
54031,9/1/19,5860,5615,245,4.2
54033,9/1/19,34677,33301,1376,4
54035,9/1/19,13495,12925,570,4.2
54037,9/1/19,30712,29818,894,2.9
54039,9/1/19,82944,79464,3480,4.2
54041,9/1/19,6886,6492,394,5.7
54043,9/1/19,7266,6864,402,5.5
54045,9/1/19,11169,10556,613,5.5
54047,9/1/19,4427,4081,346,7.8
54049,9/1/19,25721,24546,1175,4.6
54051,9/1/19,14262,13484,778,5.5
54053,9/1/19,10382,9805,577,5.6
54055,9/1/19,21224,20136,1088,5.1
54057,9/1/19,12916,12154,762,5.9
54059,9/1/19,6963,6535,428,6.1
54061,9/1/19,55748,53924,1824,3.3
54063,9/1/19,6158,5941,217,3.5
54065,9/1/19,8254,7964,290,3.5
54067,9/1/19,9502,9001,501,5.3
54069,9/1/19,21445,20584,861,4
54071,9/1/19,3786,3667,119,3.1
54073,9/1/19,2938,2769,169,5.8
54075,9/1/19,3757,3604,153,4.1
54077,9/1/19,15922,15320,602,3.8
54079,9/1/19,27102,26077,1025,3.8
54081,9/1/19,30816,29557,1259,4.1
54083,9/1/19,12510,11892,618,4.9
54085,9/1/19,4424,4227,197,4.5
54087,9/1/19,5125,4759,366,7.1
54089,9/1/19,4435,4234,201,4.5
54091,9/1/19,7967,7626,341,4.3
54093,9/1/19,3366,3222,144,4.3
54095,9/1/19,3153,2932,221,7
54097,9/1/19,9837,9315,522,5.3
54099,9/1/19,15981,15231,750,4.7
54101,9/1/19,3391,3218,173,5.1
54103,9/1/19,6667,6259,408,6.1
54105,9/1/19,2318,2166,152,6.6
54107,9/1/19,37065,35465,1600,4.3
54109,9/1/19,6712,6319,393,5.9
55001,9/1/19,8173,7881,292,3.6
55003,9/1/19,8042,7759,283,3.5
55005,9/1/19,24237,23532,705,2.9
55007,9/1/19,7637,7361,276,3.6
55009,9/1/19,141556,137685,3871,2.7
55011,9/1/19,6426,6232,194,3
55013,9/1/19,7035,6782,253,3.6
55015,9/1/19,27410,26729,681,2.5
55017,9/1/19,32891,31955,936,2.8
55019,9/1/19,17508,17101,407,2.3
55021,9/1/19,31362,30589,773,2.5
55023,9/1/19,7470,7244,226,3
55025,9/1/19,320928,313938,6990,2.2
55027,9/1/19,47676,46455,1221,2.6
55029,9/1/19,16229,15822,407,2.5
55031,9/1/19,22918,22191,727,3.2
55033,9/1/19,23826,23193,633,2.7
55035,9/1/19,58698,57218,1480,2.5
55037,9/1/19,2198,2120,78,3.5
55039,9/1/19,57372,55881,1491,2.6
55041,9/1/19,3974,3822,152,3.8
55043,9/1/19,27568,26860,708,2.6
55045,9/1/19,20872,20406,466,2.2
55047,9/1/19,9553,9263,290,3
55049,9/1/19,13588,13296,292,2.1
55051,9/1/19,2535,2417,118,4.7
55053,9/1/19,10219,9929,290,2.8
55055,9/1/19,45701,44512,1189,2.6
55057,9/1/19,13434,13097,337,2.5
55059,9/1/19,89796,86589,3207,3.6
55061,9/1/19,10975,10666,309,2.8
55063,9/1/19,66015,64437,1578,2.4
55065,9/1/19,10023,9818,205,2
55067,9/1/19,9138,8846,292,3.2
55069,9/1/19,14914,14500,414,2.8
55071,9/1/19,40893,39737,1156,2.8
55073,9/1/19,73060,71281,1779,2.4
55075,9/1/19,19336,18561,775,4
55077,9/1/19,7728,7517,211,2.7
55078,9/1/19,1642,1494,148,9
55079,9/1/19,466351,448731,17620,3.8
55081,9/1/19,23190,22646,544,2.3
55083,9/1/19,20393,19827,566,2.8
55085,9/1/19,17759,17180,579,3.3
55087,9/1/19,102499,99930,2569,2.5
55089,9/1/19,48913,47644,1269,2.6
55091,9/1/19,4141,4030,111,2.7
55093,9/1/19,25237,24630,607,2.4
55095,9/1/19,24235,23575,660,2.7
55097,9/1/19,38461,37473,988,2.6
55099,9/1/19,6359,6157,202,3.2
55101,9/1/19,98011,94423,3588,3.7
55103,9/1/19,9116,8870,246,2.7
55105,9/1/19,85040,82162,2878,3.4
55107,9/1/19,6577,6329,248,3.8
55109,9/1/19,50346,49046,1300,2.6
55111,9/1/19,35575,34741,834,2.3
55113,9/1/19,8068,7807,261,3.2
55115,9/1/19,20838,20300,538,2.6
55117,9/1/19,62228,60745,1483,2.4
55119,9/1/19,10805,10550,255,2.4
55121,9/1/19,15801,15372,429,2.7
55123,9/1/19,15103,14729,374,2.5
55125,9/1/19,10250,9956,294,2.9
55127,9/1/19,58018,56416,1602,2.8
55129,9/1/19,7901,7657,244,3.1
55131,9/1/19,76928,74997,1931,2.5
55133,9/1/19,224238,218367,5871,2.6
55135,9/1/19,25919,25192,727,2.8
55137,9/1/19,11156,10803,353,3.2
55139,9/1/19,91009,88556,2453,2.7
55141,9/1/19,35014,33984,1030,2.9
56001,9/1/19,20009,19409,600,3
56003,9/1/19,5489,5287,202,3.7
56005,9/1/19,23123,22248,875,3.8
56007,9/1/19,8267,8039,228,2.8
56009,9/1/19,8949,8714,235,2.6
56011,9/1/19,3884,3778,106,2.7
56013,9/1/19,18781,18053,728,3.9
56015,9/1/19,6696,6470,226,3.4
56017,9/1/19,2160,2089,71,3.3
56019,9/1/19,4279,4156,123,2.9
56021,9/1/19,47863,46246,1617,3.4
56023,9/1/19,9056,8793,263,2.9
56025,9/1/19,39108,37663,1445,3.7
56027,9/1/19,1276,1245,31,2.4
56029,9/1/19,16161,15634,527,3.3
56031,9/1/19,4639,4489,150,3.2
56033,9/1/19,15715,15247,468,3
56035,9/1/19,4292,4130,162,3.8
56037,9/1/19,20911,20193,718,3.4
56039,9/1/19,16399,16067,332,2
56041,9/1/19,8969,8640,329,3.7
56043,9/1/19,3923,3793,130,3.3
56045,9/1/19,3822,3723,99,2.6
72001,9/1/19,4043,3470,573,14.2
72003,9/1/19,11481,10432,1049,9.1
72005,9/1/19,14152,12757,1395,9.9
72007,9/1/19,6396,5810,586,9.2
72009,9/1/19,6399,5743,656,10.3
72011,9/1/19,8590,7894,696,8.1
72013,9/1/19,23523,21338,2185,9.3
72015,9/1/19,4476,3921,555,12.4
72017,9/1/19,5790,5145,645,11.1
72019,9/1/19,7220,6592,628,8.7
72021,9/1/19,63780,59692,4088,6.4
72023,9/1/19,13350,12220,1130,8.5
72025,9/1/19,46634,43488,3146,6.7
72027,9/1/19,9370,8563,807,8.6
72029,9/1/19,15696,14641,1055,6.7
72031,9/1/19,60105,56504,3601,6
72033,9/1/19,7652,7082,570,7.4
72035,9/1/19,15722,14612,1110,7.1
72037,9/1/19,3624,3249,375,10.3
72039,9/1/19,3630,3226,404,11.1
72041,9/1/19,15081,14111,970,6.4
72043,9/1/19,9867,8640,1227,12.4
72045,9/1/19,4781,4366,415,8.7
72047,9/1/19,8756,7966,790,9
72049,9/1/19,884,853,31,3.5
72051,9/1/19,12886,12125,761,5.9
72053,9/1/19,10673,9576,1097,10.3
72054,9/1/19,3244,2906,338,10.4
72055,9/1/19,3999,3365,634,15.9
72057,9/1/19,10783,9469,1314,12.2
72059,9/1/19,5110,4421,689,13.5
72061,9/1/19,36629,35084,1545,4.2
72063,9/1/19,17687,16651,1036,5.9
72065,9/1/19,12980,11753,1227,9.5
72067,9/1/19,5236,4797,439,8.4
72069,9/1/19,16765,15086,1679,10
72071,9/1/19,12012,10963,1049,8.7
72073,9/1/19,4173,3578,595,14.3
72075,9/1/19,14745,13231,1514,10.3
72077,9/1/19,12062,11018,1044,8.7
72079,9/1/19,5109,4473,636,12.4
72081,9/1/19,6776,5927,849,12.5
72083,9/1/19,2502,2215,287,11.5
72085,9/1/19,11073,10051,1022,9.2
72087,9/1/19,8277,7608,669,8.1
72089,9/1/19,6055,5474,581,9.6
72091,9/1/19,11224,10307,917,8.2
72093,9/1/19,1836,1625,211,11.5
72095,9/1/19,2830,2448,382,13.5
72097,9/1/19,21269,19081,2188,10.3
72099,9/1/19,10171,9177,994,9.8
72101,9/1/19,7823,7103,720,9.2
72103,9/1/19,7976,7241,735,9.2
72105,9/1/19,6932,6337,595,8.6
72107,9/1/19,4825,4347,478,9.9
72109,9/1/19,4077,3548,529,13
72111,9/1/19,5801,4956,845,14.6
72113,9/1/19,44569,40148,4421,9.9
72115,9/1/19,5901,5256,645,10.9
72117,9/1/19,4484,4008,476,10.6
72119,9/1/19,16548,15343,1205,7.3
72121,9/1/19,6067,5312,755,12.4
72123,9/1/19,6995,5922,1073,15.3
72125,9/1/19,9542,8506,1036,10.9
72127,9/1/19,130535,123145,7390,5.7
72129,9/1/19,11433,10439,994,8.7
72131,9/1/19,9982,8762,1220,12.2
72133,9/1/19,7729,6592,1137,14.7
72135,9/1/19,26499,24959,1540,5.8
72137,9/1/19,28554,26871,1683,5.9
72139,9/1/19,26399,25111,1288,4.9
72141,9/1/19,6557,5811,746,11.4
72143,9/1/19,9519,8744,775,8.1
72145,9/1/19,13020,11758,1262,9.7
72147,9/1/19,2509,2353,156,6.2
72149,9/1/19,7241,6166,1075,14.8
72151,9/1/19,8604,7505,1099,12.8
72153,9/1/19,9633,8273,1360,14.1
1001,10/1/19,26143,25530,613,2.3
1003,10/1/19,97213,94967,2246,2.3
1005,10/1/19,8672,8374,298,3.4
1007,10/1/19,8722,8501,221,2.5
1009,10/1/19,25460,24890,570,2.2
1011,10/1/19,4850,4674,176,3.6
1013,10/1/19,9258,8957,301,3.3
1015,10/1/19,46508,45127,1381,3
1017,10/1/19,15874,15477,397,2.5
1019,10/1/19,11527,11251,276,2.4
1021,10/1/19,19946,19481,465,2.3
1023,10/1/19,4567,4372,195,4.3
1025,10/1/19,7456,7089,367,4.9
1027,10/1/19,6147,6001,146,2.4
1029,10/1/19,5792,5648,144,2.5
1031,10/1/19,21263,20739,524,2.5
1033,10/1/19,23759,23045,714,3
1035,10/1/19,4510,4353,157,3.5
1037,10/1/19,4544,4435,109,2.4
1039,10/1/19,15659,15230,429,2.7
1041,10/1/19,6482,6341,141,2.2
1043,10/1/19,38849,38013,836,2.2
1045,10/1/19,20771,20247,524,2.5
1047,10/1/19,14628,13980,648,4.4
1049,10/1/19,31115,30405,710,2.3
1051,10/1/19,37549,36677,872,2.3
1053,10/1/19,14886,14434,452,3
1055,10/1/19,42766,41481,1285,3
1057,10/1/19,6582,6409,173,2.6
1059,10/1/19,14776,14428,348,2.4
1061,10/1/19,11095,10823,272,2.5
1063,10/1/19,2880,2740,140,4.9
1065,10/1/19,6234,6020,214,3.4
1067,10/1/19,6952,6748,204,2.9
1069,10/1/19,46326,45190,1136,2.5
1071,10/1/19,23308,22649,659,2.8
1073,10/1/19,320306,312557,7749,2.4
1075,10/1/19,5880,5729,151,2.6
1077,10/1/19,42816,41644,1172,2.7
1079,10/1/19,14362,13993,369,2.6
1081,10/1/19,77850,76103,1747,2.2
1083,10/1/19,44215,43253,962,2.2
1085,10/1/19,3570,3398,172,4.8
1087,10/1/19,7926,7647,279,3.5
1089,10/1/19,186819,182792,4027,2.2
1091,10/1/19,7664,7435,229,3
1093,10/1/19,12879,12504,375,2.9
1095,10/1/19,44217,43302,915,2.1
1097,10/1/19,190090,184147,5943,3.1
1099,10/1/19,7357,7032,325,4.4
1101,10/1/19,105617,102815,2802,2.7
1103,10/1/19,58611,57310,1301,2.2
1105,10/1/19,3422,3278,144,4.2
1107,10/1/19,8046,7821,225,2.8
1109,10/1/19,15653,15214,439,2.8
1111,10/1/19,9758,9508,250,2.6
1113,10/1/19,23932,23346,586,2.4
1115,10/1/19,40738,39806,932,2.3
1117,10/1/19,116598,114463,2135,1.8
1119,10/1/19,4915,4734,181,3.7
1121,10/1/19,35873,34813,1060,3
1123,10/1/19,18643,18164,479,2.6
1125,10/1/19,106733,104372,2361,2.2
1127,10/1/19,25446,24733,713,2.8
1129,10/1/19,6823,6567,256,3.8
1131,10/1/19,2751,2574,177,6.4
1133,10/1/19,10212,9898,314,3.1
2013,10/1/19,2294,2232,62,2.7
2016,10/1/19,3230,3088,142,4.4
2020,10/1/19,146368,139300,7068,4.8
2050,10/1/19,7155,6338,817,11.4
2060,10/1/19,276,254,22,8
2068,10/1/19,928,841,87,9.4
2070,10/1/19,1813,1683,130,7.2
2090,10/1/19,44717,42492,2225,5
2100,10/1/19,1088,997,91,8.4
2105,10/1/19,1031,927,104,10.1
2110,10/1/19,16854,16153,701,4.2
2122,10/1/19,25612,23951,1661,6.5
2130,10/1/19,6783,6367,416,6.1
2150,10/1/19,5945,5667,278,4.7
2158,10/1/19,2679,2256,423,15.8
2164,10/1/19,718,662,56,7.8
2170,10/1/19,46364,43508,2856,6.2
2180,10/1/19,4177,3809,368,8.8
2185,10/1/19,3435,3196,239,7
2188,10/1/19,3102,2712,390,12.6
2195,10/1/19,1330,1213,117,8.8
2198,10/1/19,2781,2548,233,8.4
2220,10/1/19,4068,3893,175,4.3
2230,10/1/19,843,779,64,7.6
2240,10/1/19,2794,2574,220,7.9
2261,10/1/19,4480,4102,378,8.4
2275,10/1/19,997,926,71,7.1
2282,10/1/19,243,224,19,7.8
2290,10/1/19,2502,2214,288,11.5
4001,10/1/19,20507,18603,1904,9.3
4003,10/1/19,51646,48914,2732,5.3
4005,10/1/19,79349,75428,3921,4.9
4007,10/1/19,21794,20663,1131,5.2
4009,10/1/19,15731,15046,685,4.4
4011,10/1/19,4569,4405,164,3.6
4012,10/1/19,9811,9309,502,5.1
4013,10/1/19,2344335,2255484,88851,3.8
4015,10/1/19,88263,83475,4788,5.4
4017,10/1/19,41657,38935,2722,6.5
4019,10/1/19,501592,480312,21280,4.2
4021,10/1/19,191534,182681,8853,4.6
4023,10/1/19,19606,17634,1972,10.1
4025,10/1/19,107722,103184,4538,4.2
4027,10/1/19,102978,85886,17092,16.6
5001,10/1/19,9450,9211,239,2.5
5003,10/1/19,7592,7265,327,4.3
5005,10/1/19,16215,15670,545,3.4
5007,10/1/19,139190,135989,3201,2.3
5009,10/1/19,16101,15643,458,2.8
5011,10/1/19,4516,4362,154,3.4
5013,10/1/19,2459,2377,82,3.3
5015,10/1/19,13075,12749,326,2.5
5017,10/1/19,3279,3097,182,5.6
5019,10/1/19,9821,9493,328,3.3
5021,10/1/19,5642,5429,213,3.8
5023,10/1/19,9160,8779,381,4.2
5025,10/1/19,3243,3128,115,3.5
5027,10/1/19,9247,8889,358,3.9
5029,10/1/19,8340,8030,310,3.7
5031,10/1/19,56337,54998,1339,2.4
5033,10/1/19,26915,26121,794,3
5035,10/1/19,21432,20660,772,3.6
5037,10/1/19,7469,7195,274,3.7
5039,10/1/19,2841,2729,112,3.9
5041,10/1/19,5462,5258,204,3.7
5043,10/1/19,7952,7612,340,4.3
5045,10/1/19,62297,60622,1675,2.7
5047,10/1/19,7554,7328,226,3
5049,10/1/19,4956,4797,159,3.2
5051,10/1/19,40921,39546,1375,3.4
5053,10/1/19,8417,8174,243,2.9
5055,10/1/19,20130,19526,604,3
5057,10/1/19,9943,9611,332,3.3
5059,10/1/19,14049,13588,461,3.3
5061,10/1/19,5733,5578,155,2.7
5063,10/1/19,16570,15977,593,3.6
5065,10/1/19,4857,4644,213,4.4
5067,10/1/19,5884,5540,344,5.8
5069,10/1/19,27765,26440,1325,4.8
5071,10/1/19,10237,9862,375,3.7
5073,10/1/19,2463,2358,105,4.3
5075,10/1/19,6897,6661,236,3.4
5077,10/1/19,2854,2742,112,3.9
5079,10/1/19,3967,3820,147,3.7
5081,10/1/19,5519,5308,211,3.8
5083,10/1/19,8597,8245,352,4.1
5085,10/1/19,34462,33475,987,2.9
5087,10/1/19,7577,7398,179,2.4
5089,10/1/19,6636,6399,237,3.6
5091,10/1/19,19685,19002,683,3.5
5093,10/1/19,17393,16702,691,4
5095,10/1/19,2767,2661,106,3.8
5097,10/1/19,2941,2819,122,4.1
5099,10/1/19,3649,3520,129,3.5
5101,10/1/19,3342,3245,97,2.9
5103,10/1/19,9840,9408,432,4.4
5105,10/1/19,4245,4108,137,3.2
5107,10/1/19,6336,6000,336,5.3
5109,10/1/19,4245,4098,147,3.5
5111,10/1/19,10438,10131,307,2.9
5113,10/1/19,8159,7837,322,3.9
5115,10/1/19,29011,28034,977,3.4
5117,10/1/19,3612,3484,128,3.5
5119,10/1/19,189786,183949,5837,3.1
5121,10/1/19,7382,7152,230,3.1
5123,10/1/19,8181,7832,349,4.3
5125,10/1/19,59026,57494,1532,2.6
5127,10/1/19,4346,4212,134,3.1
5129,10/1/19,2848,2728,120,4.2
5131,10/1/19,56640,54959,1681,3
5133,10/1/19,5549,5311,238,4.3
5135,10/1/19,5723,5470,253,4.4
5137,10/1/19,4680,4504,176,3.8
5139,10/1/19,15816,15082,734,4.6
5141,10/1/19,5698,5453,245,4.3
5143,10/1/19,126763,124020,2743,2.2
5145,10/1/19,33766,32512,1254,3.7
5147,10/1/19,2803,2678,125,4.5
5149,10/1/19,8507,8239,268,3.2
6001,10/1/19,848333,824883,23450,2.8
6003,10/1/19,455,431,24,5.3
6005,10/1/19,15107,14603,504,3.3
6007,10/1/19,100659,96479,4180,4.2
6009,10/1/19,21706,20983,723,3.3
6011,10/1/19,10918,10070,848,7.8
6013,10/1/19,564347,548106,16241,2.9
6015,10/1/19,9777,9257,520,5.3
6017,10/1/19,92298,89409,2889,3.1
6019,10/1/19,448769,421325,27444,6.1
6021,10/1/19,13322,12723,599,4.5
6023,10/1/19,63070,61103,1967,3.1
6025,10/1/19,72614,58424,14190,19.5
6027,10/1/19,8814,8559,255,2.9
6029,10/1/19,399408,374344,25064,6.3
6031,10/1/19,57617,53827,3790,6.6
6033,10/1/19,29003,27713,1290,4.4
6035,10/1/19,10562,10212,350,3.3
6037,10/1/19,5157853,4936189,221664,4.3
6039,10/1/19,61525,58067,3458,5.6
6041,10/1/19,141147,138133,3014,2.1
6043,10/1/19,7756,7481,275,3.5
6045,10/1/19,39095,37828,1267,3.2
6047,10/1/19,118481,111360,7121,6
6049,10/1/19,3254,3101,153,4.7
6051,10/1/19,7968,7648,320,4
6053,10/1/19,224987,216223,8764,3.9
6055,10/1/19,75561,73747,1814,2.4
6057,10/1/19,48417,46964,1453,3
6059,10/1/19,1631968,1588998,42970,2.6
6061,10/1/19,188716,183305,5411,2.9
6063,10/1/19,7980,7582,398,5
6065,10/1/19,1110812,1065345,45467,4.1
6067,10/1/19,715047,690825,24222,3.4
6069,10/1/19,31573,30242,1331,4.2
6071,10/1/19,973253,938057,35196,3.6
6073,10/1/19,1598643,1550782,47861,3
6075,10/1/19,589787,577708,12079,2
6077,10/1/19,327968,310984,16984,5.2
6079,10/1/19,142355,138706,3649,2.6
6081,10/1/19,465302,456399,8903,1.9
6083,10/1/19,220335,213465,6870,3.1
6085,10/1/19,1059060,1034036,25024,2.4
6087,10/1/19,143704,138705,4999,3.5
6089,10/1/19,75417,72460,2957,3.9
6091,10/1/19,1370,1315,55,4
6093,10/1/19,17479,16659,820,4.7
6095,10/1/19,210932,203840,7092,3.4
6097,10/1/19,263296,257014,6282,2.4
6099,10/1/19,244850,232483,12367,5.1
6101,10/1/19,46260,43770,2490,5.4
6103,10/1/19,26431,25245,1186,4.5
6105,10/1/19,4692,4481,211,4.5
6107,10/1/19,202214,185254,16960,8.4
6109,10/1/19,21325,20513,812,3.8
6111,10/1/19,425299,410833,14466,3.4
6113,10/1/19,108749,105079,3670,3.4
6115,10/1/19,30617,29081,1536,5
8001,10/1/19,278819,271894,6925,2.5
8003,10/1/19,9145,8879,266,2.9
8005,10/1/19,372285,363443,8842,2.4
8007,10/1/19,7112,6933,179,2.5
8009,10/1/19,2325,2291,34,1.5
8011,10/1/19,2080,2033,47,2.3
8013,10/1/19,198261,194133,4128,2.1
8014,10/1/19,41022,40132,890,2.2
8015,10/1/19,9673,9460,213,2.2
8017,10/1/19,1301,1283,18,1.4
8019,10/1/19,6173,6044,129,2.1
8021,10/1/19,4427,4315,112,2.5
8023,10/1/19,1959,1905,54,2.8
8025,10/1/19,1573,1521,52,3.3
8027,10/1/19,2135,2080,55,2.6
8029,10/1/19,15200,14823,377,2.5
8031,10/1/19,425612,415644,9968,2.3
8033,10/1/19,1254,1226,28,2.2
8035,10/1/19,198556,194346,4210,2.1
8037,10/1/19,35353,34645,708,2
8039,10/1/19,15736,15450,286,1.8
8041,10/1/19,345876,336141,9735,2.8
8043,10/1/19,15193,14593,600,3.9
8045,10/1/19,31863,31121,742,2.3
8047,10/1/19,3856,3778,78,2
8049,10/1/19,9166,8981,185,2
8051,10/1/19,11450,11246,204,1.8
8053,10/1/19,408,390,18,4.4
8055,10/1/19,2574,2459,115,4.5
8057,10/1/19,1118,1100,18,1.6
8059,10/1/19,342188,334617,7571,2.2
8061,10/1/19,1083,1068,15,1.4
8063,10/1/19,4696,4627,69,1.5
8065,10/1/19,4772,4657,115,2.4
8067,10/1/19,32835,32182,653,2
8069,10/1/19,211959,207740,4219,2
8071,10/1/19,6776,6570,206,3
8073,10/1/19,2508,2459,49,2
8075,10/1/19,11495,11278,217,1.9
8077,10/1/19,77377,75226,2151,2.8
8079,10/1/19,459,449,10,2.2
8081,10/1/19,7393,7213,180,2.4
8083,10/1/19,13349,12953,396,3
8085,10/1/19,22603,22075,528,2.3
8087,10/1/19,17420,17043,377,2.2
8089,10/1/19,8876,8592,284,3.2
8091,10/1/19,2496,2441,55,2.2
8093,10/1/19,11380,11155,225,2
8095,10/1/19,2922,2884,38,1.3
8097,10/1/19,11030,10658,372,3.4
8099,10/1/19,6805,6657,148,2.2
8101,10/1/19,77084,74430,2654,3.4
8103,10/1/19,3124,3036,88,2.8
8105,10/1/19,5851,5679,172,2.9
8107,10/1/19,15799,15490,309,2
8109,10/1/19,3912,3798,114,2.9
8111,10/1/19,605,592,13,2.1
8113,10/1/19,5523,5416,107,1.9
8115,10/1/19,1353,1329,24,1.8
8117,10/1/19,20760,20347,413,2
8119,10/1/19,12872,12528,344,2.7
8121,10/1/19,3127,3072,55,1.8
8123,10/1/19,175276,171442,3834,2.2
8125,10/1/19,6618,6526,92,1.4
9001,10/1/19,482001,465630,16371,3.4
9003,10/1/19,487268,469592,17676,3.6
9005,10/1/19,105707,102556,3151,3
9007,10/1/19,94641,91808,2833,3
9009,10/1/19,465906,448681,17225,3.7
9011,10/1/19,137621,133073,4548,3.3
9013,10/1/19,87694,85103,2591,3
9015,10/1/19,64656,62416,2240,3.5
10001,10/1/19,80257,76861,3396,4.2
10003,10/1/19,300235,288693,11542,3.8
10005,10/1/19,107283,103471,3812,3.6
11001,10/1/19,409726,388209,21517,5.3
12001,10/1/19,142433,138577,3856,2.7
12003,10/1/19,12086,11750,336,2.8
12005,10/1/19,83908,81344,2564,3.1
12007,10/1/19,11338,11017,321,2.8
12009,10/1/19,288618,280184,8434,2.9
12011,10/1/19,1053729,1024008,29721,2.8
12013,10/1/19,4866,4690,176,3.6
12015,10/1/19,71956,69566,2390,3.3
12017,10/1/19,47560,45530,2030,4.3
12019,10/1/19,109932,106889,3043,2.8
12021,10/1/19,180325,174924,5401,3
12023,10/1/19,30511,29636,875,2.9
12027,10/1/19,14120,13648,472,3.3
12029,10/1/19,6040,5837,203,3.4
12031,10/1/19,501891,486950,14941,3
12033,10/1/19,147434,143107,4327,2.9
12035,10/1/19,47214,45576,1638,3.5
12037,10/1/19,4567,4436,131,2.9
12039,10/1/19,19487,18744,743,3.8
12041,10/1/19,7307,7076,231,3.2
12043,10/1/19,5440,5245,195,3.6
12045,10/1/19,5730,5520,210,3.7
12047,10/1/19,4539,4371,168,3.7
12049,10/1/19,8555,8143,412,4.8
12051,10/1/19,15837,14891,946,6
12053,10/1/19,73028,70218,2810,3.8
12055,10/1/19,36060,34572,1488,4.1
12057,10/1/19,761135,739355,21780,2.9
12059,10/1/19,7098,6875,223,3.1
12061,10/1/19,65470,63147,2323,3.5
12063,10/1/19,17329,16795,534,3.1
12065,10/1/19,5729,5558,171,3
12067,10/1/19,2869,2789,80,2.8
12069,10/1/19,161180,156472,4708,2.9
12071,10/1/19,351228,341096,10132,2.9
12073,10/1/19,158581,154075,4506,2.8
12075,10/1/19,16972,16418,554,3.3
12077,10/1/19,2670,2582,88,3.3
12079,10/1/19,7605,7351,254,3.3
12081,10/1/19,180308,175058,5250,2.9
12083,10/1/19,139117,134320,4797,3.4
12085,10/1/19,74680,72586,2094,2.8
12086,10/1/19,1399889,1371540,28349,2
12087,10/1/19,46529,45643,886,1.9
12089,10/1/19,42041,40917,1124,2.7
12091,10/1/19,97693,95387,2306,2.4
12093,10/1/19,18028,17469,559,3.1
12095,10/1/19,773112,752294,20818,2.7
12097,10/1/19,186807,181017,5790,3.1
12099,10/1/19,737312,714672,22640,3.1
12101,10/1/19,241528,233812,7716,3.2
12103,10/1/19,501699,488248,13451,2.7
12105,10/1/19,309933,299315,10618,3.4
12107,10/1/19,26719,25681,1038,3.9
12109,10/1/19,135017,131814,3203,2.4
12111,10/1/19,146174,140798,5376,3.7
12113,10/1/19,83759,81516,2243,2.7
12115,10/1/19,189771,184481,5290,2.8
12117,10/1/19,258997,251986,7011,2.7
12119,10/1/19,32901,31606,1295,3.9
12121,10/1/19,18289,17709,580,3.2
12123,10/1/19,8335,8064,271,3.3
12125,10/1/19,4712,4582,130,2.8
12127,10/1/19,255779,247613,8166,3.2
12129,10/1/19,15215,14804,411,2.7
12131,10/1/19,31844,31064,780,2.4
12133,10/1/19,9655,9361,294,3
13001,10/1/19,9466,9170,296,3.1
13003,10/1/19,4673,4557,116,2.5
13005,10/1/19,4921,4742,179,3.6
13007,10/1/19,1166,1117,49,4.2
13009,10/1/19,17455,16807,648,3.7
13011,10/1/19,9720,9480,240,2.5
13013,10/1/19,40762,39722,1040,2.6
13015,10/1/19,50979,49475,1504,3
13017,10/1/19,5336,5072,264,4.9
13019,10/1/19,7566,7217,349,4.6
13021,10/1/19,67645,65249,2396,3.5
13023,10/1/19,4488,4284,204,4.5
13025,10/1/19,7239,6975,264,3.6
13027,10/1/19,6944,6723,221,3.2
13029,10/1/19,18278,17759,519,2.8
13031,10/1/19,36460,35253,1207,3.3
13033,10/1/19,9124,8733,391,4.3
13035,10/1/19,10813,10502,311,2.9
13037,10/1/19,2275,2199,76,3.3
13039,10/1/19,20857,20163,694,3.3
13043,10/1/19,5620,5470,150,2.7
13045,10/1/19,55681,53972,1709,3.1
13047,10/1/19,33738,32845,893,2.6
13049,10/1/19,4809,4648,161,3.3
13051,10/1/19,139417,135191,4226,3
13053,10/1/19,1990,1912,78,3.9
13055,10/1/19,10178,9789,389,3.8
13057,10/1/19,137120,133722,3398,2.5
13059,10/1/19,59713,57813,1900,3.2
13061,10/1/19,894,839,55,6.2
13063,10/1/19,138750,133575,5175,3.7
13065,10/1/19,2513,2424,89,3.5
13067,10/1/19,429043,417598,11445,2.7
13069,10/1/19,18887,18264,623,3.3
13071,10/1/19,21494,20881,613,2.9
13073,10/1/19,75310,73227,2083,2.8
13075,10/1/19,8053,7798,255,3.2
13077,10/1/19,75259,73286,1973,2.6
13079,10/1/19,5596,5406,190,3.4
13081,10/1/19,9441,9079,362,3.8
13083,10/1/19,8259,8024,235,2.8
13085,10/1/19,12434,12116,318,2.6
13087,10/1/19,11484,11082,402,3.5
13089,10/1/19,402686,390376,12310,3.1
13091,10/1/19,7039,6687,352,5
13093,10/1/19,5115,4933,182,3.6
13095,10/1/19,38424,36777,1647,4.3
13097,10/1/19,73857,71496,2361,3.2
13099,10/1/19,4474,4324,150,3.4
13101,10/1/19,1919,1871,48,2.5
13103,10/1/19,30859,30028,831,2.7
13105,10/1/19,7715,7416,299,3.9
13107,10/1/19,8284,7867,417,5
13109,10/1/19,4925,4776,149,3
13111,10/1/19,11532,11175,357,3.1
13113,10/1/19,58497,56936,1561,2.7
13115,10/1/19,44467,42979,1488,3.3
13117,10/1/19,123257,120175,3082,2.5
13119,10/1/19,9882,9553,329,3.3
13121,10/1/19,561635,544120,17515,3.1
13123,10/1/19,11959,11582,377,3.2
13125,10/1/19,1283,1239,44,3.4
13127,10/1/19,39249,38046,1203,3.1
13129,10/1/19,28031,27136,895,3.2
13131,10/1/19,10385,10044,341,3.3
13133,10/1/19,6950,6705,245,3.5
13135,10/1/19,494085,480646,13439,2.7
13137,10/1/19,19034,18434,600,3.2
13139,10/1/19,102981,100423,2558,2.5
13141,10/1/19,2445,2332,113,4.6
13143,10/1/19,12675,12289,386,3
13145,10/1/19,16656,16188,468,2.8
13147,10/1/19,11071,10610,461,4.2
13149,10/1/19,5290,5134,156,2.9
13151,10/1/19,116423,112754,3669,3.2
13153,10/1/19,70268,68083,2185,3.1
13155,10/1/19,3357,3222,135,4
13157,10/1/19,36867,35996,871,2.4
13159,10/1/19,6997,6807,190,2.7
13161,10/1/19,5988,5744,244,4.1
13163,10/1/19,6609,6319,290,4.4
13165,10/1/19,3128,2999,129,4.1
13167,10/1/19,3973,3846,127,3.2
13169,10/1/19,13663,13266,397,2.9
13171,10/1/19,8305,8010,295,3.6
13173,10/1/19,3762,3628,134,3.6
13175,10/1/19,18875,18056,819,4.3
13177,10/1/19,14782,14372,410,2.8
13179,10/1/19,26212,25305,907,3.5
13181,10/1/19,3558,3435,123,3.5
13183,10/1/19,8168,7901,267,3.3
13185,10/1/19,51435,49752,1683,3.3
13187,10/1/19,16951,16462,489,2.9
13189,10/1/19,8879,8443,436,4.9
13191,10/1/19,6149,5953,196,3.2
13193,10/1/19,4672,4476,196,4.2
13195,10/1/19,13443,13061,382,2.8
13197,10/1/19,3297,3176,121,3.7
13199,10/1/19,8969,8613,356,4
13201,10/1/19,2752,2670,82,3
13205,10/1/19,8549,8191,358,4.2
13207,10/1/19,12944,12581,363,2.8
13209,10/1/19,3796,3617,179,4.7
13211,10/1/19,9327,9061,266,2.9
13213,10/1/19,15502,14719,783,5.1
13215,10/1/19,77325,74189,3136,4.1
13217,10/1/19,52603,50794,1809,3.4
13219,10/1/19,19741,19286,455,2.3
13221,10/1/19,7000,6801,199,2.8
13223,10/1/19,86707,84405,2302,2.7
13225,10/1/19,11850,11364,486,4.1
13227,10/1/19,15418,14995,423,2.7
13229,10/1/19,8691,8414,277,3.2
13231,10/1/19,8979,8736,243,2.7
13233,10/1/19,18520,17933,587,3.2
13235,10/1/19,4039,3904,135,3.3
13237,10/1/19,8226,7921,305,3.7
13239,10/1/19,792,758,34,4.3
13241,10/1/19,7214,6964,250,3.5
13243,10/1/19,2546,2436,110,4.3
13245,10/1/19,85013,81632,3381,4
13247,10/1/19,45095,43582,1513,3.4
13249,10/1/19,2248,2170,78,3.5
13251,10/1/19,5046,4833,213,4.2
13253,10/1/19,2987,2868,119,4
13255,10/1/19,28888,27862,1026,3.6
13257,10/1/19,10644,10280,364,3.4
13259,10/1/19,2418,2331,87,3.6
13261,10/1/19,12948,12385,563,4.3
13263,10/1/19,2806,2698,108,3.8
13265,10/1/19,566,536,30,5.3
13267,10/1/19,9578,9260,318,3.3
13269,10/1/19,3189,3057,132,4.1
13271,10/1/19,3851,3489,362,9.4
13273,10/1/19,3498,3358,140,4
13275,10/1/19,16431,15808,623,3.8
13277,10/1/19,19923,19311,612,3.1
13279,10/1/19,11652,11113,539,4.6
13281,10/1/19,3957,3783,174,4.4
13283,10/1/19,2590,2455,135,5.2
13285,10/1/19,37393,36313,1080,2.9
13287,10/1/19,3147,3036,111,3.5
13289,10/1/19,2860,2721,139,4.9
13291,10/1/19,10287,10004,283,2.8
13293,10/1/19,11391,11003,388,3.4
13295,10/1/19,31475,30545,930,3
13297,10/1/19,46419,45140,1279,2.8
13299,10/1/19,15529,14999,530,3.4
13301,10/1/19,2854,2733,121,4.2
13303,10/1/19,7031,6774,257,3.7
13305,10/1/19,11267,10860,407,3.6
13307,10/1/19,1031,986,45,4.4
13309,10/1/19,1598,1480,118,7.4
13311,10/1/19,16618,16226,392,2.4
13313,10/1/19,43567,41612,1955,4.5
13315,10/1/19,2708,2603,105,3.9
13317,10/1/19,3810,3634,176,4.6
13319,10/1/19,3971,3839,132,3.3
13321,10/1/19,8934,8616,318,3.6
15001,10/1/19,90994,87808,3186,3.5
15003,10/1/19,450270,439160,11110,2.5
15007,10/1/19,36359,35403,956,2.6
15009,10/1/19,86124,83836,2288,2.7
16001,10/1/19,253818,248233,5585,2.2
16003,10/1/19,1676,1608,68,4.1
16005,10/1/19,43005,41994,1011,2.4
16007,10/1/19,3026,2962,64,2.1
16009,10/1/19,4089,3960,129,3.2
16011,10/1/19,25302,24798,504,2
16013,10/1/19,11873,11627,246,2.1
16015,10/1/19,3477,3369,108,3.1
16017,10/1/19,19605,18974,631,3.2
16019,10/1/19,57346,56206,1140,2
16021,10/1/19,5380,5210,170,3.2
16023,10/1/19,1458,1429,29,2
16025,10/1/19,725,706,19,2.6
16027,10/1/19,104599,101843,2756,2.6
16029,10/1/19,4382,4295,87,2
16031,10/1/19,13045,12817,228,1.7
16033,10/1/19,418,405,13,3.1
16035,10/1/19,2875,2745,130,4.5
16037,10/1/19,2245,2166,79,3.5
16039,10/1/19,11517,11227,290,2.5
16041,10/1/19,7358,7232,126,1.7
16043,10/1/19,8690,8560,130,1.5
16045,10/1/19,8340,8116,224,2.7
16047,10/1/19,8283,8114,169,2
16049,10/1/19,6504,6299,205,3.2
16051,10/1/19,14385,14122,263,1.8
16053,10/1/19,12340,12099,241,2
16055,10/1/19,79673,77469,2204,2.8
16057,10/1/19,21113,20674,439,2.1
16059,10/1/19,3544,3428,116,3.3
16061,10/1/19,1651,1584,67,4.1
16063,10/1/19,2740,2679,61,2.2
16065,10/1/19,23185,22846,339,1.5
16067,10/1/19,12109,11888,221,1.8
16069,10/1/19,21135,20649,486,2.3
16071,10/1/19,2377,2340,37,1.6
16073,10/1/19,5301,5169,132,2.5
16075,10/1/19,11792,11458,334,2.8
16077,10/1/19,4802,4719,83,1.7
16079,10/1/19,4921,4697,224,4.6
16081,10/1/19,6931,6786,145,2.1
16083,10/1/19,41763,40819,944,2.3
16085,10/1/19,5354,5190,164,3.1
16087,10/1/19,4701,4555,146,3.1
17001,10/1/19,32234,31196,1038,3.2
17003,10/1/19,2057,1943,114,5.5
17005,10/1/19,7918,7653,265,3.3
17007,10/1/19,26184,25009,1175,4.5
17009,10/1/19,3049,2981,68,2.2
17011,10/1/19,17436,16760,676,3.9
17013,10/1/19,2352,2260,92,3.9
17015,10/1/19,7469,7212,257,3.4
17017,10/1/19,6144,5935,209,3.4
17019,10/1/19,112731,108902,3829,3.4
17021,10/1/19,14417,13807,610,4.2
17023,10/1/19,7731,7439,292,3.8
17025,10/1/19,6563,6304,259,3.9
17027,10/1/19,20797,20173,624,3
17029,10/1/19,24353,23480,873,3.6
17031,10/1/19,2584954,2497641,87313,3.4
17033,10/1/19,8770,8440,330,3.8
17035,10/1/19,6203,6029,174,2.8
17037,10/1/19,55729,53693,2036,3.7
17039,10/1/19,7579,7320,259,3.4
17041,10/1/19,10401,10066,335,3.2
17043,10/1/19,506480,493220,13260,2.6
17045,10/1/19,9031,8682,349,3.9
17047,10/1/19,2695,2598,97,3.6
17049,10/1/19,19369,18811,558,2.9
17051,10/1/19,9963,9598,365,3.7
17053,10/1/19,6740,6504,236,3.5
17055,10/1/19,16487,15689,798,4.8
17057,10/1/19,15293,14599,694,4.5
17059,10/1/19,2349,2252,97,4.1
17061,10/1/19,6112,5886,226,3.7
17063,10/1/19,25186,24357,829,3.3
17065,10/1/19,4511,4357,154,3.4
17067,10/1/19,8613,8280,333,3.9
17069,10/1/19,1331,1258,73,5.5
17071,10/1/19,3628,3503,125,3.4
17073,10/1/19,25391,24329,1062,4.2
17075,10/1/19,14694,14172,522,3.6
17077,10/1/19,28426,27389,1037,3.6
17079,10/1/19,4704,4540,164,3.5
17081,10/1/19,17555,16812,743,4.2
17083,10/1/19,11081,10670,411,3.7
17085,10/1/19,10964,10619,345,3.1
17087,10/1/19,4176,3977,199,4.8
17089,10/1/19,274663,264581,10082,3.7
17091,10/1/19,56899,54486,2413,4.2
17093,10/1/19,68344,66428,1916,2.8
17095,10/1/19,21796,20806,990,4.5
17097,10/1/19,377502,364410,13092,3.5
17099,10/1/19,54794,52495,2299,4.2
17101,10/1/19,5822,5573,249,4.3
17103,10/1/19,17909,17334,575,3.2
17105,10/1/19,16923,16346,577,3.4
17107,10/1/19,12724,12232,492,3.9
17109,10/1/19,13857,13336,521,3.8
17111,10/1/19,164879,160295,4584,2.8
17113,10/1/19,89514,86494,3020,3.4
17115,10/1/19,48737,46368,2369,4.9
17117,10/1/19,23272,22427,845,3.6
17119,10/1/19,135607,130848,4759,3.5
17121,10/1/19,17668,16870,798,4.5
17123,10/1/19,5392,5170,222,4.1
17125,10/1/19,6423,6140,283,4.4
17127,10/1/19,5638,5361,277,4.9
17129,10/1/19,6545,6336,209,3.2
17131,10/1/19,8215,7886,329,4
17133,10/1/19,19052,18491,561,2.9
17135,10/1/19,11769,11262,507,4.3
17137,10/1/19,16662,16072,590,3.5
17139,10/1/19,7685,7458,227,3
17141,10/1/19,25027,23989,1038,4.1
17143,10/1/19,85250,81344,3906,4.6
17145,10/1/19,8487,8004,483,5.7
17147,10/1/19,8941,8669,272,3
17149,10/1/19,7076,6833,243,3.4
17151,10/1/19,1697,1619,78,4.6
17153,10/1/19,2080,1970,110,5.3
17155,10/1/19,3061,2953,108,3.5
17157,10/1/19,14596,13964,632,4.3
17159,10/1/19,7289,7027,262,3.6
17161,10/1/19,72288,68927,3361,4.6
17163,10/1/19,127893,122710,5183,4.1
17165,10/1/19,9776,9314,462,4.7
17167,10/1/19,101397,97798,3599,3.5
17169,10/1/19,3313,3190,123,3.7
17171,10/1/19,2549,2455,94,3.7
17173,10/1/19,10799,10435,364,3.4
17175,10/1/19,2565,2450,115,4.5
17177,10/1/19,21906,21069,837,3.8
17179,10/1/19,64133,61642,2491,3.9
17181,10/1/19,7584,7254,330,4.4
17183,10/1/19,33480,31909,1571,4.7
17185,10/1/19,5966,5772,194,3.3
17187,10/1/19,8575,8272,303,3.5
17189,10/1/19,10280,9936,344,3.3
17191,10/1/19,7229,6931,298,4.1
17193,10/1/19,6717,6487,230,3.4
17195,10/1/19,28946,27833,1113,3.8
17197,10/1/19,355213,343847,11366,3.2
17199,10/1/19,32384,31160,1224,3.8
17201,10/1/19,139810,132695,7115,5.1
17203,10/1/19,18889,18285,604,3.2
18001,10/1/19,17218,16774,444,2.6
18003,10/1/19,189802,183503,6299,3.3
18005,10/1/19,44861,43862,999,2.2
18007,10/1/19,4656,4532,124,2.7
18009,10/1/19,4931,4756,175,3.5
18011,10/1/19,36529,35716,813,2.2
18013,10/1/19,7745,7552,193,2.5
18015,10/1/19,10428,10168,260,2.5
18017,10/1/19,17817,17311,506,2.8
18019,10/1/19,61754,59896,1858,3
18021,10/1/19,12100,11729,371,3.1
18023,10/1/19,17300,16867,433,2.5
18025,10/1/19,4828,4666,162,3.4
18027,10/1/19,16769,16387,382,2.3
18029,10/1/19,25837,25009,828,3.2
18031,10/1/19,14627,14267,360,2.5
18033,10/1/19,22839,22146,693,3
18035,10/1/19,54541,52581,1960,3.6
18037,10/1/19,22952,22470,482,2.1
18039,10/1/19,111645,108410,3235,2.9
18041,10/1/19,8637,8242,395,4.6
18043,10/1/19,41736,40522,1214,2.9
18045,10/1/19,8074,7819,255,3.2
18047,10/1/19,11404,11062,342,3
18049,10/1/19,9911,9618,293,3
18051,10/1/19,19544,19100,444,2.3
18053,10/1/19,32215,31080,1135,3.5
18055,10/1/19,13780,13298,482,3.5
18057,10/1/19,185018,180702,4316,2.3
18059,10/1/19,40507,39486,1021,2.5
18061,10/1/19,20314,19755,559,2.8
18063,10/1/19,90555,88297,2258,2.5
18065,10/1/19,22138,21503,635,2.9
18067,10/1/19,37042,35827,1215,3.3
18069,10/1/19,18511,17892,619,3.3
18071,10/1/19,22968,22439,529,2.3
18073,10/1/19,16446,15969,477,2.9
18075,10/1/19,9442,9185,257,2.7
18077,10/1/19,15004,14542,462,3.1
18079,10/1/19,13603,13243,360,2.6
18081,10/1/19,83529,81466,2063,2.5
18083,10/1/19,18640,18140,500,2.7
18085,10/1/19,42206,41060,1146,2.7
18087,10/1/19,20062,19551,511,2.5
18089,10/1/19,232296,222573,9723,4.2
18091,10/1/19,47828,46149,1679,3.5
18093,10/1/19,21383,20701,682,3.2
18095,10/1/19,59442,57508,1934,3.3
18097,10/1/19,493369,478609,14760,3
18099,10/1/19,23043,22399,644,2.8
18101,10/1/19,5393,5267,126,2.3
18103,10/1/19,15247,14710,537,3.5
18105,10/1/19,72149,69960,2189,3
18107,10/1/19,18932,18397,535,2.8
18109,10/1/19,36524,35556,968,2.7
18111,10/1/19,7040,6809,231,3.3
18113,10/1/19,23681,23001,680,2.9
18115,10/1/19,3184,3086,98,3.1
18117,10/1/19,8548,8284,264,3.1
18119,10/1/19,9612,9301,311,3.2
18121,10/1/19,7151,6916,235,3.3
18123,10/1/19,9212,8946,266,2.9
18125,10/1/19,6140,5980,160,2.6
18127,10/1/19,87730,84872,2858,3.3
18129,10/1/19,13660,13318,342,2.5
18131,10/1/19,6495,6320,175,2.7
18133,10/1/19,16875,16364,511,3
18135,10/1/19,11500,11132,368,3.2
18137,10/1/19,14119,13735,384,2.7
18139,10/1/19,8958,8745,213,2.4
18141,10/1/19,136095,131444,4651,3.4
18143,10/1/19,10566,10233,333,3.2
18145,10/1/19,23300,22701,599,2.6
18147,10/1/19,10724,10438,286,2.7
18149,10/1/19,9919,9566,353,3.6
18151,10/1/19,21062,20496,566,2.7
18153,10/1/19,8414,8117,297,3.5
18155,10/1/19,4997,4842,155,3.1
18157,10/1/19,100785,98018,2767,2.7
18159,10/1/19,9280,9087,193,2.1
18161,10/1/19,3564,3462,102,2.9
18163,10/1/19,94682,91955,2727,2.9
18165,10/1/19,6990,6701,289,4.1
18167,10/1/19,48326,46505,1821,3.8
18169,10/1/19,15292,14857,435,2.8
18171,10/1/19,4242,4127,115,2.7
18173,10/1/19,33079,32217,862,2.6
18175,10/1/19,13774,13368,406,2.9
18177,10/1/19,30605,29601,1004,3.3
18179,10/1/19,14722,14342,380,2.6
18181,10/1/19,13572,13252,320,2.4
18183,10/1/19,18221,17611,610,3.3
19001,10/1/19,4302,4231,71,1.7
19003,10/1/19,2186,2153,33,1.5
19005,10/1/19,7539,7375,164,2.2
19007,10/1/19,6078,5872,206,3.4
19009,10/1/19,3149,3081,68,2.2
19011,10/1/19,13834,13507,327,2.4
19013,10/1/19,71156,69087,2069,2.9
19015,10/1/19,15382,15086,296,1.9
19017,10/1/19,14252,13983,269,1.9
19019,10/1/19,11476,11211,265,2.3
19021,10/1/19,12243,12032,211,1.7
19023,10/1/19,8134,7934,200,2.5
19025,10/1/19,4331,4247,84,1.9
19027,10/1/19,11189,11004,185,1.7
19029,10/1/19,6982,6836,146,2.1
19031,10/1/19,11094,10883,211,1.9
19033,10/1/19,24012,23475,537,2.2
19035,10/1/19,6286,6150,136,2.2
19037,10/1/19,6715,6556,159,2.4
19039,10/1/19,4924,4817,107,2.2
19041,10/1/19,8660,8469,191,2.2
19043,10/1/19,10284,10039,245,2.4
19045,10/1/19,23309,22453,856,3.7
19047,10/1/19,8324,8118,206,2.5
19049,10/1/19,51124,50285,839,1.6
19051,10/1/19,4326,4177,149,3.4
19053,10/1/19,4545,4471,74,1.6
19055,10/1/19,10792,10591,201,1.9
19057,10/1/19,19339,18644,695,3.6
19059,10/1/19,10160,9949,211,2.1
19061,10/1/19,57465,56263,1202,2.1
19063,10/1/19,5356,5265,91,1.7
19065,10/1/19,10978,10701,277,2.5
19067,10/1/19,8772,8421,351,4
19069,10/1/19,5756,5660,96,1.7
19071,10/1/19,3794,3719,75,2
19073,10/1/19,5580,5487,93,1.7
19075,10/1/19,6688,6532,156,2.3
19077,10/1/19,5740,5624,116,2
19079,10/1/19,7067,6900,167,2.4
19081,10/1/19,6036,5910,126,2.1
19083,10/1/19,8178,7981,197,2.4
19085,10/1/19,7558,7423,135,1.8
19087,10/1/19,10010,9781,229,2.3
19089,10/1/19,5245,5155,90,1.7
19091,10/1/19,5227,5108,119,2.3
19093,10/1/19,4226,4170,56,1.3
19095,10/1/19,10798,10621,177,1.6
19097,10/1/19,11115,10859,256,2.3
19099,10/1/19,20383,19866,517,2.5
19101,10/1/19,10492,10231,261,2.5
19103,10/1/19,89012,87511,1501,1.7
19105,10/1/19,10905,10662,243,2.2
19107,10/1/19,5331,5175,156,2.9
19109,10/1/19,8509,8354,155,1.8
19111,10/1/19,16625,16050,575,3.5
19113,10/1/19,125550,122263,3287,2.6
19115,10/1/19,6187,6033,154,2.5
19117,10/1/19,4673,4588,85,1.8
19119,10/1/19,7178,7094,84,1.2
19121,10/1/19,8793,8554,239,2.7
19123,10/1/19,12194,11898,296,2.4
19125,10/1/19,18890,18560,330,1.7
19127,10/1/19,18005,17462,543,3
19129,10/1/19,7611,7465,146,1.9
19131,10/1/19,7259,7158,101,1.4
19133,10/1/19,4505,4399,106,2.4
19135,10/1/19,4120,4004,116,2.8
19137,10/1/19,5048,4936,112,2.2
19139,10/1/19,22266,21721,545,2.4
19141,10/1/19,8428,8290,138,1.6
19143,10/1/19,3572,3513,59,1.7
19145,10/1/19,6453,6288,165,2.6
19147,10/1/19,4896,4811,85,1.7
19149,10/1/19,15245,14881,364,2.4
19151,10/1/19,4981,4903,78,1.6
19153,10/1/19,277597,270860,6737,2.4
19155,10/1/19,49973,48998,975,2
19157,10/1/19,10968,10690,278,2.5
19159,10/1/19,2520,2462,58,2.3
19161,10/1/19,5366,5278,88,1.6
19163,10/1/19,91839,88981,2858,3.1
19165,10/1/19,6790,6686,104,1.5
19167,10/1/19,21711,21449,262,1.2
19169,10/1/19,61675,60761,914,1.5
19171,10/1/19,9576,9379,197,2.1
19173,10/1/19,3242,3190,52,1.6
19175,10/1/19,6414,6259,155,2.4
19177,10/1/19,3760,3667,93,2.5
19179,10/1/19,18243,17419,824,4.5
19181,10/1/19,29153,28574,579,2
19183,10/1/19,12342,12112,230,1.9
19185,10/1/19,2862,2803,59,2.1
19187,10/1/19,20014,19545,469,2.3
19189,10/1/19,5252,5138,114,2.2
19191,10/1/19,12643,12420,223,1.8
19193,10/1/19,57050,55710,1340,2.3
19195,10/1/19,4324,4215,109,2.5
19197,10/1/19,7145,6984,161,2.3
20001,10/1/19,6416,6222,194,3
20003,10/1/19,4245,4131,114,2.7
20005,10/1/19,7049,6678,371,5.3
20007,10/1/19,2388,2326,62,2.6
20009,10/1/19,13400,13043,357,2.7
20011,10/1/19,6638,6399,239,3.6
20013,10/1/19,5381,5242,139,2.6
20015,10/1/19,32503,31553,950,2.9
20017,10/1/19,1532,1501,31,2
20019,10/1/19,1466,1416,50,3.4
20021,10/1/19,10171,9859,312,3.1
20023,10/1/19,1376,1345,31,2.3
20025,10/1/19,1120,1097,23,2.1
20027,10/1/19,3875,3774,101,2.6
20029,10/1/19,3842,3728,114,3
20031,10/1/19,4260,4120,140,3.3
20033,10/1/19,885,861,24,2.7
20035,10/1/19,16518,16021,497,3
20037,10/1/19,18663,17996,667,3.6
20039,10/1/19,1247,1214,33,2.6
20041,10/1/19,8936,8679,257,2.9
20043,10/1/19,4173,4055,118,2.8
20045,10/1/19,66705,64958,1747,2.6
20047,10/1/19,1544,1504,40,2.6
20049,10/1/19,1208,1166,42,3.5
20051,10/1/19,17304,16966,338,2
20053,10/1/19,2774,2705,69,2.5
20055,10/1/19,20744,20318,426,2.1
20057,10/1/19,17221,16817,404,2.3
20059,10/1/19,14079,13691,388,2.8
20061,10/1/19,11436,10975,461,4
20063,10/1/19,1533,1505,28,1.8
20065,10/1/19,1152,1119,33,2.9
20067,10/1/19,3328,3250,78,2.3
20069,10/1/19,3438,3377,61,1.8
20071,10/1/19,831,814,17,2
20073,10/1/19,3376,3291,85,2.5
20075,10/1/19,1733,1705,28,1.6
20077,10/1/19,2866,2800,66,2.3
20079,10/1/19,17046,16583,463,2.7
20081,10/1/19,2262,2222,40,1.8
20083,10/1/19,1036,1010,26,2.5
20085,10/1/19,7143,6973,170,2.4
20087,10/1/19,10096,9826,270,2.7
20089,10/1/19,1317,1282,35,2.7
20091,10/1/19,339163,330734,8429,2.5
20093,10/1/19,2126,2077,49,2.3
20095,10/1/19,3506,3405,101,2.9
20097,10/1/19,1347,1319,28,2.1
20099,10/1/19,9924,9596,328,3.3
20101,10/1/19,827,808,19,2.3
20103,10/1/19,36495,35380,1115,3.1
20105,10/1/19,1791,1760,31,1.7
20107,10/1/19,4451,4231,220,4.9
20109,10/1/19,1698,1669,29,1.7
20111,10/1/19,16704,16227,477,2.9
20113,10/1/19,17218,16873,345,2
20115,10/1/19,6099,5940,159,2.6
20117,10/1/19,5563,5436,127,2.3
20119,10/1/19,2189,2147,42,1.9
20121,10/1/19,17481,16980,501,2.9
20123,10/1/19,3327,3259,68,2
20125,10/1/19,14846,14243,603,4.1
20127,10/1/19,3093,3018,75,2.4
20129,10/1/19,1196,1167,29,2.4
20131,10/1/19,5451,5305,146,2.7
20133,10/1/19,6239,5976,263,4.2
20135,10/1/19,1386,1353,33,2.4
20137,10/1/19,2749,2697,52,1.9
20139,10/1/19,7974,7731,243,3
20141,10/1/19,2124,2088,36,1.7
20143,10/1/19,3053,2980,73,2.4
20145,10/1/19,2979,2908,71,2.4
20147,10/1/19,2701,2639,62,2.3
20149,10/1/19,12821,12525,296,2.3
20151,10/1/19,4986,4879,107,2.1
20153,10/1/19,1541,1512,29,1.9
20155,10/1/19,29640,28791,849,2.9
20157,10/1/19,2332,2283,49,2.1
20159,10/1/19,5220,5100,120,2.3
20161,10/1/19,36144,35248,896,2.5
20163,10/1/19,2577,2504,73,2.8
20165,10/1/19,1669,1634,35,2.1
20167,10/1/19,3325,3244,81,2.4
20169,10/1/19,29983,29203,780,2.6
20171,10/1/19,2965,2918,47,1.6
20173,10/1/19,250607,242724,7883,3.1
20175,10/1/19,9468,9189,279,2.9
20177,10/1/19,89847,87148,2699,3
20179,10/1/19,1471,1442,29,2
20181,10/1/19,2880,2800,80,2.8
20183,10/1/19,2046,2004,42,2.1
20185,10/1/19,2127,2080,47,2.2
20187,10/1/19,1041,1015,26,2.5
20189,10/1/19,2646,2582,64,2.4
20191,10/1/19,10950,10635,315,2.9
20193,10/1/19,4412,4325,87,2
20195,10/1/19,1447,1418,29,2
20197,10/1/19,3692,3583,109,3
20199,10/1/19,846,829,17,2
20201,10/1/19,3033,2974,59,1.9
20203,10/1/19,1308,1284,24,1.8
20205,10/1/19,4014,3868,146,3.6
20207,10/1/19,1583,1528,55,3.5
20209,10/1/19,77341,74192,3149,4.1
21001,10/1/19,7101,6774,327,4.6
21003,10/1/19,9125,8781,344,3.8
21005,10/1/19,12276,11825,451,3.7
21007,10/1/19,3503,3347,156,4.5
21009,10/1/19,18710,17957,753,4
21011,10/1/19,4615,4382,233,5
21013,10/1/19,8446,7897,549,6.5
21015,10/1/19,71415,69222,2193,3.1
21017,10/1/19,9860,9524,336,3.4
21019,10/1/19,17850,16968,882,4.9
21021,10/1/19,12469,11909,560,4.5
21023,10/1/19,3811,3663,148,3.9
21025,10/1/19,3399,3153,246,7.2
21027,10/1/19,7862,7505,357,4.5
21029,10/1/19,43085,41526,1559,3.6
21031,10/1/19,5150,4934,216,4.2
21033,10/1/19,5476,5221,255,4.7
21035,10/1/19,18707,18027,680,3.6
21037,10/1/19,51068,49479,1589,3.1
21039,10/1/19,2272,2191,81,3.6
21041,10/1/19,5319,5139,180,3.4
21043,10/1/19,9679,9072,607,6.3
21045,10/1/19,6656,6401,255,3.8
21047,10/1/19,25524,23912,1612,6.3
21049,10/1/19,17362,16761,601,3.5
21051,10/1/19,5184,4843,341,6.6
21053,10/1/19,3972,3780,192,4.8
21055,10/1/19,3786,3635,151,4
21057,10/1/19,3168,3061,107,3.4
21059,10/1/19,47650,46034,1616,3.4
21061,10/1/19,4866,4663,203,4.2
21063,10/1/19,2045,1894,151,7.4
21065,10/1/19,5447,5199,248,4.6
21067,10/1/19,177244,172072,5172,2.9
21069,10/1/19,6080,5796,284,4.7
21071,10/1/19,10972,10325,647,5.9
21073,10/1/19,25657,24767,890,3.5
21075,10/1/19,2047,1952,95,4.6
21077,10/1/19,4100,3957,143,3.5
21079,10/1/19,7716,7385,331,4.3
21081,10/1/19,11752,11343,409,3.5
21083,10/1/19,15940,15296,644,4
21085,10/1/19,11026,10545,481,4.4
21087,10/1/19,5145,4940,205,4
21089,10/1/19,13362,12633,729,5.5
21091,10/1/19,4002,3868,134,3.3
21093,10/1/19,48881,47084,1797,3.7
21095,10/1/19,6634,5922,712,10.7
21097,10/1/19,8901,8567,334,3.8
21099,10/1/19,7810,7484,326,4.2
21101,10/1/19,22096,21332,764,3.5
21103,10/1/19,8260,8002,258,3.1
21105,10/1/19,1739,1667,72,4.1
21107,10/1/19,18504,17732,772,4.2
21109,10/1/19,4149,3913,236,5.7
21111,10/1/19,402532,388402,14130,3.5
21113,10/1/19,26857,25982,875,3.3
21115,10/1/19,6737,6349,388,5.8
21117,10/1/19,88394,85527,2867,3.2
21119,10/1/19,4481,4197,284,6.3
21121,10/1/19,9890,9345,545,5.5
21123,10/1/19,5935,5699,236,4
21125,10/1/19,24591,23467,1124,4.6
21127,10/1/19,5249,4938,311,5.9
21129,10/1/19,2055,1957,98,4.8
21131,10/1/19,2728,2483,245,9
21133,10/1/19,6460,5957,503,7.8
21135,10/1/19,4549,4232,317,7
21137,10/1/19,9216,8814,402,4.4
21139,10/1/19,3654,3490,164,4.5
21141,10/1/19,12576,12090,486,3.9
21143,10/1/19,3033,2903,130,4.3
21145,10/1/19,29306,28054,1252,4.3
21147,10/1/19,4677,4428,249,5.3
21149,10/1/19,4232,4069,163,3.9
21151,10/1/19,48013,46417,1596,3.3
21153,10/1/19,3184,2877,307,9.6
21155,10/1/19,9691,9360,331,3.4
21157,10/1/19,15129,14554,575,3.8
21159,10/1/19,2734,2557,177,6.5
21161,10/1/19,7041,6694,347,4.9
21163,10/1/19,12251,11727,524,4.3
21165,10/1/19,2317,2193,124,5.4
21167,10/1/19,10120,9614,506,5
21169,10/1/19,4086,3893,193,4.7
21171,10/1/19,4730,4564,166,3.5
21173,10/1/19,11739,11215,524,4.5
21175,10/1/19,4574,4369,205,4.5
21177,10/1/19,10393,9808,585,5.6
21179,10/1/19,23216,22329,887,3.8
21181,10/1/19,3317,3182,135,4.1
21183,10/1/19,9778,9359,419,4.3
21185,10/1/19,33524,32563,961,2.9
21187,10/1/19,5178,4989,189,3.7
21189,10/1/19,1135,1059,76,6.7
21191,10/1/19,6990,6768,222,3.2
21193,10/1/19,8287,7803,484,5.8
21195,10/1/19,20056,18961,1095,5.5
21197,10/1/19,5065,4833,232,4.6
21199,10/1/19,26896,25778,1118,4.2
21201,10/1/19,830,793,37,4.5
21203,10/1/19,6773,6491,282,4.2
21205,10/1/19,10488,9984,504,4.8
21207,10/1/19,6184,5861,323,5.2
21209,10/1/19,29532,28596,936,3.2
21211,10/1/19,25690,24895,795,3.1
21213,10/1/19,8948,8522,426,4.8
21215,10/1/19,10271,9951,320,3.1
21217,10/1/19,12939,12461,478,3.7
21219,10/1/19,5511,5273,238,4.3
21221,10/1/19,6081,5794,287,4.7
21223,10/1/19,3896,3749,147,3.8
21225,10/1/19,6146,5888,258,4.2
21227,10/1/19,66142,63753,2389,3.6
21229,10/1/19,6263,6043,220,3.5
21231,10/1/19,7380,7007,373,5.1
21233,10/1/19,5732,5517,215,3.8
21235,10/1/19,13686,13033,653,4.8
21237,10/1/19,1994,1872,122,6.1
21239,10/1/19,15073,14605,468,3.1
22001,10/1/19,24058,22724,1334,5.5
22003,10/1/19,8985,8490,495,5.5
22005,10/1/19,64166,61373,2793,4.4
22007,10/1/19,8973,8406,567,6.3
22009,10/1/19,15197,14280,917,6
22011,10/1/19,14899,14109,790,5.3
22013,10/1/19,5515,5186,329,6
22015,10/1/19,57800,55174,2626,4.5
22017,10/1/19,103777,97922,5855,5.6
22019,10/1/19,106004,101501,4503,4.2
22021,10/1/19,3754,3509,245,6.5
22023,10/1/19,3934,3779,155,3.9
22025,10/1/19,3445,3231,214,6.2
22027,10/1/19,5868,5496,372,6.3
22029,10/1/19,7157,6724,433,6.1
22031,10/1/19,10917,10214,703,6.4
22033,10/1/19,231314,220520,10794,4.7
22035,10/1/19,1894,1706,188,9.9
22037,10/1/19,7994,7611,383,4.8
22039,10/1/19,11892,11170,722,6.1
22041,10/1/19,7415,6882,533,7.2
22043,10/1/19,8184,7729,455,5.6
22045,10/1/19,28316,26723,1593,5.6
22047,10/1/19,14116,13230,886,6.3
22049,10/1/19,6863,6523,340,5
22051,10/1/19,215208,205827,9381,4.4
22053,10/1/19,13380,12727,653,4.9
22055,10/1/19,114464,109266,5198,4.5
22057,10/1/19,42505,40545,1960,4.6
22059,10/1/19,6773,6478,295,4.4
22061,10/1/19,22529,21298,1231,5.5
22063,10/1/19,68866,65964,2902,4.2
22065,10/1/19,3517,3238,279,7.9
22067,10/1/19,10036,9207,829,8.3
22069,10/1/19,16599,15611,988,6
22071,10/1/19,180122,170950,9172,5.1
22073,10/1/19,70185,66256,3929,5.6
22075,10/1/19,10137,9682,455,4.5
22077,10/1/19,9895,9354,541,5.5
22079,10/1/19,55396,52513,2883,5.2
22081,10/1/19,3789,3580,209,5.5
22083,10/1/19,8218,7684,534,6.5
22085,10/1/19,9239,8748,491,5.3
22087,10/1/19,19997,18975,1022,5.1
22089,10/1/19,25306,24175,1131,4.5
22091,10/1/19,4277,4017,260,6.1
22093,10/1/19,9311,8728,583,6.3
22095,10/1/19,19850,18647,1203,6.1
22097,10/1/19,32088,29993,2095,6.5
22099,10/1/19,22374,21198,1176,5.3
22101,10/1/19,20038,18790,1248,6.2
22103,10/1/19,120101,114874,5227,4.4
22105,10/1/19,55250,52154,3096,5.6
22107,10/1/19,1420,1306,114,8
22109,10/1/19,46881,44631,2250,4.8
22111,10/1/19,9110,8570,540,5.9
22113,10/1/19,24236,22984,1252,5.2
22115,10/1/19,16010,15005,1005,6.3
22117,10/1/19,16760,15751,1009,6
22119,10/1/19,14557,13621,936,6.4
22121,10/1/19,13673,13040,633,4.6
22123,10/1/19,3614,3266,348,9.6
22125,10/1/19,5403,5165,238,4.4
22127,10/1/19,4895,4574,321,6.6
23001,10/1/19,55932,54545,1387,2.5
23003,10/1/19,29811,28759,1052,3.5
23005,10/1/19,166694,163228,3466,2.1
23007,10/1/19,14134,13699,435,3.1
23009,10/1/19,29484,28856,628,2.1
23011,10/1/19,61892,60410,1482,2.4
23013,10/1/19,19831,19401,430,2.2
23015,10/1/19,16741,16383,358,2.1
23017,10/1/19,25958,25221,737,2.8
23019,10/1/19,78131,76117,2014,2.6
23021,10/1/19,7237,7028,209,2.9
23023,10/1/19,19511,19146,365,1.9
23025,10/1/19,22085,21313,772,3.5
23027,10/1/19,20532,20033,499,2.4
23029,10/1/19,13346,12904,442,3.3
23031,10/1/19,114605,112140,2465,2.2
24001,10/1/19,32660,31089,1571,4.8
24003,10/1/19,319286,310232,9054,2.8
24005,10/1/19,459669,443776,15893,3.5
24009,10/1/19,50928,49502,1426,2.8
24011,10/1/19,18094,17533,561,3.1
24013,10/1/19,96598,94075,2523,2.6
24015,10/1/19,53501,51608,1893,3.5
24017,10/1/19,88877,85912,2965,3.3
24019,10/1/19,15539,14871,668,4.3
24021,10/1/19,136390,132377,4013,2.9
24023,10/1/19,15410,14821,589,3.8
24025,10/1/19,142566,138143,4423,3.1
24027,10/1/19,190141,185307,4834,2.5
24029,10/1/19,9892,9558,334,3.4
24031,10/1/19,570834,555249,15585,2.7
24033,10/1/19,519108,500742,18366,3.5
24035,10/1/19,28018,27250,768,2.7
24037,10/1/19,57687,55991,1696,2.9
24039,10/1/19,9029,8541,488,5.4
24041,10/1/19,19568,19021,547,2.8
24043,10/1/19,76008,73374,2634,3.5
24045,10/1/19,51174,49089,2085,4.1
24047,10/1/19,25140,23783,1357,5.4
24510,10/1/19,291957,277812,14145,4.8
25001,10/1/19,113834,110928,2906,2.6
25003,10/1/19,64223,62524,1699,2.6
25005,10/1/19,303400,294432,8968,3
25007,10/1/19,9258,9036,222,2.4
25009,10/1/19,430349,419800,10549,2.5
25011,10/1/19,41324,40457,867,2.1
25013,10/1/19,230695,223118,7577,3.3
25015,10/1/19,91401,89422,1979,2.2
25017,10/1/19,931248,913350,17898,1.9
25019,10/1/19,7566,7426,140,1.9
25021,10/1/19,396947,388473,8474,2.1
25023,10/1/19,286911,279862,7049,2.5
25025,10/1/19,462896,452607,10289,2.2
25027,10/1/19,449916,438492,11424,2.5
26001,10/1/19,3820,3652,168,4.4
26003,10/1/19,3179,3030,149,4.7
26005,10/1/19,61913,60502,1411,2.3
26007,10/1/19,13236,12826,410,3.1
26009,10/1/19,10110,9768,342,3.4
26011,10/1/19,5970,5679,291,4.9
26013,10/1/19,3176,3044,132,4.2
26015,10/1/19,31347,30590,757,2.4
26017,10/1/19,49540,47645,1895,3.8
26019,10/1/19,8763,8482,281,3.2
26021,10/1/19,72591,70460,2131,2.9
26023,10/1/19,19233,18516,717,3.7
26025,10/1/19,61970,59925,2045,3.3
26027,10/1/19,24232,23399,833,3.4
26029,10/1/19,12576,12183,393,3.1
26031,10/1/19,10370,10041,329,3.2
26033,10/1/19,15871,15304,567,3.6
26035,10/1/19,11551,11053,498,4.3
26037,10/1/19,41529,40430,1099,2.6
26039,10/1/19,5537,5322,215,3.9
26041,10/1/19,17083,16489,594,3.5
26043,10/1/19,12167,11794,373,3.1
26045,10/1/19,58050,55929,2121,3.7
26047,10/1/19,17384,16847,537,3.1
26049,10/1/19,183174,174906,8268,4.5
26051,10/1/19,9787,9375,412,4.2
26053,10/1/19,5913,5692,221,3.7
26055,10/1/19,49562,48348,1214,2.4
26057,10/1/19,18044,17418,626,3.5
26059,10/1/19,20269,19380,889,4.4
26061,10/1/19,16635,16084,551,3.3
26063,10/1/19,15394,14978,416,2.7
26065,10/1/19,152921,147622,5299,3.5
26067,10/1/19,30296,29461,835,2.8
26069,10/1/19,10173,9745,428,4.2
26071,10/1/19,5092,4887,205,4
26073,10/1/19,34601,33596,1005,2.9
26075,10/1/19,73197,70947,2250,3.1
26077,10/1/19,133751,130000,3751,2.8
26079,10/1/19,7821,7528,293,3.7
26081,10/1/19,356789,348499,8290,2.3
26083,10/1/19,894,860,34,3.8
26085,10/1/19,3831,3666,165,4.3
26087,10/1/19,41632,39765,1867,4.5
26089,10/1/19,10453,10215,238,2.3
26091,10/1/19,46371,44388,1983,4.3
26093,10/1/19,105143,101938,3205,3
26095,10/1/19,2259,2171,88,3.9
26097,10/1/19,5322,5186,136,2.6
26099,10/1/19,454616,436744,17872,3.9
26101,10/1/19,10439,10072,367,3.5
26103,10/1/19,32757,31738,1019,3.1
26105,10/1/19,13613,13133,480,3.5
26107,10/1/19,18496,17865,631,3.4
26109,10/1/19,10874,10574,300,2.8
26111,10/1/19,39639,38476,1163,2.9
26113,10/1/19,6897,6674,223,3.2
26115,10/1/19,74841,72773,2068,2.8
26117,10/1/19,27952,27153,799,2.9
26119,10/1/19,2955,2779,176,6
26121,10/1/19,76240,73628,2612,3.4
26123,10/1/19,23210,22494,716,3.1
26125,10/1/19,686281,664327,21954,3.2
26127,10/1/19,11995,11545,450,3.8
26129,10/1/19,7977,7624,353,4.4
26131,10/1/19,2080,1995,85,4.1
26133,10/1/19,11199,10894,305,2.7
26135,10/1/19,3090,2904,186,6
26137,10/1/19,11479,11076,403,3.5
26139,10/1/19,159874,156372,3502,2.2
26141,10/1/19,4847,4632,215,4.4
26143,10/1/19,7637,7267,370,4.8
26145,10/1/19,85380,81547,3833,4.5
26147,10/1/19,76769,73396,3373,4.4
26149,10/1/19,27451,26251,1200,4.4
26151,10/1/19,19265,18614,651,3.4
26153,10/1/19,3260,3122,138,4.2
26155,10/1/19,33267,32098,1169,3.5
26157,10/1/19,23524,22607,917,3.9
26159,10/1/19,35001,33880,1121,3.2
26161,10/1/19,199449,194751,4698,2.4
26163,10/1/19,815755,777018,38737,4.7
26165,10/1/19,14662,14176,486,3.3
27001,10/1/19,7247,6958,289,4
27003,10/1/19,199743,194520,5223,2.6
27005,10/1/19,18840,18375,465,2.5
27007,10/1/19,24683,23911,772,3.1
27009,10/1/19,22316,21690,626,2.8
27011,10/1/19,2582,2530,52,2
27013,10/1/19,42154,41253,901,2.1
27015,10/1/19,14605,14243,362,2.5
27017,10/1/19,17947,17324,623,3.5
27019,10/1/19,59467,58014,1453,2.4
27021,10/1/19,14375,13856,519,3.6
27023,10/1/19,7100,6895,205,2.9
27025,10/1/19,30173,29360,813,2.7
27027,10/1/19,36710,35956,754,2.1
27029,10/1/19,4512,4291,221,4.9
27031,10/1/19,3153,3065,88,2.8
27033,10/1/19,6032,5856,176,2.9
27035,10/1/19,32187,31216,971,3
27037,10/1/19,244419,238243,6176,2.5
27039,10/1/19,12122,11828,294,2.4
27041,10/1/19,20979,20516,463,2.2
27043,10/1/19,7344,7134,210,2.9
27045,10/1/19,11903,11643,260,2.2
27047,10/1/19,16476,16056,420,2.5
27049,10/1/19,27512,26909,603,2.2
27051,10/1/19,3403,3299,104,3.1
27053,10/1/19,715461,696920,18541,2.6
27055,10/1/19,10583,10341,242,2.3
27057,10/1/19,9968,9598,370,3.7
27059,10/1/19,21434,20804,630,2.9
27061,10/1/19,21753,20840,913,4.2
27063,10/1/19,5874,5752,122,2.1
27065,10/1/19,9070,8761,309,3.4
27067,10/1/19,24668,24106,562,2.3
27069,10/1/19,2471,2410,61,2.5
27071,10/1/19,5942,5581,361,6.1
27073,10/1/19,3731,3639,92,2.5
27075,10/1/19,5504,5353,151,2.7
27077,10/1/19,2465,2377,88,3.6
27079,10/1/19,16235,15810,425,2.6
27081,10/1/19,3428,3344,84,2.5
27083,10/1/19,14865,14547,318,2.1
27085,10/1/19,19372,18853,519,2.7
27087,10/1/19,2294,2215,79,3.4
27089,10/1/19,5574,5407,167,3
27091,10/1/19,10212,9928,284,2.8
27093,10/1/19,13513,13183,330,2.4
27095,10/1/19,12917,12476,441,3.4
27097,10/1/19,17703,17145,558,3.2
27099,10/1/19,20567,20057,510,2.5
27101,10/1/19,4971,4849,122,2.5
27103,10/1/19,21800,21385,415,1.9
27105,10/1/19,11627,11291,336,2.9
27107,10/1/19,3333,3250,83,2.5
27109,10/1/19,89674,87810,1864,2.1
27111,10/1/19,31636,30780,856,2.7
27113,10/1/19,8700,8456,244,2.8
27115,10/1/19,15170,14625,545,3.6
27117,10/1/19,5068,4960,108,2.1
27119,10/1/19,16965,16531,434,2.6
27121,10/1/19,6719,6581,138,2.1
27123,10/1/19,293270,285165,8105,2.8
27125,10/1/19,2253,2169,84,3.7
27127,10/1/19,7826,7625,201,2.6
27129,10/1/19,9212,8957,255,2.8
27131,10/1/19,37361,36516,845,2.3
27133,10/1/19,5803,5692,111,1.9
27135,10/1/19,7875,7672,203,2.6
27137,10/1/19,102575,99264,3311,3.2
27139,10/1/19,84496,82499,1997,2.4
27141,10/1/19,52817,51448,1369,2.6
27143,10/1/19,8850,8620,230,2.6
27145,10/1/19,92251,90108,2143,2.3
27147,10/1/19,21494,20959,535,2.5
27149,10/1/19,5623,5521,102,1.8
27151,10/1/19,5077,4924,153,3
27153,10/1/19,13830,13450,380,2.7
27155,10/1/19,1812,1771,41,2.3
27157,10/1/19,12669,12369,300,2.4
27159,10/1/19,5937,5723,214,3.6
27161,10/1/19,9294,9016,278,3
27163,10/1/19,145056,141507,3549,2.4
27165,10/1/19,6617,6416,201,3
27167,10/1/19,3657,3574,83,2.3
27169,10/1/19,29041,28366,675,2.3
27171,10/1/19,76431,74531,1900,2.5
27173,10/1/19,5573,5422,151,2.7
28001,10/1/19,11332,10591,741,6.5
28003,10/1/19,15812,15098,714,4.5
28005,10/1/19,4322,4023,299,6.9
28007,10/1/19,6978,6586,392,5.6
28009,10/1/19,3070,2884,186,6.1
28011,10/1/19,11968,11183,785,6.6
28013,10/1/19,5528,5226,302,5.5
28015,10/1/19,3453,3243,210,6.1
28017,10/1/19,6867,6471,396,5.8
28019,10/1/19,3713,3496,217,5.8
28021,10/1/19,3018,2705,313,10.4
28023,10/1/19,5825,5473,352,6
28025,10/1/19,7723,7145,578,7.5
28027,10/1/19,8197,7628,569,6.9
28029,10/1/19,11218,10527,691,6.2
28031,10/1/19,8164,7794,370,4.5
28033,10/1/19,91869,88031,3838,4.2
28035,10/1/19,33596,32019,1577,4.7
28037,10/1/19,2753,2569,184,6.7
28039,10/1/19,8694,8100,594,6.8
28041,10/1/19,4277,3985,292,6.8
28043,10/1/19,9319,8856,463,5
28045,10/1/19,18809,17838,971,5.2
28047,10/1/19,86725,82425,4300,5
28049,10/1/19,107842,102566,5276,4.9
28051,10/1/19,5652,5123,529,9.4
28053,10/1/19,2141,1938,203,9.5
28055,10/1/19,372,338,34,9.1
28057,10/1/19,10501,10034,467,4.4
28059,10/1/19,58529,55297,3232,5.5
28061,10/1/19,6094,5707,387,6.4
28063,10/1/19,1970,1705,265,13.5
28065,10/1/19,4106,3858,248,6
28067,10/1/19,26042,24723,1319,5.1
28069,10/1/19,3456,3185,271,7.8
28071,10/1/19,29699,28513,1186,4
28073,10/1/19,31083,29883,1200,3.9
28075,10/1/19,30094,28513,1581,5.3
28077,10/1/19,4568,4285,283,6.2
28079,10/1/19,7805,7384,421,5.4
28081,10/1/19,41373,39596,1777,4.3
28083,10/1/19,9943,9255,688,6.9
28085,10/1/19,14613,13784,829,5.7
28087,10/1/19,25758,24487,1271,4.9
28089,10/1/19,53720,51533,2187,4.1
28091,10/1/19,9887,9394,493,5
28093,10/1/19,14580,13760,820,5.6
28095,10/1/19,15652,14798,854,5.5
28097,10/1/19,3883,3653,230,5.9
28099,10/1/19,9990,9414,576,5.8
28101,10/1/19,8860,8400,460,5.2
28103,10/1/19,3716,3445,271,7.3
28105,10/1/19,23230,22005,1225,5.3
28107,10/1/19,12482,11722,760,6.1
28109,10/1/19,23848,22681,1167,4.9
28111,10/1/19,4300,4045,255,5.9
28113,10/1/19,14324,13426,898,6.3
28115,10/1/19,14799,14184,615,4.2
28117,10/1/19,11273,10759,514,4.6
28119,10/1/19,2290,2113,177,7.7
28121,10/1/19,76830,73962,2868,3.7
28123,10/1/19,12529,11995,534,4.3
28125,10/1/19,1566,1453,113,7.2
28127,10/1/19,10758,10259,499,4.6
28129,10/1/19,6697,6368,329,4.9
28131,10/1/19,6892,6478,414,6
28133,10/1/19,7505,6883,622,8.3
28135,10/1/19,5092,4832,260,5.1
28137,10/1/19,12383,11718,665,5.4
28139,10/1/19,9405,8963,442,4.7
28141,10/1/19,8439,8025,414,4.9
28143,10/1/19,4398,4154,244,5.5
28145,10/1/19,14362,13773,589,4.1
28147,10/1/19,4840,4497,343,7.1
28149,10/1/19,20285,19157,1128,5.6
28151,10/1/19,16795,15642,1153,6.9
28153,10/1/19,7311,6890,421,5.8
28155,10/1/19,4045,3789,256,6.3
28157,10/1/19,2801,2536,265,9.5
28159,10/1/19,7368,6960,408,5.5
28161,10/1/19,5031,4782,249,4.9
28163,10/1/19,9373,8807,566,6
29001,10/1/19,10442,10162,280,2.7
29003,10/1/19,9843,9629,214,2.2
29005,10/1/19,2784,2712,72,2.6
29007,10/1/19,10759,10476,283,2.6
29009,10/1/19,15719,15255,464,3
29011,10/1/19,5301,5167,134,2.5
29013,10/1/19,7989,7758,231,2.9
29015,10/1/19,7251,6992,259,3.6
29017,10/1/19,5549,5380,169,3
29019,10/1/19,99703,97819,1884,1.9
29021,10/1/19,44832,43685,1147,2.6
29023,10/1/19,17978,17377,601,3.3
29025,10/1/19,4436,4332,104,2.3
29027,10/1/19,21366,20893,473,2.2
29029,10/1/19,18600,17926,674,3.6
29031,10/1/19,41182,40133,1049,2.5
29033,10/1/19,4842,4699,143,3
29035,10/1/19,2557,2462,95,3.7
29037,10/1/19,55186,53887,1299,2.4
29039,10/1/19,5878,5700,178,3
29041,10/1/19,3829,3746,83,2.2
29043,10/1/19,45199,44201,998,2.2
29045,10/1/19,3250,3173,77,2.4
29047,10/1/19,137455,134032,3423,2.5
29049,10/1/19,10811,10573,238,2.2
29051,10/1/19,38999,38212,787,2
29053,10/1/19,7598,7402,196,2.6
29055,10/1/19,11003,10662,341,3.1
29057,10/1/19,3627,3532,95,2.6
29059,10/1/19,7197,6880,317,4.4
29061,10/1/19,4248,4139,109,2.6
29063,10/1/19,4890,4777,113,2.3
29065,10/1/19,6376,6174,202,3.2
29067,10/1/19,5104,4897,207,4.1
29069,10/1/19,11593,11123,470,4.1
29071,10/1/19,53758,52058,1700,3.2
29073,10/1/19,8083,7650,433,5.4
29075,10/1/19,3576,3492,84,2.3
29077,10/1/19,152127,148696,3431,2.3
29079,10/1/19,4477,4367,110,2.5
29081,10/1/19,3883,3777,106,2.7
29083,10/1/19,9757,9469,288,3
29085,10/1/19,3946,3809,137,3.5
29087,10/1/19,2635,2582,53,2
29089,10/1/19,4940,4824,116,2.3
29091,10/1/19,16802,16137,665,4
29093,10/1/19,3491,3373,118,3.4
29095,10/1/19,365288,353499,11789,3.2
29097,10/1/19,57637,56136,1501,2.6
29099,10/1/19,118536,115560,2976,2.5
29101,10/1/19,23572,22785,787,3.3
29103,10/1/19,1823,1787,36,2
29105,10/1/19,17909,16227,1682,9.4
29107,10/1/19,17009,16590,419,2.5
29109,10/1/19,18274,17766,508,2.8
29111,10/1/19,5088,4957,131,2.6
29113,10/1/19,28737,27814,923,3.2
29115,10/1/19,5238,5050,188,3.6
29117,10/1/19,7432,7268,164,2.2
29119,10/1/19,10867,10573,294,2.7
29121,10/1/19,7609,7425,184,2.4
29123,10/1/19,5504,5361,143,2.6
29125,10/1/19,3936,3824,112,2.8
29127,10/1/19,14670,14292,378,2.6
29129,10/1/19,1964,1926,38,1.9
29131,10/1/19,12445,12043,402,3.2
29133,10/1/19,5867,5685,182,3.1
29135,10/1/19,7366,7205,161,2.2
29137,10/1/19,3959,3828,131,3.3
29139,10/1/19,5900,5712,188,3.2
29141,10/1/19,8215,7917,298,3.6
29143,10/1/19,8353,8068,285,3.4
29145,10/1/19,27588,26836,752,2.7
29147,10/1/19,11109,10874,235,2.1
29149,10/1/19,4087,3947,140,3.4
29151,10/1/19,7173,7030,143,2
29153,10/1/19,3443,3283,160,4.6
29155,10/1/19,6374,6125,249,3.9
29157,10/1/19,10050,9842,208,2.1
29159,10/1/19,21168,20597,571,2.7
29161,10/1/19,19864,19335,529,2.7
29163,10/1/19,7528,7297,231,3.1
29165,10/1/19,59202,57823,1379,2.3
29167,10/1/19,14799,14339,460,3.1
29169,10/1/19,14708,14168,540,3.7
29171,10/1/19,2331,2266,65,2.8
29173,10/1/19,5715,5579,136,2.4
29175,10/1/19,10475,10155,320,3.1
29177,10/1/19,11089,10768,321,2.9
29179,10/1/19,3056,2961,95,3.1
29181,10/1/19,5069,4881,188,3.7
29183,10/1/19,228399,223263,5136,2.2
29185,10/1/19,3796,3656,140,3.7
29186,10/1/19,9243,9053,190,2.1
29187,10/1/19,26571,25777,794,3
29189,10/1/19,535475,521425,14050,2.6
29195,10/1/19,10711,10458,253,2.4
29197,10/1/19,2012,1932,80,4
29199,10/1/19,2479,2417,62,2.5
29201,10/1/19,20146,19540,606,3
29203,10/1/19,3306,3163,143,4.3
29205,10/1/19,3141,3081,60,1.9
29207,10/1/19,13284,12784,500,3.8
29209,10/1/19,13910,13477,433,3.1
29211,10/1/19,2724,2641,83,3
29213,10/1/19,27082,26247,835,3.1
29215,10/1/19,9242,8904,338,3.7
29217,10/1/19,9596,9329,267,2.8
29219,10/1/19,18136,17648,488,2.7
29221,10/1/19,10247,9899,348,3.4
29223,10/1/19,5284,5096,188,3.6
29225,10/1/19,17511,16952,559,3.2
29227,10/1/19,1211,1188,23,1.9
29229,10/1/19,7760,7353,407,5.2
29510,10/1/19,153435,148387,5048,3.3
30001,10/1/19,5105,4974,131,2.6
30003,10/1/19,4849,4541,308,6.4
30005,10/1/19,2561,2481,80,3.1
30007,10/1/19,2581,2494,87,3.4
30009,10/1/19,5511,5348,163,3
30011,10/1/19,689,672,17,2.5
30013,10/1/19,37962,36765,1197,3.2
30015,10/1/19,2540,2472,68,2.7
30017,10/1/19,6115,5961,154,2.5
30019,10/1/19,910,893,17,1.9
30021,10/1/19,4580,4468,112,2.4
30023,10/1/19,4965,4830,135,2.7
30025,10/1/19,1730,1695,35,2
30027,10/1/19,6111,5963,148,2.4
30029,10/1/19,47428,45495,1933,4.1
30031,10/1/19,69254,67586,1668,2.4
30033,10/1/19,768,752,16,2.1
30035,10/1/19,5586,5198,388,6.9
30037,10/1/19,375,362,13,3.5
30039,10/1/19,1618,1544,74,4.6
30041,10/1/19,7729,7447,282,3.6
30043,10/1/19,5681,5504,177,3.1
30045,10/1/19,1038,1010,28,2.7
30047,10/1/19,13273,12758,515,3.9
30049,10/1/19,35525,34562,963,2.7
30051,10/1/19,1000,974,26,2.6
30053,10/1/19,8172,7667,505,6.2
30055,10/1/19,998,976,22,2.2
30057,10/1/19,4209,4064,145,3.4
30059,10/1/19,951,923,28,2.9
30061,10/1/19,1747,1666,81,4.6
30063,10/1/19,64444,62603,1841,2.9
30065,10/1/19,2282,2205,77,3.4
30067,10/1/19,9020,8768,252,2.8
30069,10/1/19,292,283,9,3.1
30071,10/1/19,1948,1890,58,3
30073,10/1/19,2705,2625,80,3
30075,10/1/19,1007,985,22,2.2
30077,10/1/19,3040,2940,100,3.3
30079,10/1/19,490,471,19,3.9
30081,10/1/19,20449,19774,675,3.3
30083,10/1/19,6015,5854,161,2.7
30085,10/1/19,4508,4345,163,3.6
30087,10/1/19,3904,3725,179,4.6
30089,10/1/19,4888,4670,218,4.5
30091,10/1/19,1768,1729,39,2.2
30093,10/1/19,17123,16522,601,3.5
30095,10/1/19,5353,5213,140,2.6
30097,10/1/19,1863,1814,49,2.6
30099,10/1/19,2801,2718,83,3
30101,10/1/19,2142,2082,60,2.8
30103,10/1/19,346,339,7,2
30105,10/1/19,4151,4017,134,3.2
30107,10/1/19,820,795,25,3
30109,10/1/19,478,463,15,3.1
30111,10/1/19,81675,79293,2382,2.9
31001,10/1/19,16884,16407,477,2.8
31003,10/1/19,3506,3421,85,2.4
31005,10/1/19,215,204,11,5.1
31007,10/1/19,382,367,15,3.9
31009,10/1/19,251,240,11,4.4
31011,10/1/19,2901,2829,72,2.5
31013,10/1/19,5455,5294,161,3
31015,10/1/19,1059,1030,29,2.7
31017,10/1/19,1358,1317,41,3
31019,10/1/19,27902,27211,691,2.5
31021,10/1/19,3422,3323,99,2.9
31023,10/1/19,4554,4445,109,2.4
31025,10/1/19,13637,13246,391,2.9
31027,10/1/19,4437,4330,107,2.4
31029,10/1/19,2230,2178,52,2.3
31031,10/1/19,3310,3232,78,2.4
31033,10/1/19,4319,4169,150,3.5
31035,10/1/19,3250,3159,91,2.8
31037,10/1/19,5536,5391,145,2.6
31039,10/1/19,4599,4478,121,2.6
31041,10/1/19,6273,6125,148,2.4
31043,10/1/19,10786,10447,339,3.1
31045,10/1/19,4990,4860,130,2.6
31047,10/1/19,12943,12612,331,2.6
31049,10/1/19,945,914,31,3.3
31051,10/1/19,3010,2930,80,2.7
31053,10/1/19,19537,19021,516,2.6
31055,10/1/19,302491,293822,8669,2.9
31057,10/1/19,1154,1123,31,2.7
31059,10/1/19,3096,3021,75,2.4
31061,10/1/19,1418,1371,47,3.3
31063,10/1/19,1593,1547,46,2.9
31065,10/1/19,2535,2468,67,2.6
31067,10/1/19,11153,10557,596,5.3
31069,10/1/19,1046,1015,31,3
31071,10/1/19,1163,1134,29,2.5
31073,10/1/19,1085,1057,28,2.6
31075,10/1/19,422,411,11,2.6
31077,10/1/19,1189,1152,37,3.1
31079,10/1/19,32019,30693,1326,4.1
31081,10/1/19,4754,4575,179,3.8
31083,10/1/19,1758,1709,49,2.8
31085,10/1/19,621,606,15,2.4
31087,10/1/19,1244,1207,37,3
31089,10/1/19,5611,5477,134,2.4
31091,10/1/19,392,381,11,2.8
31093,10/1/19,3393,3220,173,5.1
31095,10/1/19,4120,3996,124,3
31097,10/1/19,2038,1963,75,3.7
31099,10/1/19,3800,3714,86,2.3
31101,10/1/19,4478,4331,147,3.3
31103,10/1/19,576,561,15,2.6
31105,10/1/19,1997,1940,57,2.9
31107,10/1/19,4497,4383,114,2.5
31109,10/1/19,178518,173978,4540,2.5
31111,10/1/19,18236,17653,583,3.2
31113,10/1/19,467,451,16,3.4
31115,10/1/19,399,384,15,3.8
31117,10/1/19,442,432,10,2.3
31119,10/1/19,19896,19409,487,2.4
31121,10/1/19,4009,3848,161,4
31123,10/1/19,2572,2504,68,2.6
31125,10/1/19,1937,1885,52,2.7
31127,10/1/19,3589,3480,109,3
31129,10/1/19,2356,2297,59,2.5
31131,10/1/19,8457,8231,226,2.7
31133,10/1/19,1455,1409,46,3.2
31135,10/1/19,1786,1747,39,2.2
31137,10/1/19,4915,4791,124,2.5
31139,10/1/19,4078,3980,98,2.4
31141,10/1/19,17737,17274,463,2.6
31143,10/1/19,2903,2825,78,2.7
31145,10/1/19,5794,5643,151,2.6
31147,10/1/19,4177,4058,119,2.8
31149,10/1/19,861,838,23,2.7
31151,10/1/19,7296,7086,210,2.9
31153,10/1/19,97787,95180,2607,2.7
31155,10/1/19,11188,10900,288,2.6
31157,10/1/19,18378,17813,565,3.1
31159,10/1/19,8902,8667,235,2.6
31161,10/1/19,2625,2555,70,2.7
31163,10/1/19,1659,1607,52,3.1
31165,10/1/19,728,708,20,2.7
31167,10/1/19,3496,3416,80,2.3
31169,10/1/19,2701,2634,67,2.5
31171,10/1/19,406,395,11,2.7
31173,10/1/19,3056,2949,107,3.5
31175,10/1/19,2078,2019,59,2.8
31177,10/1/19,11366,11073,293,2.6
31179,10/1/19,5833,5703,130,2.2
31181,10/1/19,1651,1597,54,3.3
31183,10/1/19,539,526,13,2.4
31185,10/1/19,7245,7066,179,2.5
32001,10/1/19,11459,11120,339,3
32003,10/1/19,1138969,1096041,42928,3.8
32005,10/1/19,23448,22664,784,3.3
32007,10/1/19,27272,26571,701,2.6
32009,10/1/19,481,463,18,3.7
32011,10/1/19,1202,1178,24,2
32013,10/1/19,8595,8368,227,2.6
32015,10/1/19,3256,3164,92,2.8
32017,10/1/19,2228,2155,73,3.3
32019,10/1/19,23523,22588,935,4
32021,10/1/19,2010,1942,68,3.4
32023,10/1/19,17701,16878,823,4.6
32027,10/1/19,2674,2585,89,3.3
32029,10/1/19,2057,1997,60,2.9
32031,10/1/19,259121,251824,7297,2.8
32033,10/1/19,4757,4639,118,2.5
32510,10/1/19,26409,25535,874,3.3
33001,10/1/19,31343,30654,689,2.2
33003,10/1/19,23669,23162,507,2.1
33005,10/1/19,41208,40284,924,2.2
33007,10/1/19,14634,14293,341,2.3
33009,10/1/19,50041,49104,937,1.9
33011,10/1/19,242384,236889,5495,2.3
33013,10/1/19,83686,82041,1645,2
33015,10/1/19,188260,183805,4455,2.4
33017,10/1/19,75123,73600,1523,2
33019,10/1/19,23019,22546,473,2.1
34001,10/1/19,121075,115257,5818,4.8
34003,10/1/19,488407,474455,13952,2.9
34005,10/1/19,233313,225930,7383,3.2
34007,10/1/19,255811,245660,10151,4
34009,10/1/19,43924,41467,2457,5.6
34011,10/1/19,66107,62778,3329,5
34013,10/1/19,371963,355526,16437,4.4
34015,10/1/19,151306,145947,5359,3.5
34017,10/1/19,365671,353803,11868,3.2
34019,10/1/19,65263,63560,1703,2.6
34021,10/1/19,205097,198796,6301,3.1
34023,10/1/19,441376,428103,13273,3
34025,10/1/19,331346,321362,9984,3
34027,10/1/19,258824,251826,6998,2.7
34029,10/1/19,276991,267437,9554,3.4
34031,10/1/19,244639,234725,9914,4.1
34033,10/1/19,29551,28174,1377,4.7
34035,10/1/19,172740,167699,5041,2.9
34037,10/1/19,74631,72276,2355,3.2
34039,10/1/19,278298,268319,9979,3.6
34041,10/1/19,57018,55290,1728,3
35001,10/1/19,337070,322518,14552,4.3
35003,10/1/19,1154,1083,71,6.2
35005,10/1/19,27231,25872,1359,5
35006,10/1/19,9014,8460,554,6.1
35007,10/1/19,5167,4928,239,4.6
35009,10/1/19,21732,20815,917,4.2
35011,10/1/19,789,757,32,4.1
35013,10/1/19,98847,93796,5051,5.1
35015,10/1/19,35463,34357,1106,3.1
35017,10/1/19,12512,11946,566,4.5
35019,10/1/19,1543,1470,73,4.7
35021,10/1/19,272,259,13,4.8
35023,10/1/19,2094,2001,93,4.4
35025,10/1/19,32362,31074,1288,4
35027,10/1/19,8855,8456,399,4.5
35028,10/1/19,9371,9077,294,3.1
35029,10/1/19,10160,9315,845,8.3
35031,10/1/19,24104,22495,1609,6.7
35033,10/1/19,2207,2089,118,5.3
35035,10/1/19,24840,23663,1177,4.7
35037,10/1/19,3225,3068,157,4.9
35039,10/1/19,16792,15950,842,5
35041,10/1/19,8041,7680,361,4.5
35043,10/1/19,67101,63958,3143,4.7
35045,10/1/19,52844,49965,2879,5.4
35047,10/1/19,11069,10452,617,5.6
35049,10/1/19,75279,72478,2801,3.7
35051,10/1/19,3966,3743,223,5.6
35053,10/1/19,6462,6085,377,5.8
35055,10/1/19,14968,14105,863,5.8
35057,10/1/19,6127,5757,370,6
35059,10/1/19,1819,1758,61,3.4
35061,10/1/19,30950,29323,1627,5.3
36001,10/1/19,158948,153371,5577,3.5
36003,10/1/19,19876,18963,913,4.6
36005,10/1/19,597792,567740,30052,5
36007,10/1/19,83697,80098,3599,4.3
36009,10/1/19,33969,32471,1498,4.4
36011,10/1/19,35726,34384,1342,3.8
36013,10/1/19,54067,51776,2291,4.2
36015,10/1/19,35222,33820,1402,4
36017,10/1/19,21926,21098,828,3.8
36019,10/1/19,36436,35021,1415,3.9
36021,10/1/19,31096,30196,900,2.9
36023,10/1/19,22988,22057,931,4
36025,10/1/19,19062,18283,779,4.1
36027,10/1/19,144971,139859,5112,3.5
36029,10/1/19,444019,426336,17683,4
36031,10/1/19,16448,15814,634,3.9
36033,10/1/19,19537,18729,808,4.1
36035,10/1/19,22689,21666,1023,4.5
36037,10/1/19,29718,28718,1000,3.4
36039,10/1/19,20053,19251,802,4
36041,10/1/19,2143,2059,84,3.9
36043,10/1/19,27716,26570,1146,4.1
36045,10/1/19,43558,41424,2134,4.9
36047,10/1/19,1199008,1153301,45707,3.8
36049,10/1/19,11569,11087,482,4.2
36051,10/1/19,30829,29685,1144,3.7
36053,10/1/19,32872,31578,1294,3.9
36055,10/1/19,364651,350138,14513,4
36057,10/1/19,22382,21413,969,4.3
36059,10/1/19,712936,688582,24354,3.4
36061,10/1/19,912586,882508,30078,3.3
36063,10/1/19,99035,94701,4334,4.4
36065,10/1/19,100898,96964,3934,3.9
36067,10/1/19,222579,214201,8378,3.8
36069,10/1/19,55696,53738,1958,3.5
36071,10/1/19,185360,178419,6941,3.7
36073,10/1/19,17604,16887,717,4.1
36075,10/1/19,53074,50598,2476,4.7
36077,10/1/19,28244,27204,1040,3.7
36079,10/1/19,51601,49714,1887,3.7
36081,10/1/19,1140962,1103794,37168,3.3
36083,10/1/19,81706,78855,2851,3.5
36085,10/1/19,222594,214671,7923,3.6
36087,10/1/19,155509,150033,5476,3.5
36089,10/1/19,43862,41774,2088,4.8
36091,10/1/19,119883,116064,3819,3.2
36093,10/1/19,76657,73899,2758,3.6
36095,10/1/19,14619,14065,554,3.8
36097,10/1/19,8134,7836,298,3.7
36099,10/1/19,16087,15534,553,3.4
36101,10/1/19,42582,40859,1723,4
36103,10/1/19,782005,754784,27221,3.5
36105,10/1/19,36592,35237,1355,3.7
36107,10/1/19,22776,21912,864,3.8
36109,10/1/19,50174,48363,1811,3.6
36111,10/1/19,88786,85702,3084,3.5
36113,10/1/19,31161,29990,1171,3.8
36115,10/1/19,27721,26757,964,3.5
36117,10/1/19,44026,42473,1553,3.5
36119,10/1/19,484961,467003,17958,3.7
36121,10/1/19,17965,17358,607,3.4
36123,10/1/19,11860,11457,403,3.4
37001,10/1/19,83405,80555,2850,3.4
37003,10/1/19,18212,17651,561,3.1
37005,10/1/19,4438,4242,196,4.4
37007,10/1/19,10926,10505,421,3.9
37009,10/1/19,13086,12687,399,3
37011,10/1/19,7712,7469,243,3.2
37013,10/1/19,19404,18590,814,4.2
37015,10/1/19,7736,7403,333,4.3
37017,10/1/19,14410,13763,647,4.5
37019,10/1/19,54463,51901,2562,4.7
37021,10/1/19,143971,140077,3894,2.7
37023,10/1/19,41545,40116,1429,3.4
37025,10/1/19,111292,107640,3652,3.3
37027,10/1/19,37045,35690,1355,3.7
37029,10/1/19,4628,4469,159,3.4
37031,10/1/19,32046,30917,1129,3.5
37033,10/1/19,9987,9570,417,4.2
37035,10/1/19,80062,77412,2650,3.3
37037,10/1/19,36151,35030,1121,3.1
37039,10/1/19,11230,10786,444,4
37041,10/1/19,5508,5278,230,4.2
37043,10/1/19,4204,4036,168,4
37045,10/1/19,49292,47473,1819,3.7
37047,10/1/19,23273,22226,1047,4.5
37049,10/1/19,42143,40620,1523,3.6
37051,10/1/19,128898,122862,6036,4.7
37053,10/1/19,14137,13691,446,3.2
37055,10/1/19,19801,19127,674,3.4
37057,10/1/19,82602,79786,2816,3.4
37059,10/1/19,21039,20389,650,3.1
37061,10/1/19,25158,24258,900,3.6
37063,10/1/19,173851,168451,5400,3.1
37065,10/1/19,21468,20310,1158,5.4
37067,10/1/19,191735,185251,6484,3.4
37069,10/1/19,31920,30766,1154,3.6
37071,10/1/19,113356,109380,3976,3.5
37073,10/1/19,5341,5145,196,3.7
37075,10/1/19,3261,3114,147,4.5
37077,10/1/19,30203,29278,925,3.1
37079,10/1/19,9450,9128,322,3.4
37081,10/1/19,267697,257740,9957,3.7
37083,10/1/19,20513,19377,1136,5.5
37085,10/1/19,54280,52067,2213,4.1
37087,10/1/19,30637,29729,908,3
37089,10/1/19,56347,54663,1684,3
37091,10/1/19,9239,8820,419,4.5
37093,10/1/19,20301,19354,947,4.7
37095,10/1/19,1976,1795,181,9.2
37097,10/1/19,91312,88285,3027,3.3
37099,10/1/19,20508,19793,715,3.5
37101,10/1/19,100939,97630,3309,3.3
37103,10/1/19,4371,4215,156,3.6
37105,10/1/19,26294,25230,1064,4
37107,10/1/19,27815,26840,975,3.5
37109,10/1/19,44357,42928,1429,3.2
37111,10/1/19,20987,20102,885,4.2
37113,10/1/19,15829,15308,521,3.3
37115,10/1/19,10400,10060,340,3.3
37117,10/1/19,9061,8654,407,4.5
37119,10/1/19,635182,614079,21103,3.3
37121,10/1/19,6153,5903,250,4.1
37123,10/1/19,11527,11086,441,3.8
37125,10/1/19,42862,41363,1499,3.5
37127,10/1/19,43822,41885,1937,4.4
37129,10/1/19,126332,122358,3974,3.1
37131,10/1/19,7749,7375,374,4.8
37133,10/1/19,65817,63007,2810,4.3
37135,10/1/19,80083,77731,2352,2.9
37137,10/1/19,5364,5183,181,3.4
37139,10/1/19,16758,16068,690,4.1
37141,10/1/19,29290,28251,1039,3.5
37143,10/1/19,4943,4713,230,4.7
37145,10/1/19,18668,17943,725,3.9
37147,10/1/19,91338,87828,3510,3.8
37149,10/1/19,9193,8870,323,3.5
37151,10/1/19,67411,65104,2307,3.4
37153,10/1/19,16740,15892,848,5.1
37155,10/1/19,50407,47906,2501,5
37157,10/1/19,40858,39216,1642,4
37159,10/1/19,67492,65038,2454,3.6
37161,10/1/19,25601,24452,1149,4.5
37163,10/1/19,29179,28145,1034,3.5
37165,10/1/19,11583,10859,724,6.3
37167,10/1/19,30706,29620,1086,3.5
37169,10/1/19,22149,21424,725,3.3
37171,10/1/19,34422,33227,1195,3.5
37173,10/1/19,7133,6902,231,3.2
37175,10/1/19,14838,14337,501,3.4
37177,10/1/19,1433,1359,74,5.2
37179,10/1/19,126229,122302,3927,3.1
37181,10/1/19,17532,16579,953,5.4
37183,10/1/19,608754,590387,18367,3
37185,10/1/19,6654,6304,350,5.3
37187,10/1/19,4437,4204,233,5.3
37189,10/1/19,30472,29561,911,3
37191,10/1/19,51591,49606,1985,3.8
37193,10/1/19,29523,28404,1119,3.8
37195,10/1/19,34960,33099,1861,5.3
37197,10/1/19,18004,17448,556,3.1
37199,10/1/19,8652,8364,288,3.3
38001,10/1/19,1056,1036,20,1.9
38003,10/1/19,5158,5069,89,1.7
38005,10/1/19,2314,2247,67,2.9
38007,10/1/19,401,392,9,2.2
38009,10/1/19,2927,2873,54,1.8
38011,10/1/19,1713,1688,25,1.5
38013,10/1/19,1045,1026,19,1.8
38015,10/1/19,48905,48106,799,1.6
38017,10/1/19,102661,101221,1440,1.4
38019,10/1/19,1917,1880,37,1.9
38021,10/1/19,2265,2239,26,1.1
38023,10/1/19,1418,1401,17,1.2
38025,10/1/19,3222,3182,40,1.2
38027,10/1/19,1209,1175,34,2.8
38029,10/1/19,1440,1407,33,2.3
38031,10/1/19,1467,1439,28,1.9
38033,10/1/19,827,816,11,1.3
38035,10/1/19,37183,36643,540,1.5
38037,10/1/19,1208,1192,16,1.3
38039,10/1/19,1023,1006,17,1.7
38041,10/1/19,1397,1371,26,1.9
38043,10/1/19,1243,1219,24,1.9
38045,10/1/19,2060,2031,29,1.4
38047,10/1/19,866,855,11,1.3
38049,10/1/19,3041,2977,64,2.1
38051,10/1/19,1103,1082,21,1.9
38053,10/1/19,10432,10280,152,1.5
38055,10/1/19,4630,4543,87,1.9
38057,10/1/19,3449,3363,86,2.5
38059,10/1/19,16061,15749,312,1.9
38061,10/1/19,7417,7331,86,1.2
38063,10/1/19,1381,1353,28,2
38065,10/1/19,856,841,15,1.8
38067,10/1/19,3307,3241,66,2
38069,10/1/19,1689,1653,36,2.1
38071,10/1/19,5503,5395,108,2
38073,10/1/19,2790,2761,29,1
38075,10/1/19,1231,1210,21,1.7
38077,10/1/19,8608,8474,134,1.6
38079,10/1/19,4454,4237,217,4.9
38081,10/1/19,2637,2607,30,1.1
38083,10/1/19,678,659,19,2.8
38085,10/1/19,1237,1199,38,3.1
38087,10/1/19,409,401,8,2
38089,10/1/19,18371,18090,281,1.5
38091,10/1/19,979,967,12,1.2
38093,10/1/19,10147,9987,160,1.6
38095,10/1/19,1114,1090,24,2.2
38097,10/1/19,4359,4295,64,1.5
38099,10/1/19,5093,4988,105,2.1
38101,10/1/19,31303,30771,532,1.7
38103,10/1/19,1893,1857,36,1.9
38105,10/1/19,24554,24199,355,1.4
39001,10/1/19,10648,10048,600,5.6
39003,10/1/19,47673,45842,1831,3.8
39005,10/1/19,26973,25950,1023,3.8
39007,10/1/19,44465,42566,1899,4.3
39009,10/1/19,29654,28288,1366,4.6
39011,10/1/19,24932,24176,756,3
39013,10/1/19,30477,28808,1669,5.5
39015,10/1/19,19644,18773,871,4.4
39017,10/1/19,196219,189071,7148,3.6
39019,10/1/19,13051,12434,617,4.7
39021,10/1/19,20134,19220,914,4.5
39023,10/1/19,64014,60915,3099,4.8
39025,10/1/19,107354,103666,3688,3.4
39027,10/1/19,17814,17050,764,4.3
39029,10/1/19,47652,45505,2147,4.5
39031,10/1/19,14358,13585,773,5.4
39033,10/1/19,18190,17386,804,4.4
39035,10/1/19,612718,591180,21538,3.5
39037,10/1/19,25805,24934,871,3.4
39039,10/1/19,18477,17660,817,4.4
39041,10/1/19,111550,108125,3425,3.1
39043,10/1/19,37018,35504,1514,4.1
39045,10/1/19,78598,75880,2718,3.5
39047,10/1/19,13892,13389,503,3.6
39049,10/1/19,704318,680640,23678,3.4
39051,10/1/19,22680,21825,855,3.8
39053,10/1/19,12228,11648,580,4.7
39055,10/1/19,49241,47863,1378,2.8
39057,10/1/19,84114,81059,3055,3.6
39059,10/1/19,18552,17643,909,4.9
39061,10/1/19,418838,403575,15263,3.6
39063,10/1/19,41972,40733,1239,3
39065,10/1/19,13780,13227,553,4
39067,10/1/19,6739,6392,347,5.1
39069,10/1/19,13411,12902,509,3.8
39071,10/1/19,17056,16264,792,4.6
39073,10/1/19,13165,12636,529,4
39075,10/1/19,20836,20222,614,2.9
39077,10/1/19,27742,26418,1324,4.8
39079,10/1/19,12569,11919,650,5.2
39081,10/1/19,27914,26324,1590,5.7
39083,10/1/19,31839,30735,1104,3.5
39085,10/1/19,126133,122451,3682,2.9
39087,10/1/19,23963,22790,1173,4.9
39089,10/1/19,91327,88115,3212,3.5
39091,10/1/19,22673,21873,800,3.5
39093,10/1/19,153390,148004,5386,3.5
39095,10/1/19,212691,203843,8848,4.2
39097,10/1/19,20893,20239,654,3.1
39099,10/1/19,102861,97536,5325,5.2
39101,10/1/19,28216,27176,1040,3.7
39103,10/1/19,97602,94826,2776,2.8
39105,10/1/19,9161,8636,525,5.7
39107,10/1/19,23206,22618,588,2.5
39109,10/1/19,54575,52686,1889,3.5
39111,10/1/19,5305,4916,389,7.3
39113,10/1/19,255615,244921,10694,4.2
39115,10/1/19,6638,6266,372,5.6
39117,10/1/19,16896,16303,593,3.5
39119,10/1/19,39714,38062,1652,4.2
39121,10/1/19,4670,4391,279,6
39123,10/1/19,20925,20061,864,4.1
39125,10/1/19,8657,8333,324,3.7
39127,10/1/19,15991,15230,761,4.8
39129,10/1/19,26588,25646,942,3.5
39131,10/1/19,10754,10166,588,5.5
39133,10/1/19,87868,84495,3373,3.8
39135,10/1/19,21243,20476,767,3.6
39137,10/1/19,18765,18242,523,2.8
39139,10/1/19,51779,49620,2159,4.2
39141,10/1/19,35340,34054,1286,3.6
39143,10/1/19,30497,29126,1371,4.5
39145,10/1/19,29081,27460,1621,5.6
39147,10/1/19,27251,26212,1039,3.8
39149,10/1/19,24047,23240,807,3.4
39151,10/1/19,186909,179200,7709,4.1
39153,10/1/19,274119,263402,10717,3.9
39155,10/1/19,86582,81788,4794,5.5
39157,10/1/19,44916,43115,1801,4
39159,10/1/19,29224,28307,917,3.1
39161,10/1/19,15021,14536,485,3.2
39163,10/1/19,5565,5303,262,4.7
39165,10/1/19,119919,115876,4043,3.4
39167,10/1/19,27554,26217,1337,4.9
39169,10/1/19,62254,60348,1906,3.1
39171,10/1/19,19056,18431,625,3.3
39173,10/1/19,72144,69676,2468,3.4
39175,10/1/19,12848,12488,360,2.8
40001,10/1/19,8196,7883,313,3.8
40003,10/1/19,2906,2840,66,2.3
40005,10/1/19,4942,4719,223,4.5
40007,10/1/19,2960,2914,46,1.6
40009,10/1/19,10209,9784,425,4.2
40011,10/1/19,4760,4669,91,1.9
40013,10/1/19,21306,20699,607,2.8
40015,10/1/19,11878,11420,458,3.9
40017,10/1/19,75173,72987,2186,2.9
40019,10/1/19,21651,20909,742,3.4
40021,10/1/19,18788,18088,700,3.7
40023,10/1/19,5375,5120,255,4.7
40025,10/1/19,1403,1380,23,1.6
40027,10/1/19,143907,140067,3840,2.7
40029,10/1/19,2416,2302,114,4.7
40031,10/1/19,48110,46328,1782,3.7
40033,10/1/19,2758,2655,103,3.7
40035,10/1/19,5956,5733,223,3.7
40037,10/1/19,31871,30596,1275,4
40039,10/1/19,15677,15266,411,2.6
40041,10/1/19,18034,17368,666,3.7
40043,10/1/19,2934,2856,78,2.7
40045,10/1/19,2167,2114,53,2.4
40047,10/1/19,26944,26146,798,3
40049,10/1/19,12515,12102,413,3.3
40051,10/1/19,26858,25989,869,3.2
40053,10/1/19,2693,2647,46,1.7
40055,10/1/19,1890,1812,78,4.1
40057,10/1/19,1183,1151,32,2.7
40059,10/1/19,1831,1779,52,2.8
40061,10/1/19,4258,3995,263,6.2
40063,10/1/19,5429,5135,294,5.4
40065,10/1/19,10755,10452,303,2.8
40067,10/1/19,2551,2474,77,3
40069,10/1/19,3705,3527,178,4.8
40071,10/1/19,18423,17647,776,4.2
40073,10/1/19,9154,8987,167,1.8
40075,10/1/19,3518,3370,148,4.2
40077,10/1/19,3174,2935,239,7.5
40079,10/1/19,19081,18187,894,4.7
40081,10/1/19,15924,15376,548,3.4
40083,10/1/19,22294,21708,586,2.6
40085,10/1/19,6227,6085,142,2.3
40087,10/1/19,19912,19342,570,2.9
40089,10/1/19,14875,14013,862,5.8
40091,10/1/19,7169,6742,427,6
40093,10/1/19,3855,3773,82,2.1
40095,10/1/19,6930,6711,219,3.2
40097,10/1/19,19525,18920,605,3.1
40099,10/1/19,6338,6146,192,3
40101,10/1/19,29881,28763,1118,3.7
40103,10/1/19,5667,5523,144,2.5
40105,10/1/19,4650,4493,157,3.4
40107,10/1/19,4655,4427,228,4.9
40109,10/1/19,388081,375946,12135,3.1
40111,10/1/19,15854,15060,794,5
40113,10/1/19,20874,20093,781,3.7
40115,10/1/19,14091,13639,452,3.2
40117,10/1/19,7412,7120,292,3.9
40119,10/1/19,37863,36923,940,2.5
40121,10/1/19,17129,16310,819,4.8
40123,10/1/19,19643,18758,885,4.5
40125,10/1/19,32647,31474,1173,3.6
40127,10/1/19,4326,4100,226,5.2
40129,10/1/19,1918,1845,73,3.8
40131,10/1/19,45489,44060,1429,3.1
40133,10/1/19,9601,9071,530,5.5
40135,10/1/19,16202,15513,689,4.3
40137,10/1/19,18453,17517,936,5.1
40139,10/1/19,11459,11285,174,1.5
40141,10/1/19,3074,2930,144,4.7
40143,10/1/19,325874,314516,11358,3.5
40145,10/1/19,38287,36993,1294,3.4
40147,10/1/19,22217,21478,739,3.3
40149,10/1/19,5300,5074,226,4.3
40151,10/1/19,4680,4600,80,1.7
40153,10/1/19,8940,8648,292,3.3
41001,10/1/19,7256,7007,249,3.4
41003,10/1/19,48875,47733,1142,2.3
41005,10/1/19,219951,213713,6238,2.8
41007,10/1/19,19446,18856,590,3
41009,10/1/19,24417,23480,937,3.8
41011,10/1/19,25935,24936,999,3.9
41013,10/1/19,9593,9210,383,4
41015,10/1/19,8984,8634,350,3.9
41017,10/1/19,96369,93551,2818,2.9
41019,10/1/19,46398,44551,1847,4
41021,10/1/19,877,846,31,3.5
41023,10/1/19,3181,3054,127,4
41025,10/1/19,3584,3473,111,3.1
41027,10/1/19,14332,13991,341,2.4
41029,10/1/19,104139,100828,3311,3.2
41031,10/1/19,10034,9675,359,3.6
41033,10/1/19,35818,34422,1396,3.9
41035,10/1/19,29345,27961,1384,4.7
41037,10/1/19,3656,3533,123,3.4
41039,10/1/19,181792,175810,5982,3.3
41041,10/1/19,20621,19898,723,3.5
41043,10/1/19,58943,56887,2056,3.5
41045,10/1/19,12478,12131,347,2.8
41047,10/1/19,162210,157070,5140,3.2
41049,10/1/19,5774,5611,163,2.8
41051,10/1/19,456073,443524,12549,2.8
41053,10/1/19,40170,38839,1331,3.3
41055,10/1/19,945,920,25,2.6
41057,10/1/19,11775,11401,374,3.2
41059,10/1/19,36892,35669,1223,3.3
41061,10/1/19,11981,11574,407,3.4
41063,10/1/19,3378,3254,124,3.7
41065,10/1/19,12541,12107,434,3.5
41067,10/1/19,325734,317232,8502,2.6
41069,10/1/19,737,711,26,3.5
41071,10/1/19,54954,53426,1528,2.8
42001,10/1/19,55545,53717,1828,3.3
42003,10/1/19,655839,628425,27414,4.2
42005,10/1/19,32430,30903,1527,4.7
42007,10/1/19,84817,81024,3793,4.5
42009,10/1/19,23593,22561,1032,4.4
42011,10/1/19,217403,207765,9638,4.4
42013,10/1/19,59553,56832,2721,4.6
42015,10/1/19,28871,27573,1298,4.5
42017,10/1/19,348291,334531,13760,4
42019,10/1/19,100754,96868,3886,3.9
42021,10/1/19,58402,55491,2911,5
42023,10/1/19,2051,1875,176,8.6
42025,10/1/19,32601,30824,1777,5.5
42027,10/1/19,82034,79219,2815,3.4
42029,10/1/19,287859,278303,9556,3.3
42031,10/1/19,17349,16556,793,4.6
42033,10/1/19,36070,34315,1755,4.9
42035,10/1/19,18338,17432,906,4.9
42037,10/1/19,34014,32537,1477,4.3
42039,10/1/19,38724,36978,1746,4.5
42041,10/1/19,133601,128886,4715,3.5
42043,10/1/19,146011,139832,6179,4.2
42045,10/1/19,303813,290893,12920,4.3
42047,10/1/19,15481,14566,915,5.9
42049,10/1/19,129331,123552,5779,4.5
42051,10/1/19,57546,54303,3243,5.6
42053,10/1/19,1805,1690,115,6.4
42055,10/1/19,78205,75159,3046,3.9
42057,10/1/19,7828,7511,317,4
42059,10/1/19,16755,15895,860,5.1
42061,10/1/19,20097,19001,1096,5.5
42063,10/1/19,39783,37942,1841,4.6
42065,10/1/19,20556,19637,919,4.5
42067,10/1/19,12623,12093,530,4.2
42069,10/1/19,106426,101269,5157,4.8
42071,10/1/19,286906,276812,10094,3.5
42073,10/1/19,40923,38989,1934,4.7
42075,10/1/19,73001,70103,2898,4
42077,10/1/19,195512,186693,8819,4.5
42079,10/1/19,159377,150535,8842,5.5
42081,10/1/19,57148,54495,2653,4.6
42083,10/1/19,17398,16448,950,5.5
42085,10/1/19,49298,46831,2467,5
42087,10/1/19,21107,20168,939,4.4
42089,10/1/19,83516,78944,4572,5.5
42091,10/1/19,460450,443608,16842,3.7
42093,10/1/19,9271,8951,320,3.5
42095,10/1/19,163566,156329,7237,4.4
42097,10/1/19,43347,41075,2272,5.2
42099,10/1/19,24641,23747,894,3.6
42101,10/1/19,733323,691092,42231,5.8
42103,10/1/19,25442,24019,1423,5.6
42105,10/1/19,7165,6757,408,5.7
42107,10/1/19,66662,63033,3629,5.4
42109,10/1/19,20189,19165,1024,5.1
42111,10/1/19,33550,31913,1637,4.9
42113,10/1/19,2675,2535,140,5.2
42115,10/1/19,20691,19846,845,4.1
42117,10/1/19,19385,18461,924,4.8
42119,10/1/19,20164,19397,767,3.8
42121,10/1/19,22391,21284,1107,4.9
42123,10/1/19,18932,18079,853,4.5
42125,10/1/19,108323,103334,4989,4.6
42127,10/1/19,22145,21159,986,4.5
42129,10/1/19,182756,174852,7904,4.3
42131,10/1/19,13726,13084,642,4.7
42133,10/1/19,238249,228898,9351,3.9
44001,10/1/19,26122,25490,632,2.4
44003,10/1/19,91178,88734,2444,2.7
44005,10/1/19,44377,43353,1024,2.3
44007,10/1/19,326784,316201,10583,3.2
44009,10/1/19,69139,67419,1720,2.5
45001,10/1/19,10067,9759,308,3.1
45003,10/1/19,75147,73318,1829,2.4
45005,10/1/19,2649,2521,128,4.8
45007,10/1/19,92178,90082,2096,2.3
45009,10/1/19,4972,4695,277,5.6
45011,10/1/19,8227,7920,307,3.7
45013,10/1/19,78395,76680,1715,2.2
45015,10/1/19,104588,102365,2223,2.1
45017,10/1/19,6629,6415,214,3.2
45019,10/1/19,211921,207907,4014,1.9
45021,10/1/19,25411,24744,667,2.6
45023,10/1/19,13566,13097,469,3.5
45025,10/1/19,21990,21435,555,2.5
45027,10/1/19,12700,12278,422,3.3
45029,10/1/19,16809,16348,461,2.7
45031,10/1/19,30503,29627,876,2.9
45033,10/1/19,13031,12575,456,3.5
45035,10/1/19,78478,76878,1600,2
45037,10/1/19,10705,10453,252,2.4
45039,10/1/19,9629,9288,341,3.5
45041,10/1/19,67067,65434,1633,2.4
45043,10/1/19,25744,24961,783,3
45045,10/1/19,257803,252507,5296,2.1
45047,10/1/19,31425,30596,829,2.6
45049,10/1/19,8414,8229,185,2.2
45051,10/1/19,147647,143508,4139,2.8
45053,10/1/19,12630,12374,256,2
45055,10/1/19,29469,28725,744,2.5
45057,10/1/19,41776,40550,1226,2.9
45059,10/1/19,30467,29672,795,2.6
45061,10/1/19,6668,6417,251,3.8
45063,10/1/19,151240,148277,2963,2
45065,10/1/19,3368,3278,90,2.7
45067,10/1/19,12954,12497,457,3.5
45069,10/1/19,9298,8923,375,4
45071,10/1/19,19124,18659,465,2.4
45073,10/1/19,35280,34481,799,2.3
45075,10/1/19,34398,32726,1672,4.9
45077,10/1/19,57956,56627,1329,2.3
45079,10/1/19,200637,196081,4556,2.3
45081,10/1/19,8894,8692,202,2.3
45083,10/1/19,154757,151469,3288,2.1
45085,10/1/19,43854,42605,1249,2.8
45087,10/1/19,11755,11405,350,3
45089,10/1/19,11916,11445,471,4
45091,10/1/19,141947,138675,3272,2.3
46003,10/1/19,1514,1471,43,2.8
46005,10/1/19,9439,9156,283,3
46007,10/1/19,1106,1046,60,5.4
46009,10/1/19,2870,2782,88,3.1
46011,10/1/19,19658,19033,625,3.2
46013,10/1/19,20801,20185,616,3
46015,10/1/19,2474,2394,80,3.2
46017,10/1/19,677,631,46,6.8
46019,10/1/19,5041,4875,166,3.3
46021,10/1/19,771,748,23,3
46023,10/1/19,3736,3600,136,3.6
46025,10/1/19,1927,1867,60,3.1
46027,10/1/19,7768,7513,255,3.3
46029,10/1/19,15573,15144,429,2.8
46031,10/1/19,1395,1315,80,5.7
46033,10/1/19,3995,3846,149,3.7
46035,10/1/19,11108,10811,297,2.7
46037,10/1/19,2767,2666,101,3.7
46039,10/1/19,2188,2113,75,3.4
46041,10/1/19,2223,2064,159,7.2
46043,10/1/19,1589,1548,41,2.6
46045,10/1/19,2042,1984,58,2.8
46047,10/1/19,2926,2812,114,3.9
46049,10/1/19,1078,1043,35,3.2
46051,10/1/19,4437,4324,113,2.5
46053,10/1/19,2115,2045,70,3.3
46055,10/1/19,1060,1032,28,2.6
46057,10/1/19,3366,3280,86,2.6
46059,10/1/19,1821,1773,48,2.6
46061,10/1/19,1735,1672,63,3.6
46063,10/1/19,743,721,22,3
46065,10/1/19,10058,9811,247,2.5
46067,10/1/19,3621,3518,103,2.8
46069,10/1/19,685,662,23,3.4
46071,10/1/19,1257,1192,65,5.2
46073,10/1/19,1123,1095,28,2.5
46075,10/1/19,540,525,15,2.8
46077,10/1/19,2651,2580,71,2.7
46079,10/1/19,6760,6535,225,3.3
46081,10/1/19,13561,13137,424,3.1
46083,10/1/19,34909,34054,855,2.4
46085,10/1/19,1724,1648,76,4.4
46087,10/1/19,3096,3015,81,2.6
46089,10/1/19,1012,972,40,4
46091,10/1/19,2398,2322,76,3.2
46093,10/1/19,14161,13702,459,3.2
46095,10/1/19,738,697,41,5.6
46097,10/1/19,1199,1159,40,3.3
46099,10/1/19,113993,110995,2998,2.6
46101,10/1/19,4064,3940,124,3.1
46102,10/1/19,3545,3219,326,9.2
46103,10/1/19,56999,55169,1830,3.2
46105,10/1/19,1422,1377,45,3.2
46107,10/1/19,1044,1011,33,3.2
46109,10/1/19,5011,4854,157,3.1
46111,10/1/19,1151,1116,35,3
46115,10/1/19,3169,3065,104,3.3
46117,10/1/19,1850,1804,46,2.5
46119,10/1/19,804,781,23,2.9
46121,10/1/19,3136,2937,199,6.3
46123,10/1/19,3098,3012,86,2.8
46125,10/1/19,4722,4589,133,2.8
46127,10/1/19,8566,8276,290,3.4
46129,10/1/19,2116,2018,98,4.6
46135,10/1/19,11896,11553,343,2.9
46137,10/1/19,940,889,51,5.4
47001,10/1/19,35239,34026,1213,3.4
47003,10/1/19,21274,20506,768,3.6
47005,10/1/19,6993,6677,316,4.5
47007,10/1/19,4456,4242,214,4.8
47009,10/1/19,64663,62702,1961,3
47011,10/1/19,53609,51938,1671,3.1
47013,10/1/19,15097,14438,659,4.4
47015,10/1/19,6775,6576,199,2.9
47017,10/1/19,12191,11650,541,4.4
47019,10/1/19,24305,23432,873,3.6
47021,10/1/19,22458,21926,532,2.4
47023,10/1/19,8660,8379,281,3.2
47025,10/1/19,13242,12741,501,3.8
47027,10/1/19,2816,2670,146,5.2
47029,10/1/19,15085,14497,588,3.9
47031,10/1/19,25780,24989,791,3.1
47033,10/1/19,7109,6883,226,3.2
47035,10/1/19,23891,22993,898,3.8
47037,10/1/19,414469,404807,9662,2.3
47039,10/1/19,4701,4402,299,6.4
47041,10/1/19,7928,7515,413,5.2
47043,10/1/19,27718,26958,760,2.7
47045,10/1/19,16636,15878,758,4.6
47047,10/1/19,19487,18770,717,3.7
47049,10/1/19,7637,7339,298,3.9
47051,10/1/19,20604,19939,665,3.2
47053,10/1/19,22410,21495,915,4.1
47055,10/1/19,15272,14600,672,4.4
47057,10/1/19,9675,9334,341,3.5
47059,10/1/19,29893,28550,1343,4.5
47061,10/1/19,5100,4888,212,4.2
47063,10/1/19,28564,27509,1055,3.7
47065,10/1/19,185845,180168,5677,3.1
47067,10/1/19,2149,2033,116,5.4
47069,10/1/19,9635,9148,487,5.1
47071,10/1/19,10572,10155,417,3.9
47073,10/1/19,24049,23025,1024,4.3
47075,10/1/19,7818,7477,341,4.4
47077,10/1/19,12510,11893,617,4.9
47079,10/1/19,14306,13760,546,3.8
47081,10/1/19,11794,11414,380,3.2
47083,10/1/19,3329,3197,132,4
47085,10/1/19,9049,8743,306,3.4
47087,10/1/19,4723,4538,185,3.9
47089,10/1/19,24903,24076,827,3.3
47091,10/1/19,7812,7575,237,3
47093,10/1/19,247970,241347,6623,2.7
47095,10/1/19,1774,1690,84,4.7
47097,10/1/19,9858,9355,503,5.1
47099,10/1/19,19814,18916,898,4.5
47101,10/1/19,5434,5118,316,5.8
47103,10/1/19,16763,16048,715,4.3
47105,10/1/19,23895,23161,734,3.1
47107,10/1/19,23955,23138,817,3.4
47109,10/1/19,8642,8246,396,4.6
47111,10/1/19,11645,11285,360,3.1
47113,10/1/19,49572,47852,1720,3.5
47115,10/1/19,12632,12115,517,4.1
47117,10/1/19,16205,15381,824,5.1
47119,10/1/19,52383,49244,3139,6
47121,10/1/19,5263,5058,205,3.9
47123,10/1/19,20394,19693,701,3.4
47125,10/1/19,86761,83648,3113,3.6
47127,10/1/19,3683,3582,101,2.7
47129,10/1/19,7989,7711,278,3.5
47131,10/1/19,12550,12041,509,4.1
47133,10/1/19,10181,9863,318,3.1
47135,10/1/19,3112,2855,257,8.3
47137,10/1/19,2419,2323,96,4
47139,10/1/19,7727,7463,264,3.4
47141,10/1/19,35799,34676,1123,3.1
47143,10/1/19,13639,13009,630,4.6
47145,10/1/19,23740,22885,855,3.6
47147,10/1/19,39001,37999,1002,2.6
47149,10/1/19,188770,184280,4490,2.4
47151,10/1/19,8310,7970,340,4.1
47153,10/1/19,6289,6024,265,4.2
47155,10/1/19,55286,53966,1320,2.4
47157,10/1/19,449513,432775,16738,3.7
47159,10/1/19,9712,9442,270,2.8
47161,10/1/19,5578,5366,212,3.8
47163,10/1/19,70846,68429,2417,3.4
47165,10/1/19,105071,102417,2654,2.5
47167,10/1/19,28487,27443,1044,3.7
47169,10/1/19,5562,5413,149,2.7
47171,10/1/19,7189,6883,306,4.3
47173,10/1/19,7746,7470,276,3.6
47175,10/1/19,2091,1999,92,4.4
47177,10/1/19,16935,16166,769,4.5
47179,10/1/19,61176,59239,1937,3.2
47181,10/1/19,6310,6015,295,4.7
47183,10/1/19,16331,15779,552,3.4
47185,10/1/19,12415,11962,453,3.6
47187,10/1/19,131871,128851,3020,2.3
47189,10/1/19,78690,76680,2010,2.6
48001,10/1/19,24135,23470,665,2.8
48003,10/1/19,9879,9655,224,2.3
48005,10/1/19,36017,34638,1379,3.8
48007,10/1/19,9429,9061,368,3.9
48009,10/1/19,4174,4063,111,2.7
48011,10/1/19,941,917,24,2.6
48013,10/1/19,21976,21229,747,3.4
48015,10/1/19,14209,13747,462,3.3
48017,10/1/19,2525,2443,82,3.2
48019,10/1/19,10191,9864,327,3.2
48021,10/1/19,43412,42168,1244,2.9
48023,10/1/19,1790,1753,37,2.1
48025,10/1/19,9884,9461,423,4.3
48027,10/1/19,145056,139793,5263,3.6
48029,10/1/19,961234,932364,28870,3
48031,10/1/19,6509,6361,148,2.3
48033,10/1/19,424,415,9,2.1
48035,10/1/19,8374,8101,273,3.3
48037,10/1/19,40047,38380,1667,4.2
48039,10/1/19,180965,173595,7370,4.1
48041,10/1/19,122689,119539,3150,2.6
48043,10/1/19,4182,4070,112,2.7
48045,10/1/19,588,568,20,3.4
48047,10/1/19,2588,2459,129,5
48049,10/1/19,15522,14938,584,3.8
48051,10/1/19,8608,8355,253,2.9
48053,10/1/19,23604,22983,621,2.6
48055,10/1/19,19889,19267,622,3.1
48057,10/1/19,12161,11793,368,3
48059,10/1/19,6182,6009,173,2.8
48061,10/1/19,166663,158120,8543,5.1
48063,10/1/19,5004,4811,193,3.9
48065,10/1/19,3046,2974,72,2.4
48067,10/1/19,12473,11975,498,4
48069,10/1/19,3504,3419,85,2.4
48071,10/1/19,19577,18766,811,4.1
48073,10/1/19,20931,20156,775,3.7
48075,10/1/19,2949,2860,89,3
48077,10/1/19,4980,4838,142,2.9
48079,10/1/19,1149,1115,34,3
48081,10/1/19,1483,1436,47,3.2
48083,10/1/19,2877,2768,109,3.8
48085,10/1/19,569882,553156,16726,2.9
48087,10/1/19,1192,1154,38,3.2
48089,10/1/19,9879,9591,288,2.9
48091,10/1/19,74073,71988,2085,2.8
48093,10/1/19,5685,5503,182,3.2
48095,10/1/19,1389,1349,40,2.9
48097,10/1/19,19818,19278,540,2.7
48099,10/1/19,24308,23413,895,3.7
48101,10/1/19,562,539,23,4.1
48103,10/1/19,1584,1520,64,4
48105,10/1/19,1625,1568,57,3.5
48107,10/1/19,2548,2456,92,3.6
48109,10/1/19,1062,1019,43,4
48111,10/1/19,3946,3872,74,1.9
48113,10/1/19,1378578,1333216,45362,3.3
48115,10/1/19,4641,4469,172,3.7
48117,10/1/19,8662,8446,216,2.5
48119,10/1/19,2466,2382,84,3.4
48121,10/1/19,500290,486234,14056,2.8
48123,10/1/19,9895,9639,256,2.6
48125,10/1/19,690,660,30,4.3
48127,10/1/19,7405,7218,187,2.5
48129,10/1/19,1429,1384,45,3.1
48131,10/1/19,4944,4734,210,4.2
48133,10/1/19,8202,7939,263,3.2
48135,10/1/19,88389,85963,2426,2.7
48137,10/1/19,1151,1130,21,1.8
48139,10/1/19,93666,90924,2742,2.9
48141,10/1/19,366624,353079,13545,3.7
48143,10/1/19,21346,20674,672,3.1
48145,10/1/19,6619,6413,206,3.1
48147,10/1/19,17510,17046,464,2.6
48149,10/1/19,12104,11799,305,2.5
48151,10/1/19,1650,1606,44,2.7
48153,10/1/19,2603,2508,95,3.6
48155,10/1/19,599,582,17,2.8
48157,10/1/19,394963,381779,13184,3.3
48159,10/1/19,4642,4484,158,3.4
48161,10/1/19,6424,6119,305,4.7
48163,10/1/19,10467,10213,254,2.4
48165,10/1/19,9885,9656,229,2.3
48167,10/1/19,166498,160169,6329,3.8
48169,10/1/19,2161,2108,53,2.5
48171,10/1/19,13491,13189,302,2.2
48173,10/1/19,821,805,16,1.9
48175,10/1/19,3273,3169,104,3.2
48177,10/1/19,9715,9462,253,2.6
48179,10/1/19,8072,7806,266,3.3
48181,10/1/19,64281,62367,1914,3
48183,10/1/19,58750,56633,2117,3.6
48185,10/1/19,11508,11062,446,3.9
48187,10/1/19,82542,80253,2289,2.8
48189,10/1/19,12173,11676,497,4.1
48191,10/1/19,1074,1031,43,4
48193,10/1/19,3656,3545,111,3
48195,10/1/19,2797,2736,61,2.2
48197,10/1/19,1745,1695,50,2.9
48199,10/1/19,25441,24384,1057,4.2
48201,10/1/19,2330581,2245695,84886,3.6
48203,10/1/19,29830,28654,1176,3.9
48205,10/1/19,2830,2785,45,1.6
48207,10/1/19,2344,2276,68,2.9
48209,10/1/19,121348,118096,3252,2.7
48211,10/1/19,1916,1862,54,2.8
48213,10/1/19,36681,35455,1226,3.3
48215,10/1/19,354494,334439,20055,5.7
48217,10/1/19,16584,16064,520,3.1
48219,10/1/19,11322,11001,321,2.8
48221,10/1/19,27756,26856,900,3.2
48223,10/1/19,17695,17185,510,2.9
48225,10/1/19,10514,10194,320,3
48227,10/1/19,14117,13667,450,3.2
48229,10/1/19,1870,1790,80,4.3
48231,10/1/19,43879,42384,1495,3.4
48233,10/1/19,8734,8378,356,4.1
48235,10/1/19,764,746,18,2.4
48237,10/1/19,3425,3307,118,3.4
48239,10/1/19,7681,7464,217,2.8
48241,10/1/19,12789,12085,704,5.5
48243,10/1/19,1023,995,28,2.7
48245,10/1/19,107441,101653,5788,5.4
48247,10/1/19,1864,1782,82,4.4
48249,10/1/19,16648,15868,780,4.7
48251,10/1/19,82930,80343,2587,3.1
48253,10/1/19,5842,5613,229,3.9
48255,10/1/19,7351,7173,178,2.4
48257,10/1/19,65371,63313,2058,3.1
48259,10/1/19,22382,21805,577,2.6
48261,10/1/19,212,203,9,4.2
48263,10/1/19,486,475,11,2.3
48265,10/1/19,22150,21507,643,2.9
48267,10/1/19,1863,1809,54,2.9
48269,10/1/19,245,241,4,1.6
48271,10/1/19,1406,1361,45,3.2
48273,10/1/19,13731,13157,574,4.2
48275,10/1/19,1470,1427,43,2.9
48277,10/1/19,24378,23605,773,3.2
48279,10/1/19,5392,5192,200,3.7
48281,10/1/19,9283,8998,285,3.1
48283,10/1/19,4332,4221,111,2.6
48285,10/1/19,8538,8299,239,2.8
48287,10/1/19,10110,9850,260,2.6
48289,10/1/19,6400,6122,278,4.3
48291,10/1/19,33286,31715,1571,4.7
48293,10/1/19,8649,8331,318,3.7
48295,10/1/19,1636,1595,41,2.5
48297,10/1/19,5670,5508,162,2.9
48299,10/1/19,8731,8456,275,3.1
48301,10/1/19,640,636,4,0.6
48303,10/1/19,158917,154691,4226,2.7
48305,10/1/19,2826,2746,80,2.8
48307,10/1/19,3387,3217,170,5
48309,10/1/19,119784,116007,3777,3.2
48311,10/1/19,898,884,14,1.6
48313,10/1/19,4580,4397,183,4
48315,10/1/19,4257,4084,173,4.1
48317,10/1/19,2935,2850,85,2.9
48319,10/1/19,1767,1716,51,2.9
48321,10/1/19,16993,16111,882,5.2
48323,10/1/19,23629,22094,1535,6.5
48325,10/1/19,22129,21471,658,3
48327,10/1/19,881,853,28,3.2
48329,10/1/19,108074,105850,2224,2.1
48331,10/1/19,9799,9376,423,4.3
48333,10/1/19,1938,1884,54,2.8
48335,10/1/19,2349,2269,80,3.4
48337,10/1/19,9429,9169,260,2.8
48339,10/1/19,285848,276470,9378,3.3
48341,10/1/19,10954,10714,240,2.2
48343,10/1/19,4820,4574,246,5.1
48345,10/1/19,490,476,14,2.9
48347,10/1/19,28277,27262,1015,3.6
48349,10/1/19,24619,23903,716,2.9
48351,10/1/19,5206,4912,294,5.6
48353,10/1/19,7279,7079,200,2.7
48355,10/1/19,167773,161388,6385,3.8
48357,10/1/19,4353,4242,111,2.5
48359,10/1/19,929,906,23,2.5
48361,10/1/19,36536,34809,1727,4.7
48363,10/1/19,13605,13209,396,2.9
48365,10/1/19,10112,9712,400,4
48367,10/1/19,67925,66018,1907,2.8
48369,10/1/19,4953,4849,104,2.1
48371,10/1/19,6361,6151,210,3.3
48373,10/1/19,18141,17330,811,4.5
48375,10/1/19,55466,54003,1463,2.6
48377,10/1/19,3141,2938,203,6.5
48379,10/1/19,6032,5864,168,2.8
48381,10/1/19,72607,70934,1673,2.3
48383,10/1/19,1945,1891,54,2.8
48385,10/1/19,1008,970,38,3.8
48387,10/1/19,5154,4930,224,4.3
48389,10/1/19,12072,11882,190,1.6
48391,10/1/19,3164,3042,122,3.9
48393,10/1/19,428,417,11,2.6
48395,10/1/19,7889,7629,260,3.3
48397,10/1/19,52629,51081,1548,2.9
48399,10/1/19,4673,4545,128,2.7
48401,10/1/19,23243,22436,807,3.5
48403,10/1/19,3670,3450,220,6
48405,10/1/19,3406,3246,160,4.7
48407,10/1/19,11815,11301,514,4.4
48409,10/1/19,30020,28492,1528,5.1
48411,10/1/19,2575,2498,77,3
48413,10/1/19,1304,1264,40,3.1
48415,10/1/19,6724,6514,210,3.1
48417,10/1/19,1895,1855,40,2.1
48419,10/1/19,11304,10888,416,3.7
48421,10/1/19,1416,1383,33,2.3
48423,10/1/19,107593,104149,3444,3.2
48425,10/1/19,4392,4247,145,3.3
48427,10/1/19,25044,22664,2380,9.5
48429,10/1/19,4069,3950,119,2.9
48431,10/1/19,597,579,18,3
48433,10/1/19,583,567,16,2.7
48435,10/1/19,1286,1232,54,4.2
48437,10/1/19,2629,2537,92,3.5
48439,10/1/19,1092588,1057072,35516,3.3
48441,10/1/19,67997,66138,1859,2.7
48443,10/1/19,375,362,13,3.5
48445,10/1/19,5017,4847,170,3.4
48447,10/1/19,665,639,26,3.9
48449,10/1/19,13105,12605,500,3.8
48451,10/1/19,54691,53096,1595,2.9
48453,10/1/19,749182,730820,18362,2.5
48455,10/1/19,5380,5124,256,4.8
48457,10/1/19,7168,6800,368,5.1
48459,10/1/19,18028,17395,633,3.5
48461,10/1/19,1676,1638,38,2.3
48463,10/1/19,11487,11081,406,3.5
48465,10/1/19,23091,22350,741,3.2
48467,10/1/19,26058,25246,812,3.1
48469,10/1/19,42868,41435,1433,3.3
48471,10/1/19,24443,23544,899,3.7
48473,10/1/19,23704,22828,876,3.7
48475,10/1/19,7510,7338,172,2.3
48477,10/1/19,15396,14939,457,3
48479,10/1/19,118980,114899,4081,3.4
48481,10/1/19,21985,21274,711,3.2
48483,10/1/19,2286,2215,71,3.1
48485,10/1/19,56522,54842,1680,3
48487,10/1/19,4982,4826,156,3.1
48489,10/1/19,6730,6249,481,7.1
48491,10/1/19,317883,309323,8560,2.7
48493,10/1/19,25196,24513,683,2.7
48495,10/1/19,4036,3931,105,2.6
48497,10/1/19,32150,31186,964,3
48499,10/1/19,17828,17162,666,3.7
48501,10/1/19,3699,3585,114,3.1
48503,10/1/19,8105,7878,227,2.8
48505,10/1/19,4789,4545,244,5.1
48507,10/1/19,3352,3078,274,8.2
49001,10/1/19,2860,2799,61,2.1
49003,10/1/19,26129,25592,537,2.1
49005,10/1/19,65179,64052,1127,1.7
49007,10/1/19,8645,8387,258,3
49009,10/1/19,401,387,14,3.5
49011,10/1/19,175167,171737,3430,2
49013,10/1/19,7802,7561,241,3.1
49015,10/1/19,4266,4143,123,2.9
49017,10/1/19,2886,2806,80,2.8
49019,10/1/19,6389,6266,123,1.9
49021,10/1/19,24754,24187,567,2.3
49023,10/1/19,5801,5699,102,1.8
49025,10/1/19,3849,3770,79,2.1
49027,10/1/19,6018,5886,132,2.2
49029,10/1/19,5603,5502,101,1.8
49031,10/1/19,493,474,19,3.9
49033,10/1/19,1120,1090,30,2.7
49035,10/1/19,640368,627077,13291,2.1
49037,10/1/19,5778,5567,211,3.7
49039,10/1/19,12585,12270,315,2.5
49041,10/1/19,9751,9531,220,2.3
49043,10/1/19,23854,23303,551,2.3
49045,10/1/19,34249,33443,806,2.4
49047,10/1/19,13634,13151,483,3.5
49049,10/1/19,313159,307087,6072,1.9
49051,10/1/19,16154,15778,376,2.3
49053,10/1/19,77355,75516,1839,2.4
49055,10/1/19,1463,1422,41,2.8
49057,10/1/19,128164,125332,2832,2.2
50001,10/1/19,20436,20111,325,1.6
50003,10/1/19,17678,17294,384,2.2
50005,10/1/19,14452,14159,293,2
50007,10/1/19,96471,95136,1335,1.4
50009,10/1/19,2648,2597,51,1.9
50011,10/1/19,27195,26748,447,1.6
50013,10/1/19,4020,3942,78,1.9
50015,10/1/19,13814,13520,294,2.1
50017,10/1/19,15781,15539,242,1.5
50019,10/1/19,13002,12636,366,2.8
50021,10/1/19,30019,29420,599,2
50023,10/1/19,34066,33539,527,1.5
50025,10/1/19,21545,21150,395,1.8
50027,10/1/19,28243,27782,461,1.6
51001,10/1/19,16747,16269,478,2.9
51003,10/1/19,58209,56909,1300,2.2
51005,10/1/19,6960,6750,210,3
51007,10/1/19,6369,6203,166,2.6
51009,10/1/19,15304,14862,442,2.9
51011,10/1/19,7291,7071,220,3
51013,10/1/19,157251,154505,2746,1.7
51015,10/1/19,38235,37379,856,2.2
51017,10/1/19,2552,2497,55,2.2
51019,10/1/19,39086,38069,1017,2.6
51021,10/1/19,2856,2790,66,2.3
51023,10/1/19,17601,17182,419,2.4
51025,10/1/19,6073,5821,252,4.1
51027,10/1/19,6686,6318,368,5.5
51029,10/1/19,6487,6291,196,3
51031,10/1/19,26423,25680,743,2.8
51033,10/1/19,15469,15023,446,2.9
51035,10/1/19,13312,12885,427,3.2
51036,10/1/19,3726,3620,106,2.8
51037,10/1/19,5378,5186,192,3.6
51041,10/1/19,190224,185445,4779,2.5
51043,10/1/19,7759,7590,169,2.2
51045,10/1/19,2318,2254,64,2.8
51047,10/1/19,25020,24439,581,2.3
51049,10/1/19,4682,4556,126,2.7
51051,10/1/19,4822,4603,219,4.5
51053,10/1/19,13846,13442,404,2.9
51057,10/1/19,5517,5345,172,3.1
51059,10/1/19,646163,632820,13343,2.1
51061,10/1/19,37992,37192,800,2.1
51063,10/1/19,8127,7941,186,2.3
51065,10/1/19,14133,13840,293,2.1
51067,10/1/19,26669,25943,726,2.7
51069,10/1/19,49145,48109,1036,2.1
51071,10/1/19,7765,7546,219,2.8
51073,10/1/19,19777,19313,464,2.3
51075,10/1/19,11358,11077,281,2.5
51077,10/1/19,8131,7924,207,2.5
51079,10/1/19,10671,10442,229,2.1
51081,10/1/19,4303,4170,133,3.1
51083,10/1/19,15678,15096,582,3.7
51085,10/1/19,60163,58827,1336,2.2
51087,10/1/19,184705,179954,4751,2.6
51089,10/1/19,23849,23124,725,3
51091,10/1/19,1240,1210,30,2.4
51093,10/1/19,19632,19130,502,2.6
51095,10/1/19,36892,36004,888,2.4
51097,10/1/19,3868,3781,87,2.2
51099,10/1/19,13669,13341,328,2.4
51101,10/1/19,9288,9048,240,2.6
51103,10/1/19,5469,5318,151,2.8
51105,10/1/19,8302,7979,323,3.9
51107,10/1/19,226780,222067,4713,2.1
51109,10/1/19,20307,19823,484,2.4
51111,10/1/19,5338,5185,153,2.9
51113,10/1/19,7626,7475,151,2
51115,10/1/19,4176,4065,111,2.7
51117,10/1/19,12504,12026,478,3.8
51119,10/1/19,5351,5230,121,2.3
51121,10/1/19,49344,48068,1276,2.6
51125,10/1/19,7552,7377,175,2.3
51127,10/1/19,12656,12389,267,2.1
51131,10/1/19,5551,5373,178,3.2
51133,10/1/19,5696,5525,171,3
51135,10/1/19,7358,7163,195,2.7
51137,10/1/19,17717,17233,484,2.7
51139,10/1/19,12223,11885,338,2.8
51141,10/1/19,7276,7048,228,3.1
51143,10/1/19,30458,29521,937,3.1
51145,10/1/19,14332,14000,332,2.3
51147,10/1/19,10397,10063,334,3.2
51149,10/1/19,15332,14841,491,3.2
51153,10/1/19,250024,244346,5678,2.3
51155,10/1/19,15780,15304,476,3
51157,10/1/19,3750,3668,82,2.2
51159,10/1/19,4119,4014,105,2.5
51161,10/1/19,49804,48630,1174,2.4
51163,10/1/19,10983,10716,267,2.4
51165,10/1/19,43157,42295,862,2
51167,10/1/19,11329,10923,406,3.6
51169,10/1/19,9205,8952,253,2.7
51171,10/1/19,22602,22099,503,2.2
51173,10/1/19,13935,13426,509,3.7
51175,10/1/19,9243,9008,235,2.5
51177,10/1/19,68255,66472,1783,2.6
51179,10/1/19,73443,71594,1849,2.5
51181,10/1/19,3756,3645,111,3
51183,10/1/19,3908,3751,157,4
51185,10/1/19,15763,15128,635,4
51187,10/1/19,20766,20246,520,2.5
51191,10/1/19,26949,26164,785,2.9
51193,10/1/19,9621,9350,271,2.8
51195,10/1/19,13515,12949,566,4.2
51197,10/1/19,13821,13366,455,3.3
51199,10/1/19,33052,32260,792,2.4
51510,10/1/19,103167,101198,1969,1.9
51520,10/1/19,7230,6981,249,3.4
51530,10/1/19,3653,3569,84,2.3
51540,10/1/19,26862,26313,549,2
51550,10/1/19,123888,120588,3300,2.7
51570,10/1/19,8947,8667,280,3.1
51580,10/1/19,2410,2322,88,3.7
51590,10/1/19,19268,18406,862,4.5
51595,10/1/19,2283,2192,91,4
51600,10/1/19,13681,13414,267,2
51610,10/1/19,8744,8581,163,1.9
51620,10/1/19,3603,3464,139,3.9
51630,10/1/19,14389,13964,425,3
51640,10/1/19,2919,2838,81,2.8
51650,10/1/19,64892,62669,2223,3.4
51660,10/1/19,25648,24955,693,2.7
51670,10/1/19,9816,9434,382,3.9
51678,10/1/19,2129,2039,90,4.2
51680,10/1/19,36902,35715,1187,3.2
51683,10/1/19,22414,21929,485,2.2
51685,10/1/19,9524,9317,207,2.2
51690,10/1/19,5506,5289,217,3.9
51700,10/1/19,89557,86745,2812,3.1
51710,10/1/19,112518,109028,3490,3.1
51720,10/1/19,1691,1637,54,3.2
51730,10/1/19,13179,12510,669,5.1
51735,10/1/19,6463,6316,147,2.3
51740,10/1/19,44631,43032,1599,3.6
51750,10/1/19,8491,8229,262,3.1
51760,10/1/19,119924,116325,3599,3
51770,10/1/19,49535,48167,1368,2.8
51775,10/1/19,13085,12757,328,2.5
51790,10/1/19,12443,12139,304,2.4
51800,10/1/19,45076,43817,1259,2.8
51810,10/1/19,235102,229249,5853,2.5
51820,10/1/19,10870,10581,289,2.7
51830,10/1/19,6734,6499,235,3.5
51840,10/1/19,15122,14752,370,2.4
53001,10/1/19,10414,10025,389,3.7
53003,10/1/19,10609,10250,359,3.4
53005,10/1/19,104670,100330,4340,4.1
53007,10/1/19,45754,44107,1647,3.6
53009,10/1/19,29300,27703,1597,5.5
53011,10/1/19,244960,234661,10299,4.2
53013,10/1/19,1883,1800,83,4.4
53015,10/1/19,48321,45832,2489,5.2
53017,10/1/19,22452,21534,918,4.1
53019,10/1/19,2413,2200,213,8.8
53021,10/1/19,43354,41360,1994,4.6
53023,10/1/19,945,902,43,4.6
53025,10/1/19,47617,45227,2390,5
53027,10/1/19,29248,27518,1730,5.9
53029,10/1/19,36951,35358,1593,4.3
53031,10/1/19,13304,12681,623,4.7
53033,10/1/19,1290236,1256592,33644,2.6
53035,10/1/19,130423,125361,5062,3.9
53037,10/1/19,24612,23542,1070,4.3
53039,10/1/19,10417,9945,472,4.5
53041,10/1/19,35291,33470,1821,5.2
53043,10/1/19,5022,4812,210,4.2
53045,10/1/19,26530,25169,1361,5.1
53047,10/1/19,20564,19604,960,4.7
53049,10/1/19,8636,8110,526,6.1
53051,10/1/19,5144,4793,351,6.8
53053,10/1/19,448395,428436,19959,4.5
53055,10/1/19,8751,8471,280,3.2
53057,10/1/19,63801,60862,2939,4.6
53059,10/1/19,5602,5357,245,4.4
53061,10/1/19,439529,426954,12575,2.9
53063,10/1/19,258979,248088,10891,4.2
53065,10/1/19,19167,18194,973,5.1
53067,10/1/19,145859,139729,6130,4.2
53069,10/1/19,1389,1306,83,6
53071,10/1/19,31865,30626,1239,3.9
53073,10/1/19,116357,111328,5029,4.3
53075,10/1/19,25031,24041,990,4
53077,10/1/19,137142,130792,6350,4.6
54001,10/1/19,7460,7055,405,5.4
54003,10/1/19,59761,57853,1908,3.2
54005,10/1/19,7514,7102,412,5.5
54007,10/1/19,5301,4944,357,6.7
54009,10/1/19,10155,9616,539,5.3
54011,10/1/19,42130,40513,1617,3.8
54013,10/1/19,2566,2275,291,11.3
54015,10/1/19,3162,2910,252,8
54017,10/1/19,4071,3886,185,4.5
54019,10/1/19,16494,15632,862,5.2
54021,10/1/19,2481,2325,156,6.3
54023,10/1/19,5997,5717,280,4.7
54025,10/1/19,16282,15580,702,4.3
54027,10/1/19,11007,10632,375,3.4
54029,10/1/19,13271,12577,694,5.2
54031,10/1/19,5840,5593,247,4.2
54033,10/1/19,34943,33462,1481,4.2
54035,10/1/19,13504,12881,623,4.6
54037,10/1/19,30788,29916,872,2.8
54039,10/1/19,82917,79391,3526,4.3
54041,10/1/19,6852,6390,462,6.7
54043,10/1/19,7304,6862,442,6.1
54045,10/1/19,11285,10628,657,5.8
54047,10/1/19,4442,4087,355,8
54049,10/1/19,25938,24688,1250,4.8
54051,10/1/19,14459,13602,857,5.9
54053,10/1/19,10435,9862,573,5.5
54055,10/1/19,21399,20277,1122,5.2
54057,10/1/19,12921,12173,748,5.8
54059,10/1/19,6994,6523,471,6.7
54061,10/1/19,56170,54282,1888,3.4
54063,10/1/19,6064,5832,232,3.8
54065,10/1/19,8301,8015,286,3.4
54067,10/1/19,9651,9078,573,5.9
54069,10/1/19,21762,20767,995,4.6
54071,10/1/19,3783,3669,114,3
54073,10/1/19,2962,2764,198,6.7
54075,10/1/19,3693,3505,188,5.1
54077,10/1/19,15978,15357,621,3.9
54079,10/1/19,27084,26038,1046,3.9
54081,10/1/19,30936,29598,1338,4.3
54083,10/1/19,12477,11823,654,5.2
54085,10/1/19,4477,4218,259,5.8
54087,10/1/19,5213,4758,455,8.7
54089,10/1/19,4429,4217,212,4.8
54091,10/1/19,8023,7665,358,4.5
54093,10/1/19,3408,3257,151,4.4
54095,10/1/19,3144,2917,227,7.2
54097,10/1/19,9753,9204,549,5.6
54099,10/1/19,16003,15217,786,4.9
54101,10/1/19,3399,3206,193,5.7
54103,10/1/19,6724,6255,469,7
54105,10/1/19,2346,2163,183,7.8
54107,10/1/19,37345,35588,1757,4.7
54109,10/1/19,6713,6296,417,6.2
55001,10/1/19,8086,7799,287,3.5
55003,10/1/19,8050,7755,295,3.7
55005,10/1/19,24227,23520,707,2.9
55007,10/1/19,7673,7402,271,3.5
55009,10/1/19,141834,138098,3736,2.6
55011,10/1/19,6411,6218,193,3
55013,10/1/19,7019,6757,262,3.7
55015,10/1/19,27400,26748,652,2.4
55017,10/1/19,33154,32223,931,2.8
55019,10/1/19,17477,17055,422,2.4
55021,10/1/19,31730,30939,791,2.5
55023,10/1/19,7572,7336,236,3.1
55025,10/1/19,324865,317924,6941,2.1
55027,10/1/19,47373,46161,1212,2.6
55029,10/1/19,15866,15470,396,2.5
55031,10/1/19,23075,22335,740,3.2
55033,10/1/19,24454,23820,634,2.6
55035,10/1/19,59134,57668,1466,2.5
55037,10/1/19,2213,2129,84,3.8
55039,10/1/19,57161,55742,1419,2.5
55041,10/1/19,3980,3838,142,3.6
55043,10/1/19,28260,27542,718,2.5
55045,10/1/19,21117,20656,461,2.2
55047,10/1/19,9334,9072,262,2.8
55049,10/1/19,13763,13474,289,2.1
55051,10/1/19,2551,2432,119,4.7
55053,10/1/19,10177,9882,295,2.9
55055,10/1/19,45674,44528,1146,2.5
55057,10/1/19,13356,13026,330,2.5
55059,10/1/19,89197,86132,3065,3.4
55061,10/1/19,10971,10709,262,2.4
55063,10/1/19,66525,64960,1565,2.4
55065,10/1/19,10035,9836,199,2
55067,10/1/19,9146,8843,303,3.3
55069,10/1/19,15030,14589,441,2.9
55071,10/1/19,40893,39739,1154,2.8
55073,10/1/19,73343,71555,1788,2.4
55075,10/1/19,19322,18571,751,3.9
55077,10/1/19,7715,7504,211,2.7
55078,10/1/19,1589,1482,107,6.7
55079,10/1/19,466945,450016,16929,3.6
55081,10/1/19,23271,22721,550,2.4
55083,10/1/19,20522,19952,570,2.8
55085,10/1/19,17469,16911,558,3.2
55087,10/1/19,102440,99943,2497,2.4
55089,10/1/19,49204,47972,1232,2.5
55091,10/1/19,4173,4060,113,2.7
55093,10/1/19,25299,24686,613,2.4
55095,10/1/19,24399,23729,670,2.7
55097,10/1/19,38909,37935,974,2.5
55099,10/1/19,6604,6305,299,4.5
55101,10/1/19,97840,94293,3547,3.6
55103,10/1/19,9132,8878,254,2.8
55105,10/1/19,84938,82178,2760,3.2
55107,10/1/19,6720,6474,246,3.7
55109,10/1/19,50489,49183,1306,2.6
55111,10/1/19,35201,34354,847,2.4
55113,10/1/19,8013,7740,273,3.4
55115,10/1/19,20790,20273,517,2.5
55117,10/1/19,61425,59912,1513,2.5
55119,10/1/19,10900,10633,267,2.4
55121,10/1/19,15848,15452,396,2.5
55123,10/1/19,15181,14785,396,2.6
55125,10/1/19,10132,9837,295,2.9
55127,10/1/19,58409,56861,1548,2.7
55129,10/1/19,7861,7619,242,3.1
55131,10/1/19,77172,75220,1952,2.5
55133,10/1/19,225034,219243,5791,2.6
55135,10/1/19,25565,24866,699,2.7
55137,10/1/19,11252,10885,367,3.3
55139,10/1/19,91238,88827,2411,2.6
55141,10/1/19,35116,34091,1025,2.9
56001,10/1/19,20899,20308,591,2.8
56003,10/1/19,5429,5232,197,3.6
56005,10/1/19,23334,22517,817,3.5
56007,10/1/19,8158,7926,232,2.8
56009,10/1/19,8968,8729,239,2.7
56011,10/1/19,3719,3615,104,2.8
56013,10/1/19,18833,18080,753,4
56015,10/1/19,6646,6405,241,3.6
56017,10/1/19,2130,2055,75,3.5
56019,10/1/19,4183,4059,124,3
56021,10/1/19,48535,46903,1632,3.4
56023,10/1/19,8912,8637,275,3.1
56025,10/1/19,39482,37994,1488,3.8
56027,10/1/19,1235,1204,31,2.5
56029,10/1/19,15358,14809,549,3.6
56031,10/1/19,4515,4375,140,3.1
56033,10/1/19,15613,15157,456,2.9
56035,10/1/19,4211,4023,188,4.5
56037,10/1/19,21155,20417,738,3.5
56039,10/1/19,15229,14808,421,2.8
56041,10/1/19,8985,8653,332,3.7
56043,10/1/19,3971,3832,139,3.5
56045,10/1/19,3814,3719,95,2.5
72001,10/1/19,4049,3451,598,14.8
72003,10/1/19,11567,10331,1236,10.7
72005,10/1/19,14181,12650,1531,10.8
72007,10/1/19,6419,5774,645,10
72009,10/1/19,6389,5700,689,10.8
72011,10/1/19,8568,7797,771,9
72013,10/1/19,23761,21279,2482,10.4
72015,10/1/19,4511,3879,632,14
72017,10/1/19,5846,5118,728,12.5
72019,10/1/19,7307,6610,697,9.5
72021,10/1/19,63473,59010,4463,7
72023,10/1/19,13386,12154,1232,9.2
72025,10/1/19,46519,43059,3460,7.4
72027,10/1/19,9409,8526,883,9.4
72029,10/1/19,15688,14508,1180,7.5
72031,10/1/19,59935,55925,4010,6.7
72033,10/1/19,7609,6988,621,8.2
72035,10/1/19,15646,14440,1206,7.7
72037,10/1/19,3581,3206,375,10.5
72039,10/1/19,3668,3220,448,12.2
72041,10/1/19,15061,13978,1083,7.2
72043,10/1/19,9812,8547,1265,12.9
72045,10/1/19,4822,4333,489,10.1
72047,10/1/19,8816,7941,875,9.9
72049,10/1/19,859,829,30,3.5
72051,10/1/19,12839,11992,847,6.6
72053,10/1/19,10631,9462,1169,11
72054,10/1/19,3264,2892,372,11.4
72055,10/1/19,4074,3379,695,17.1
72057,10/1/19,10777,9369,1408,13.1
72059,10/1/19,4816,4106,710,14.7
72061,10/1/19,36280,34546,1734,4.8
72063,10/1/19,17624,16511,1113,6.3
72065,10/1/19,13235,11732,1503,11.4
72067,10/1/19,5220,4746,474,9.1
72069,10/1/19,16712,14936,1776,10.6
72071,10/1/19,12072,10955,1117,9.3
72073,10/1/19,4178,3598,580,13.9
72075,10/1/19,14764,13131,1633,11.1
72077,10/1/19,12082,10967,1115,9.2
72079,10/1/19,5190,4488,702,13.5
72081,10/1/19,7044,6070,974,13.8
72083,10/1/19,2532,2220,312,12.3
72085,10/1/19,11072,9972,1100,9.9
72087,10/1/19,8288,7554,734,8.9
72089,10/1/19,6029,5410,619,10.3
72091,10/1/19,11318,10315,1003,8.9
72093,10/1/19,1883,1643,240,12.7
72095,10/1/19,2824,2428,396,14
72097,10/1/19,21252,18874,2378,11.2
72099,10/1/19,10189,9089,1100,10.8
72101,10/1/19,7876,7077,799,10.1
72103,10/1/19,7962,7180,782,9.8
72105,10/1/19,6988,6310,678,9.7
72107,10/1/19,4840,4322,518,10.7
72109,10/1/19,4110,3519,591,14.4
72111,10/1/19,5808,4916,892,15.4
72113,10/1/19,44405,39702,4703,10.6
72115,10/1/19,5935,5212,723,12.2
72117,10/1/19,4531,3957,574,12.7
72119,10/1/19,16572,15236,1336,8.1
72121,10/1/19,6164,5335,829,13.4
72123,10/1/19,7039,5902,1137,16.2
72125,10/1/19,9581,8459,1122,11.7
72127,10/1/19,129240,121050,8190,6.3
72129,10/1/19,11442,10377,1065,9.3
72131,10/1/19,10118,8749,1369,13.5
72133,10/1/19,8757,7575,1182,13.5
72135,10/1/19,26479,24738,1741,6.6
72137,10/1/19,28514,26641,1873,6.6
72139,10/1/19,26252,24834,1418,5.4
72141,10/1/19,6603,5797,806,12.2
72143,10/1/19,9570,8702,868,9.1
72145,10/1/19,13113,11725,1388,10.6
72147,10/1/19,2463,2281,182,7.4
72149,10/1/19,7227,6105,1122,15.5
72151,10/1/19,8673,7443,1230,14.2
72153,10/1/19,9713,8312,1401,14.4
1001,11/1/19,26086,25500,586,2.2
1003,11/1/19,96603,94405,2198,2.3
1005,11/1/19,8600,8323,277,3.2
1007,11/1/19,8720,8510,210,2.4
1009,11/1/19,25411,24851,560,2.2
1011,11/1/19,4759,4592,167,3.5
1013,11/1/19,9244,8945,299,3.2
1015,11/1/19,46408,45076,1332,2.9
1017,11/1/19,15873,15492,381,2.4
1019,11/1/19,11487,11218,269,2.3
1021,11/1/19,19898,19447,451,2.3
1023,11/1/19,4525,4343,182,4
1025,11/1/19,7409,7058,351,4.7
1027,11/1/19,6110,5962,148,2.4
1029,11/1/19,5757,5615,142,2.5
1031,11/1/19,21161,20663,498,2.4
1033,11/1/19,23719,23015,704,3
1035,11/1/19,4462,4316,146,3.3
1037,11/1/19,4516,4412,104,2.3
1039,11/1/19,15528,15115,413,2.7
1041,11/1/19,6388,6240,148,2.3
1043,11/1/19,38779,37959,820,2.1
1045,11/1/19,20668,20158,510,2.5
1047,11/1/19,14524,13913,611,4.2
1049,11/1/19,30847,30156,691,2.2
1051,11/1/19,37508,36673,835,2.2
1053,11/1/19,14802,14379,423,2.9
1055,11/1/19,42785,41622,1163,2.7
1057,11/1/19,6570,6402,168,2.6
1059,11/1/19,14752,14423,329,2.2
1061,11/1/19,10979,10722,257,2.3
1063,11/1/19,2866,2735,131,4.6
1065,11/1/19,6141,5953,188,3.1
1067,11/1/19,6915,6719,196,2.8
1069,11/1/19,46336,45207,1129,2.4
1071,11/1/19,23221,22583,638,2.7
1073,11/1/19,320792,313419,7373,2.3
1075,11/1/19,5842,5697,145,2.5
1077,11/1/19,42668,41570,1098,2.6
1079,11/1/19,14359,13998,361,2.5
1081,11/1/19,78204,76498,1706,2.2
1083,11/1/19,44197,43261,936,2.1
1085,11/1/19,3549,3384,165,4.6
1087,11/1/19,7915,7647,268,3.4
1089,11/1/19,186938,183118,3820,2
1091,11/1/19,7606,7381,225,3
1093,11/1/19,12815,12459,356,2.8
1095,11/1/19,43957,43067,890,2
1097,11/1/19,189712,184022,5690,3
1099,11/1/19,7306,6999,307,4.2
1101,11/1/19,105553,102883,2670,2.5
1103,11/1/19,58756,57506,1250,2.1
1105,11/1/19,3381,3247,134,4
1107,11/1/19,8002,7787,215,2.7
1109,11/1/19,15572,15146,426,2.7
1111,11/1/19,9658,9414,244,2.5
1113,11/1/19,24006,23421,585,2.4
1115,11/1/19,40749,39869,880,2.2
1117,11/1/19,116853,114752,2101,1.8
1119,11/1/19,4866,4676,190,3.9
1121,11/1/19,35651,34669,982,2.8
1123,11/1/19,18546,18095,451,2.4
1125,11/1/19,106921,104576,2345,2.2
1127,11/1/19,25446,24751,695,2.7
1129,11/1/19,6777,6534,243,3.6
1131,11/1/19,2717,2551,166,6.1
1133,11/1/19,10100,9813,287,2.8
2013,11/1/19,1401,1329,72,5.1
2016,11/1/19,2848,2701,147,5.2
2020,11/1/19,148116,140837,7279,4.9
2050,11/1/19,7179,6368,811,11.3
2060,11/1/19,247,217,30,12.1
2068,11/1/19,584,488,96,16.4
2070,11/1/19,1690,1556,134,7.9
2090,11/1/19,44677,42301,2376,5.3
2100,11/1/19,970,839,131,13.5
2105,11/1/19,991,850,141,14.2
2110,11/1/19,16521,15788,733,4.4
2122,11/1/19,25292,23470,1822,7.2
2130,11/1/19,6476,6028,448,6.9
2150,11/1/19,5809,5477,332,5.7
2158,11/1/19,2676,2244,432,16.1
2164,11/1/19,605,551,54,8.9
2170,11/1/19,47112,44023,3089,6.6
2180,11/1/19,4123,3737,386,9.4
2185,11/1/19,3475,3253,222,6.4
2188,11/1/19,3147,2715,432,13.7
2195,11/1/19,1287,1170,117,9.1
2198,11/1/19,2828,2577,251,8.9
2220,11/1/19,4017,3833,184,4.6
2230,11/1/19,618,498,120,19.4
2240,11/1/19,2865,2626,239,8.3
2261,11/1/19,4267,3835,432,10.1
2275,11/1/19,988,909,79,8
2282,11/1/19,229,211,18,7.9
2290,11/1/19,2444,2143,301,12.3
4001,11/1/19,20279,18471,1808,8.9
4003,11/1/19,51708,48998,2710,5.2
4005,11/1/19,78173,74463,3710,4.7
4007,11/1/19,21765,20573,1192,5.5
4009,11/1/19,15666,14998,668,4.3
4011,11/1/19,4549,4389,160,3.5
4012,11/1/19,9709,9218,491,5.1
4013,11/1/19,2356073,2270551,85522,3.6
4015,11/1/19,88701,84012,4689,5.3
4017,11/1/19,41114,38458,2656,6.5
4019,11/1/19,504426,483933,20493,4.1
4021,11/1/19,192465,183669,8796,4.6
4023,11/1/19,19882,18276,1606,8.1
4025,11/1/19,108301,103823,4478,4.1
4027,11/1/19,102376,86784,15592,15.2
5001,11/1/19,9385,9129,256,2.7
5003,11/1/19,7566,7196,370,4.9
5005,11/1/19,16191,15639,552,3.4
5007,11/1/19,138707,135615,3092,2.2
5009,11/1/19,16031,15588,443,2.8
5011,11/1/19,4453,4307,146,3.3
5013,11/1/19,2443,2352,91,3.7
5015,11/1/19,12720,12402,318,2.5
5017,11/1/19,3239,3053,186,5.7
5019,11/1/19,9803,9483,320,3.3
5021,11/1/19,5613,5368,245,4.4
5023,11/1/19,9092,8709,383,4.2
5025,11/1/19,3213,3098,115,3.6
5027,11/1/19,9224,8868,356,3.9
5029,11/1/19,8289,7991,298,3.6
5031,11/1/19,56299,55005,1294,2.3
5033,11/1/19,26895,26153,742,2.8
5035,11/1/19,21511,20765,746,3.5
5037,11/1/19,7394,7120,274,3.7
5039,11/1/19,2831,2714,117,4.1
5041,11/1/19,5410,5200,210,3.9
5043,11/1/19,7935,7572,363,4.6
5045,11/1/19,62075,60443,1632,2.6
5047,11/1/19,7457,7239,218,2.9
5049,11/1/19,4925,4770,155,3.1
5051,11/1/19,40659,39335,1324,3.3
5053,11/1/19,8379,8134,245,2.9
5055,11/1/19,20052,19444,608,3
5057,11/1/19,9869,9544,325,3.3
5059,11/1/19,13983,13549,434,3.1
5061,11/1/19,5698,5537,161,2.8
5063,11/1/19,16553,15952,601,3.6
5065,11/1/19,4862,4620,242,5
5067,11/1/19,5830,5484,346,5.9
5069,11/1/19,27654,26303,1351,4.9
5071,11/1/19,10263,9900,363,3.5
5073,11/1/19,2450,2350,100,4.1
5075,11/1/19,6868,6617,251,3.7
5077,11/1/19,2820,2701,119,4.2
5079,11/1/19,3927,3782,145,3.7
5081,11/1/19,5541,5329,212,3.8
5083,11/1/19,8532,8196,336,3.9
5085,11/1/19,34303,33315,988,2.9
5087,11/1/19,7490,7329,161,2.1
5089,11/1/19,6573,6354,219,3.3
5091,11/1/19,19772,19082,690,3.5
5093,11/1/19,17233,16530,703,4.1
5095,11/1/19,2718,2611,107,3.9
5097,11/1/19,2891,2766,125,4.3
5099,11/1/19,3625,3504,121,3.3
5101,11/1/19,3323,3224,99,3
5103,11/1/19,9787,9355,432,4.4
5105,11/1/19,4221,4087,134,3.2
5107,11/1/19,6306,5961,345,5.5
5109,11/1/19,4204,4059,145,3.4
5111,11/1/19,10391,10089,302,2.9
5113,11/1/19,8151,7823,328,4
5115,11/1/19,28922,27905,1017,3.5
5117,11/1/19,3576,3443,133,3.7
5119,11/1/19,189276,183501,5775,3.1
5121,11/1/19,7345,7106,239,3.3
5123,11/1/19,8111,7766,345,4.3
5125,11/1/19,58825,57355,1470,2.5
5127,11/1/19,4307,4175,132,3.1
5129,11/1/19,2814,2698,116,4.1
5131,11/1/19,56702,55087,1615,2.8
5133,11/1/19,5498,5275,223,4.1
5135,11/1/19,5681,5428,253,4.5
5137,11/1/19,4623,4433,190,4.1
5139,11/1/19,15776,15011,765,4.8
5141,11/1/19,5662,5415,247,4.4
5143,11/1/19,126299,123692,2607,2.1
5145,11/1/19,33758,32436,1322,3.9
5147,11/1/19,2753,2625,128,4.6
5149,11/1/19,8415,8160,255,3
6001,11/1/19,846991,824242,22749,2.7
6003,11/1/19,500,475,25,5
6005,11/1/19,14937,14423,514,3.4
6007,11/1/19,99254,95082,4172,4.2
6009,11/1/19,21596,20875,721,3.3
6011,11/1/19,10587,9456,1131,10.7
6013,11/1/19,563394,547608,15786,2.8
6015,11/1/19,9613,9084,529,5.5
6017,11/1/19,92397,89507,2890,3.1
6019,11/1/19,448416,418471,29945,6.7
6021,11/1/19,12946,12329,617,4.8
6023,11/1/19,63086,61123,1963,3.1
6025,11/1/19,72396,58890,13506,18.7
6027,11/1/19,8774,8503,271,3.1
6029,11/1/19,395137,369899,25238,6.4
6031,11/1/19,57402,53245,4157,7.2
6033,11/1/19,28793,27417,1376,4.8
6035,11/1/19,10318,9957,361,3.5
6037,11/1/19,5177117,4963388,213729,4.1
6039,11/1/19,60686,56929,3757,6.2
6041,11/1/19,140995,138064,2931,2.1
6043,11/1/19,7321,7023,298,4.1
6045,11/1/19,38558,37219,1339,3.5
6047,11/1/19,115475,107741,7734,6.7
6049,11/1/19,3110,2934,176,5.7
6051,11/1/19,7915,7601,314,4
6053,11/1/19,219427,209156,10271,4.7
6055,11/1/19,73640,71720,1920,2.6
6057,11/1/19,48473,47039,1434,3
6059,11/1/19,1630097,1588311,41786,2.6
6061,11/1/19,188849,183568,5281,2.8
6063,11/1/19,7576,7113,463,6.1
6065,11/1/19,1116161,1073080,43081,3.9
6067,11/1/19,715263,691610,23653,3.3
6069,11/1/19,31388,30015,1373,4.4
6071,11/1/19,978931,944748,34183,3.5
6073,11/1/19,1600077,1553350,46727,2.9
6075,11/1/19,589758,578050,11708,2
6077,11/1/19,325674,308123,17551,5.4
6079,11/1/19,142044,138410,3634,2.6
6081,11/1/19,465463,456745,8718,1.9
6083,11/1/19,218458,211469,6989,3.2
6085,11/1/19,1059219,1034732,24487,2.3
6087,11/1/19,141792,136149,5643,4
6089,11/1/19,74708,71735,2973,4
6091,11/1/19,1331,1278,53,4
6093,11/1/19,17105,16237,868,5.1
6095,11/1/19,210399,203373,7026,3.3
6097,11/1/19,260583,254278,6305,2.4
6099,11/1/19,243932,231079,12853,5.3
6101,11/1/19,46099,43323,2776,6
6103,11/1/19,25804,24637,1167,4.5
6105,11/1/19,4562,4334,228,5
6107,11/1/19,203387,185782,17605,8.7
6109,11/1/19,21484,20671,813,3.8
6111,11/1/19,425979,411300,14679,3.4
6113,11/1/19,108509,104533,3976,3.7
6115,11/1/19,30724,29143,1581,5.1
8001,11/1/19,277792,270957,6835,2.5
8003,11/1/19,9008,8739,269,3
8005,11/1/19,371176,362520,8656,2.3
8007,11/1/19,6984,6799,185,2.6
8009,11/1/19,2259,2228,31,1.4
8011,11/1/19,2029,1987,42,2.1
8013,11/1/19,198526,194571,3955,2
8014,11/1/19,40908,40035,873,2.1
8015,11/1/19,9730,9522,208,2.1
8017,11/1/19,1266,1251,15,1.2
8019,11/1/19,6149,6025,124,2
8021,11/1/19,4324,4210,114,2.6
8023,11/1/19,1943,1885,58,3
8025,11/1/19,1580,1527,53,3.4
8027,11/1/19,2150,2094,56,2.6
8029,11/1/19,14898,14506,392,2.6
8031,11/1/19,424326,414573,9753,2.3
8033,11/1/19,1216,1177,39,3.2
8035,11/1/19,197886,193833,4053,2
8037,11/1/19,35923,35036,887,2.5
8039,11/1/19,15582,15292,290,1.9
8041,11/1/19,346325,336623,9702,2.8
8043,11/1/19,15228,14643,585,3.8
8045,11/1/19,31995,31235,760,2.4
8047,11/1/19,3842,3766,76,2
8049,11/1/19,9687,9500,187,1.9
8051,11/1/19,11278,11043,235,2.1
8053,11/1/19,362,345,17,4.7
8055,11/1/19,2534,2420,114,4.5
8057,11/1/19,1063,1046,17,1.6
8059,11/1/19,341063,333677,7386,2.2
8061,11/1/19,1042,1030,12,1.2
8063,11/1/19,4526,4459,67,1.5
8065,11/1/19,4930,4831,99,2
8067,11/1/19,32522,31851,671,2.1
8069,11/1/19,211387,207242,4145,2
8071,11/1/19,6778,6570,208,3.1
8073,11/1/19,2469,2422,47,1.9
8075,11/1/19,11396,11188,208,1.8
8077,11/1/19,76804,74643,2161,2.8
8079,11/1/19,515,504,11,2.1
8081,11/1/19,7442,7242,200,2.7
8083,11/1/19,13145,12677,468,3.6
8085,11/1/19,22504,21947,557,2.5
8087,11/1/19,17182,16804,378,2.2
8089,11/1/19,8836,8553,283,3.2
8091,11/1/19,2378,2311,67,2.8
8093,11/1/19,11320,11094,226,2
8095,11/1/19,2742,2707,35,1.3
8097,11/1/19,11284,10712,572,5.1
8099,11/1/19,6700,6560,140,2.1
8101,11/1/19,77322,74621,2701,3.5
8103,11/1/19,3078,2988,90,2.9
8105,11/1/19,5757,5556,201,3.5
8107,11/1/19,16397,16061,336,2
8109,11/1/19,3823,3694,129,3.4
8111,11/1/19,456,439,17,3.7
8113,11/1/19,5639,5334,305,5.4
8115,11/1/19,1305,1286,19,1.5
8117,11/1/19,23589,23211,378,1.6
8119,11/1/19,12885,12549,336,2.6
8121,11/1/19,3066,3013,53,1.7
8123,11/1/19,173704,169903,3801,2.2
8125,11/1/19,6408,6323,85,1.3
9001,11/1/19,484305,468798,15507,3.2
9003,11/1/19,487079,470584,16495,3.4
9005,11/1/19,105592,102517,3075,2.9
9007,11/1/19,94673,92004,2669,2.8
9009,11/1/19,466275,450233,16042,3.4
9011,11/1/19,137708,133325,4383,3.2
9013,11/1/19,87716,85293,2423,2.8
9015,11/1/19,64587,62404,2183,3.4
10001,11/1/19,80546,77516,3030,3.8
10003,11/1/19,301843,291497,10346,3.4
10005,11/1/19,106019,102105,3914,3.7
11001,11/1/19,412346,391565,20781,5
12001,11/1/19,141612,137984,3628,2.6
12003,11/1/19,12016,11696,320,2.7
12005,11/1/19,82497,80002,2495,3
12007,11/1/19,11274,10960,314,2.8
12009,11/1/19,287508,279290,8218,2.9
12011,11/1/19,1045634,1016914,28720,2.7
12013,11/1/19,4792,4623,169,3.5
12015,11/1/19,72707,70295,2412,3.3
12017,11/1/19,47355,45311,2044,4.3
12019,11/1/19,109361,106411,2950,2.7
12021,11/1/19,183572,178439,5133,2.8
12023,11/1/19,30344,29506,838,2.8
12027,11/1/19,14077,13614,463,3.3
12029,11/1/19,5885,5687,198,3.4
12031,11/1/19,498839,484540,14299,2.9
12033,11/1/19,146791,142567,4224,2.9
12035,11/1/19,47140,45506,1634,3.5
12037,11/1/19,4539,4409,130,2.9
12039,11/1/19,19040,18340,700,3.7
12041,11/1/19,7261,7040,221,3
12043,11/1/19,5445,5253,192,3.5
12045,11/1/19,5633,5430,203,3.6
12047,11/1/19,4303,4144,159,3.7
12049,11/1/19,8590,8223,367,4.3
12051,11/1/19,15757,14932,825,5.2
12053,11/1/19,72587,69855,2732,3.8
12055,11/1/19,36302,34829,1473,4.1
12057,11/1/19,758798,738009,20789,2.7
12059,11/1/19,7019,6801,218,3.1
12061,11/1/19,66003,63762,2241,3.4
12063,11/1/19,17154,16619,535,3.1
12065,11/1/19,5698,5532,166,2.9
12067,11/1/19,2848,2773,75,2.6
12069,11/1/19,160461,155798,4663,2.9
12071,11/1/19,352406,342558,9848,2.8
12073,11/1/19,157670,153458,4212,2.7
12075,11/1/19,16826,16286,540,3.2
12077,11/1/19,2651,2567,84,3.2
12079,11/1/19,7558,7302,256,3.4
12081,11/1/19,181260,176130,5130,2.8
12083,11/1/19,138518,133766,4752,3.4
12085,11/1/19,74608,72532,2076,2.8
12086,11/1/19,1384486,1360307,24179,1.7
12087,11/1/19,47312,46455,857,1.8
12089,11/1/19,41812,40711,1101,2.6
12091,11/1/19,96354,94012,2342,2.4
12093,11/1/19,18084,17552,532,2.9
12095,11/1/19,769251,749379,19872,2.6
12097,11/1/19,185845,180369,5476,2.9
12099,11/1/19,735547,713976,21571,2.9
12101,11/1/19,240277,232699,7578,3.2
12103,11/1/19,499256,485870,13386,2.7
12105,11/1/19,309867,299722,10145,3.3
12107,11/1/19,26528,25481,1047,3.9
12109,11/1/19,134295,131178,3117,2.3
12111,11/1/19,145879,140731,5148,3.5
12113,11/1/19,83474,81262,2212,2.6
12115,11/1/19,189959,184684,5275,2.8
12117,11/1/19,257685,250970,6715,2.6
12119,11/1/19,32923,31536,1387,4.2
12121,11/1/19,18093,17538,555,3.1
12123,11/1/19,8260,7999,261,3.2
12125,11/1/19,4685,4560,125,2.7
12127,11/1/19,255129,247097,8032,3.1
12129,11/1/19,15140,14753,387,2.6
12131,11/1/19,31401,30593,808,2.6
12133,11/1/19,9618,9331,287,3
13001,11/1/19,9446,9179,267,2.8
13003,11/1/19,4659,4561,98,2.1
13005,11/1/19,4904,4744,160,3.3
13007,11/1/19,1175,1125,50,4.3
13009,11/1/19,17498,16829,669,3.8
13011,11/1/19,9810,9585,225,2.3
13013,11/1/19,40722,39817,905,2.2
13015,11/1/19,50944,49598,1346,2.6
13017,11/1/19,5309,5048,261,4.9
13019,11/1/19,7578,7249,329,4.3
13021,11/1/19,67773,65678,2095,3.1
13023,11/1/19,4488,4306,182,4.1
13025,11/1/19,7221,6986,235,3.3
13027,11/1/19,6973,6766,207,3
13029,11/1/19,18254,17814,440,2.4
13031,11/1/19,36610,35546,1064,2.9
13033,11/1/19,9120,8750,370,4.1
13035,11/1/19,10805,10530,275,2.5
13037,11/1/19,2298,2233,65,2.8
13039,11/1/19,20785,20193,592,2.8
13043,11/1/19,5596,5475,121,2.2
13045,11/1/19,55619,54095,1524,2.7
13047,11/1/19,33711,32928,783,2.3
13049,11/1/19,4803,4662,141,2.9
13051,11/1/19,139356,135608,3748,2.7
13053,11/1/19,1986,1920,66,3.3
13055,11/1/19,10126,9789,337,3.3
13057,11/1/19,136973,134008,2965,2.2
13059,11/1/19,59528,57894,1634,2.7
13061,11/1/19,885,829,56,6.3
13063,11/1/19,138659,133901,4758,3.4
13065,11/1/19,2516,2432,84,3.3
13067,11/1/19,428712,418510,10202,2.4
13069,11/1/19,18866,18293,573,3
13071,11/1/19,21313,20784,529,2.5
13073,11/1/19,75101,73290,1811,2.4
13075,11/1/19,8062,7815,247,3.1
13077,11/1/19,75185,73460,1725,2.3
13079,11/1/19,5603,5443,160,2.9
13081,11/1/19,9394,9098,296,3.2
13083,11/1/19,8247,8036,211,2.6
13085,11/1/19,12407,12141,266,2.1
13087,11/1/19,11545,11185,360,3.1
13089,11/1/19,402308,391250,11058,2.7
13091,11/1/19,7008,6690,318,4.5
13093,11/1/19,5095,4940,155,3
13095,11/1/19,38413,36889,1524,4
13097,11/1/19,73794,71656,2138,2.9
13099,11/1/19,4452,4299,153,3.4
13101,11/1/19,1931,1887,44,2.3
13103,11/1/19,30848,30127,721,2.3
13105,11/1/19,7649,7388,261,3.4
13107,11/1/19,8249,7901,348,4.2
13109,11/1/19,4896,4764,132,2.7
13111,11/1/19,11480,11172,308,2.7
13113,11/1/19,58444,57070,1374,2.4
13115,11/1/19,44454,43050,1404,3.2
13117,11/1/19,123107,120452,2655,2.2
13119,11/1/19,9845,9558,287,2.9
13121,11/1/19,561031,545359,15672,2.8
13123,11/1/19,11882,11549,333,2.8
13125,11/1/19,1276,1237,39,3.1
13127,11/1/19,39134,38099,1035,2.6
13129,11/1/19,27929,27149,780,2.8
13131,11/1/19,10388,10091,297,2.9
13133,11/1/19,6893,6678,215,3.1
13135,11/1/19,493509,481670,11839,2.4
13137,11/1/19,19110,18476,634,3.3
13139,11/1/19,102867,100620,2247,2.2
13141,11/1/19,2474,2339,135,5.5
13143,11/1/19,12664,12314,350,2.8
13145,11/1/19,16638,16240,398,2.4
13147,11/1/19,10955,10628,327,3
13149,11/1/19,5293,5147,146,2.8
13151,11/1/19,116305,113041,3264,2.8
13153,11/1/19,70316,68448,1868,2.7
13155,11/1/19,3344,3222,122,3.6
13157,11/1/19,37669,36909,760,2
13159,11/1/19,6997,6824,173,2.5
13161,11/1/19,5941,5719,222,3.7
13163,11/1/19,6603,6346,257,3.9
13165,11/1/19,3106,2993,113,3.6
13167,11/1/19,3978,3861,117,2.9
13169,11/1/19,13722,13355,367,2.7
13171,11/1/19,8280,8025,255,3.1
13173,11/1/19,3773,3648,125,3.3
13175,11/1/19,18874,18118,756,4
13177,11/1/19,14804,14418,386,2.6
13179,11/1/19,26246,25429,817,3.1
13181,11/1/19,3556,3444,112,3.1
13183,11/1/19,8176,7942,234,2.9
13185,11/1/19,51538,50015,1523,3
13187,11/1/19,16881,16481,400,2.4
13189,11/1/19,8844,8453,391,4.4
13191,11/1/19,6133,5968,165,2.7
13193,11/1/19,4678,4510,168,3.6
13195,11/1/19,13406,13077,329,2.5
13197,11/1/19,3294,3186,108,3.3
13199,11/1/19,8961,8634,327,3.6
13201,11/1/19,2763,2685,78,2.8
13205,11/1/19,8587,8218,369,4.3
13207,11/1/19,13000,12661,339,2.6
13209,11/1/19,3764,3615,149,4
13211,11/1/19,9314,9084,230,2.5
13213,11/1/19,15363,14678,685,4.5
13215,11/1/19,77219,74413,2806,3.6
13217,11/1/19,52531,50917,1614,3.1
13219,11/1/19,19691,19308,383,1.9
13221,11/1/19,6992,6815,177,2.5
13223,11/1/19,86643,84611,2032,2.3
13225,11/1/19,11803,11428,375,3.2
13227,11/1/19,15394,15031,363,2.4
13229,11/1/19,8679,8446,233,2.7
13231,11/1/19,8971,8755,216,2.4
13233,11/1/19,18499,17954,545,2.9
13235,11/1/19,4040,3926,114,2.8
13237,11/1/19,8191,7920,271,3.3
13239,11/1/19,795,759,36,4.5
13241,11/1/19,7121,6901,220,3.1
13243,11/1/19,2536,2432,104,4.1
13245,11/1/19,84814,81721,3093,3.6
13247,11/1/19,45036,43682,1354,3
13249,11/1/19,2228,2159,69,3.1
13251,11/1/19,5034,4831,203,4
13253,11/1/19,3008,2906,102,3.4
13255,11/1/19,28840,27929,911,3.2
13257,11/1/19,10620,10279,341,3.2
13259,11/1/19,2422,2344,78,3.2
13261,11/1/19,12840,12333,507,3.9
13263,11/1/19,2797,2700,97,3.5
13265,11/1/19,566,535,31,5.5
13267,11/1/19,9535,9250,285,3
13269,11/1/19,3160,3055,105,3.3
13271,11/1/19,3854,3498,356,9.2
13273,11/1/19,3492,3369,123,3.5
13275,11/1/19,16345,15774,571,3.5
13277,11/1/19,19937,19390,547,2.7
13279,11/1/19,11525,11101,424,3.7
13281,11/1/19,3885,3729,156,4
13283,11/1/19,2546,2444,102,4
13285,11/1/19,37302,36307,995,2.7
13287,11/1/19,3135,3033,102,3.3
13289,11/1/19,2867,2741,126,4.4
13291,11/1/19,10276,10028,248,2.4
13293,11/1/19,11357,11010,347,3.1
13295,11/1/19,31449,30629,820,2.6
13297,11/1/19,46375,45249,1126,2.4
13299,11/1/19,15525,15060,465,3
13301,11/1/19,2849,2741,108,3.8
13303,11/1/19,7030,6786,244,3.5
13305,11/1/19,11241,10884,357,3.2
13307,11/1/19,1022,988,34,3.3
13309,11/1/19,1590,1485,105,6.6
13311,11/1/19,16456,16115,341,2.1
13313,11/1/19,43015,41486,1529,3.6
13315,11/1/19,2673,2581,92,3.4
13317,11/1/19,3789,3625,164,4.3
13319,11/1/19,3950,3818,132,3.3
13321,11/1/19,8927,8649,278,3.1
15001,11/1/19,92013,88991,3022,3.3
15003,11/1/19,452986,441863,11123,2.5
15007,11/1/19,36536,35504,1032,2.8
15009,11/1/19,86322,84155,2167,2.5
16001,11/1/19,257391,251026,6365,2.5
16003,11/1/19,1669,1569,100,6
16005,11/1/19,43372,42250,1122,2.6
16007,11/1/19,2919,2833,86,2.9
16009,11/1/19,4082,3911,171,4.2
16011,11/1/19,23669,23076,593,2.5
16013,11/1/19,11886,11565,321,2.7
16015,11/1/19,3551,3407,144,4.1
16017,11/1/19,19949,19196,753,3.8
16019,11/1/19,57933,56644,1289,2.2
16021,11/1/19,5307,5110,197,3.7
16023,11/1/19,1406,1371,35,2.5
16025,11/1/19,684,662,22,3.2
16027,11/1/19,104900,101744,3156,3
16029,11/1/19,4144,4026,118,2.8
16031,11/1/19,12330,12041,289,2.3
16033,11/1/19,379,364,15,4
16035,11/1/19,2866,2719,147,5.1
16037,11/1/19,2093,2008,85,4.1
16039,11/1/19,11533,11193,340,2.9
16041,11/1/19,7107,6946,161,2.3
16043,11/1/19,8027,7852,175,2.2
16045,11/1/19,8405,8147,258,3.1
16047,11/1/19,8279,8076,203,2.5
16049,11/1/19,6449,6202,247,3.8
16051,11/1/19,14214,13899,315,2.2
16053,11/1/19,12275,11971,304,2.5
16055,11/1/19,80122,77439,2683,3.3
16057,11/1/19,21192,20673,519,2.4
16059,11/1/19,3477,3326,151,4.3
16061,11/1/19,1620,1534,86,5.3
16063,11/1/19,2601,2533,68,2.6
16065,11/1/19,22491,22101,390,1.7
16067,11/1/19,11623,11348,275,2.4
16069,11/1/19,21368,20801,567,2.7
16071,11/1/19,2294,2253,41,1.8
16073,11/1/19,5233,5072,161,3.1
16075,11/1/19,11725,11344,381,3.2
16077,11/1/19,4012,3906,106,2.6
16079,11/1/19,5019,4721,298,5.9
16081,11/1/19,6271,6082,189,3
16083,11/1/19,41828,40703,1125,2.7
16085,11/1/19,5224,5007,217,4.2
16087,11/1/19,4689,4523,166,3.5
17001,11/1/19,32039,31072,967,3
17003,11/1/19,2065,1943,122,5.9
17005,11/1/19,7796,7550,246,3.2
17007,11/1/19,26061,24757,1304,5
17009,11/1/19,2989,2923,66,2.2
17011,11/1/19,17185,16458,727,4.2
17013,11/1/19,2338,2233,105,4.5
17015,11/1/19,7314,7052,262,3.6
17017,11/1/19,6034,5821,213,3.5
17019,11/1/19,113026,109466,3560,3.1
17021,11/1/19,14300,13686,614,4.3
17023,11/1/19,7635,7337,298,3.9
17025,11/1/19,6397,6151,246,3.8
17027,11/1/19,20521,20000,521,2.5
17029,11/1/19,24330,23508,822,3.4
17031,11/1/19,2576961,2496373,80588,3.1
17033,11/1/19,8706,8394,312,3.6
17035,11/1/19,6123,5958,165,2.7
17037,11/1/19,55403,53393,2010,3.6
17039,11/1/19,7492,7232,260,3.5
17041,11/1/19,10365,10054,311,3
17043,11/1/19,504769,492940,11829,2.3
17045,11/1/19,8850,8512,338,3.8
17047,11/1/19,2672,2567,105,3.9
17049,11/1/19,19265,18742,523,2.7
17051,11/1/19,9783,9410,373,3.8
17053,11/1/19,6644,6389,255,3.8
17055,11/1/19,16375,15576,799,4.9
17057,11/1/19,15111,14392,719,4.8
17059,11/1/19,2316,2214,102,4.4
17061,11/1/19,5992,5772,220,3.7
17063,11/1/19,25107,24276,831,3.3
17065,11/1/19,4427,4282,145,3.3
17067,11/1/19,8455,8117,338,4
17069,11/1/19,1328,1255,73,5.5
17071,11/1/19,3571,3461,110,3.1
17073,11/1/19,25101,23979,1122,4.5
17075,11/1/19,14469,13925,544,3.8
17077,11/1/19,28480,27531,949,3.3
17079,11/1/19,4586,4432,154,3.4
17081,11/1/19,17485,16759,726,4.2
17083,11/1/19,11044,10623,421,3.8
17085,11/1/19,10582,10209,373,3.5
17087,11/1/19,4142,3939,203,4.9
17089,11/1/19,274058,263806,10252,3.7
17091,11/1/19,56735,53996,2739,4.8
17093,11/1/19,68124,66320,1804,2.6
17095,11/1/19,21605,20666,939,4.3
17097,11/1/19,376268,363081,13187,3.5
17099,11/1/19,54650,52214,2436,4.5
17101,11/1/19,5818,5545,273,4.7
17103,11/1/19,17776,17155,621,3.5
17105,11/1/19,16632,16036,596,3.6
17107,11/1/19,12540,12077,463,3.7
17109,11/1/19,13778,13289,489,3.5
17111,11/1/19,164203,159970,4233,2.6
17113,11/1/19,89195,86343,2852,3.2
17115,11/1/19,48435,46099,2336,4.8
17117,11/1/19,23117,22241,876,3.8
17119,11/1/19,135385,130758,4627,3.4
17121,11/1/19,17561,16829,732,4.2
17123,11/1/19,5292,5054,238,4.5
17125,11/1/19,6254,5978,276,4.4
17127,11/1/19,5647,5390,257,4.6
17129,11/1/19,6472,6271,201,3.1
17131,11/1/19,8076,7731,345,4.3
17133,11/1/19,18968,18447,521,2.7
17135,11/1/19,11653,11105,548,4.7
17137,11/1/19,16460,15877,583,3.5
17139,11/1/19,7573,7357,216,2.9
17141,11/1/19,24887,23835,1052,4.2
17143,11/1/19,84556,80670,3886,4.6
17145,11/1/19,8353,7988,365,4.4
17147,11/1/19,8872,8615,257,2.9
17149,11/1/19,6871,6607,264,3.8
17151,11/1/19,1659,1579,80,4.8
17153,11/1/19,2035,1922,113,5.6
17155,11/1/19,3065,2935,130,4.2
17157,11/1/19,14295,13819,476,3.3
17159,11/1/19,7265,7006,259,3.6
17161,11/1/19,71841,68524,3317,4.6
17163,11/1/19,127688,122707,4981,3.9
17165,11/1/19,9713,9261,452,4.7
17167,11/1/19,100960,97437,3523,3.5
17169,11/1/19,3137,3014,123,3.9
17171,11/1/19,2512,2426,86,3.4
17173,11/1/19,10614,10241,373,3.5
17175,11/1/19,2506,2375,131,5.2
17177,11/1/19,21592,20745,847,3.9
17179,11/1/19,63438,60967,2471,3.9
17181,11/1/19,7498,7134,364,4.9
17183,11/1/19,33357,31792,1565,4.7
17185,11/1/19,5967,5784,183,3.1
17187,11/1/19,8429,8140,289,3.4
17189,11/1/19,10129,9918,211,2.1
17191,11/1/19,7014,6722,292,4.2
17193,11/1/19,6595,6371,224,3.4
17195,11/1/19,28838,27680,1158,4
17197,11/1/19,354250,343491,10759,3
17199,11/1/19,32601,31384,1217,3.7
17201,11/1/19,139275,131747,7528,5.4
17203,11/1/19,18615,18033,582,3.1
18001,11/1/19,17066,16591,475,2.8
18003,11/1/19,187277,181339,5938,3.2
18005,11/1/19,44983,43946,1037,2.3
18007,11/1/19,4638,4509,129,2.8
18009,11/1/19,4874,4687,187,3.8
18011,11/1/19,36484,35637,847,2.3
18013,11/1/19,7754,7551,203,2.6
18015,11/1/19,10449,10172,277,2.7
18017,11/1/19,17733,17188,545,3.1
18019,11/1/19,61781,59870,1911,3.1
18021,11/1/19,12166,11765,401,3.3
18023,11/1/19,17210,16777,433,2.5
18025,11/1/19,4800,4634,166,3.5
18027,11/1/19,16661,16254,407,2.4
18029,11/1/19,25841,25000,841,3.3
18031,11/1/19,14616,14228,388,2.7
18033,11/1/19,22655,22026,629,2.8
18035,11/1/19,54732,52734,1998,3.7
18037,11/1/19,22852,22336,516,2.3
18039,11/1/19,111351,108118,3233,2.9
18041,11/1/19,8631,8232,399,4.6
18043,11/1/19,41733,40493,1240,3
18045,11/1/19,8026,7754,272,3.4
18047,11/1/19,11364,10989,375,3.3
18049,11/1/19,9791,9503,288,2.9
18051,11/1/19,19584,19107,477,2.4
18053,11/1/19,32316,31218,1098,3.4
18055,11/1/19,13757,13256,501,3.6
18057,11/1/19,184782,180430,4352,2.4
18059,11/1/19,40423,39403,1020,2.5
18061,11/1/19,20313,19738,575,2.8
18063,11/1/19,90458,88155,2303,2.5
18065,11/1/19,22108,21439,669,3
18067,11/1/19,36993,35754,1239,3.3
18069,11/1/19,18266,17735,531,2.9
18071,11/1/19,22960,22413,547,2.4
18073,11/1/19,16349,15828,521,3.2
18075,11/1/19,9375,9118,257,2.7
18077,11/1/19,14965,14468,497,3.3
18079,11/1/19,13615,13225,390,2.9
18081,11/1/19,83414,81299,2115,2.5
18083,11/1/19,18600,18068,532,2.9
18085,11/1/19,42077,40887,1190,2.8
18087,11/1/19,19988,19489,499,2.5
18089,11/1/19,231837,221635,10202,4.4
18091,11/1/19,47785,45996,1789,3.7
18093,11/1/19,21425,20673,752,3.5
18095,11/1/19,59372,57377,1995,3.4
18097,11/1/19,493184,478099,15085,3.1
18099,11/1/19,22915,22240,675,2.9
18101,11/1/19,5347,5223,124,2.3
18103,11/1/19,15205,14673,532,3.5
18105,11/1/19,72249,70073,2176,3
18107,11/1/19,18865,18312,553,2.9
18109,11/1/19,36520,35500,1020,2.8
18111,11/1/19,6988,6750,238,3.4
18113,11/1/19,23417,22737,680,2.9
18115,11/1/19,3196,3089,107,3.3
18117,11/1/19,8502,8214,288,3.4
18119,11/1/19,9634,9299,335,3.5
18121,11/1/19,7044,6783,261,3.7
18123,11/1/19,9176,8904,272,3
18125,11/1/19,6108,5940,168,2.8
18127,11/1/19,87455,84514,2941,3.4
18129,11/1/19,13669,13314,355,2.6
18131,11/1/19,6450,6252,198,3.1
18133,11/1/19,16847,16316,531,3.2
18135,11/1/19,11207,10800,407,3.6
18137,11/1/19,14171,13742,429,3
18139,11/1/19,8873,8657,216,2.4
18141,11/1/19,136131,131458,4673,3.4
18143,11/1/19,10558,10223,335,3.2
18145,11/1/19,23269,22646,623,2.7
18147,11/1/19,10189,9886,303,3
18149,11/1/19,9846,9458,388,3.9
18151,11/1/19,20965,20446,519,2.5
18153,11/1/19,8423,8118,305,3.6
18155,11/1/19,4993,4832,161,3.2
18157,11/1/19,101422,98649,2773,2.7
18159,11/1/19,9174,8982,192,2.1
18161,11/1/19,3554,3449,105,3
18163,11/1/19,94885,92153,2732,2.9
18165,11/1/19,7029,6709,320,4.6
18167,11/1/19,48638,46727,1911,3.9
18169,11/1/19,15249,14800,449,2.9
18171,11/1/19,4222,4102,120,2.8
18173,11/1/19,33211,32296,915,2.8
18175,11/1/19,13708,13299,409,3
18177,11/1/19,30629,29607,1022,3.3
18179,11/1/19,14496,14132,364,2.5
18181,11/1/19,13366,13039,327,2.4
18183,11/1/19,17848,17375,473,2.7
19001,11/1/19,4359,4278,81,1.9
19003,11/1/19,2212,2179,33,1.5
19005,11/1/19,7596,7410,186,2.4
19007,11/1/19,6047,5857,190,3.1
19009,11/1/19,3186,3124,62,1.9
19011,11/1/19,13918,13542,376,2.7
19013,11/1/19,70338,68235,2103,3
19015,11/1/19,15278,14967,311,2
19017,11/1/19,14208,13901,307,2.2
19019,11/1/19,11486,11216,270,2.4
19021,11/1/19,12405,12183,222,1.8
19023,11/1/19,8138,7929,209,2.6
19025,11/1/19,4356,4269,87,2
19027,11/1/19,11224,11024,200,1.8
19029,11/1/19,6994,6851,143,2
19031,11/1/19,11122,10885,237,2.1
19033,11/1/19,23946,23375,571,2.4
19035,11/1/19,6304,6179,125,2
19037,11/1/19,6752,6587,165,2.4
19039,11/1/19,4949,4833,116,2.3
19041,11/1/19,8677,8463,214,2.5
19043,11/1/19,10316,10019,297,2.9
19045,11/1/19,23390,22522,868,3.7
19047,11/1/19,8395,8156,239,2.8
19049,11/1/19,50648,49790,858,1.7
19051,11/1/19,4313,4209,104,2.4
19053,11/1/19,4527,4449,78,1.7
19055,11/1/19,10914,10685,229,2.1
19057,11/1/19,19291,18567,724,3.8
19059,11/1/19,9913,9693,220,2.2
19061,11/1/19,57378,56040,1338,2.3
19063,11/1/19,5349,5258,91,1.7
19065,11/1/19,11010,10683,327,3
19067,11/1/19,8870,8480,390,4.4
19069,11/1/19,5795,5696,99,1.7
19071,11/1/19,3790,3715,75,2
19073,11/1/19,5591,5497,94,1.7
19075,11/1/19,6695,6549,146,2.2
19077,11/1/19,5782,5646,136,2.4
19079,11/1/19,7113,6936,177,2.5
19081,11/1/19,6072,5930,142,2.3
19083,11/1/19,8220,8010,210,2.6
19085,11/1/19,7590,7439,151,2
19087,11/1/19,10034,9778,256,2.6
19089,11/1/19,5310,5204,106,2
19091,11/1/19,5262,5140,122,2.3
19093,11/1/19,4232,4164,68,1.6
19095,11/1/19,10838,10661,177,1.6
19097,11/1/19,11147,10850,297,2.7
19099,11/1/19,20307,19770,537,2.6
19101,11/1/19,10426,10199,227,2.2
19103,11/1/19,88502,86863,1639,1.9
19105,11/1/19,11007,10723,284,2.6
19107,11/1/19,5360,5222,138,2.6
19109,11/1/19,8617,8459,158,1.8
19111,11/1/19,16497,15909,588,3.6
19113,11/1/19,125166,121714,3452,2.8
19115,11/1/19,6206,6034,172,2.8
19117,11/1/19,4668,4581,87,1.9
19119,11/1/19,7237,7128,109,1.5
19121,11/1/19,8757,8503,254,2.9
19123,11/1/19,12152,11885,267,2.2
19125,11/1/19,18760,18416,344,1.8
19127,11/1/19,18029,17437,592,3.3
19129,11/1/19,7609,7453,156,2.1
19131,11/1/19,7304,7206,98,1.3
19133,11/1/19,4520,4406,114,2.5
19135,11/1/19,4117,4006,111,2.7
19137,11/1/19,5102,4977,125,2.5
19139,11/1/19,22143,21576,567,2.6
19141,11/1/19,8469,8318,151,1.8
19143,11/1/19,3616,3555,61,1.7
19145,11/1/19,6481,6321,160,2.5
19147,11/1/19,4915,4821,94,1.9
19149,11/1/19,15310,14961,349,2.3
19151,11/1/19,4928,4853,75,1.5
19153,11/1/19,274608,267633,6975,2.5
19155,11/1/19,49658,48648,1010,2
19157,11/1/19,10904,10667,237,2.2
19159,11/1/19,2538,2480,58,2.3
19161,11/1/19,5427,5336,91,1.7
19163,11/1/19,90745,87681,3064,3.4
19165,11/1/19,6823,6705,118,1.7
19167,11/1/19,21804,21510,294,1.3
19169,11/1/19,61308,60271,1037,1.7
19171,11/1/19,9561,9334,227,2.4
19173,11/1/19,3286,3225,61,1.9
19175,11/1/19,6482,6302,180,2.8
19177,11/1/19,3771,3687,84,2.2
19179,11/1/19,18050,17482,568,3.1
19181,11/1/19,28875,28253,622,2.2
19183,11/1/19,12382,12132,250,2
19185,11/1/19,2893,2833,60,2.1
19187,11/1/19,20028,19521,507,2.5
19189,11/1/19,5269,5140,129,2.4
19191,11/1/19,12615,12375,240,1.9
19193,11/1/19,56964,55534,1430,2.5
19195,11/1/19,4332,4223,109,2.5
19197,11/1/19,7180,7014,166,2.3
20001,11/1/19,6400,6206,194,3
20003,11/1/19,4214,4101,113,2.7
20005,11/1/19,7041,6678,363,5.2
20007,11/1/19,2369,2300,69,2.9
20009,11/1/19,13385,13010,375,2.8
20011,11/1/19,6635,6397,238,3.6
20013,11/1/19,5355,5202,153,2.9
20015,11/1/19,32651,31674,977,3
20017,11/1/19,1510,1477,33,2.2
20019,11/1/19,1462,1409,53,3.6
20021,11/1/19,10205,9904,301,2.9
20023,11/1/19,1349,1319,30,2.2
20025,11/1/19,1118,1093,25,2.2
20027,11/1/19,3824,3724,100,2.6
20029,11/1/19,3822,3713,109,2.9
20031,11/1/19,4171,4004,167,4
20033,11/1/19,890,865,25,2.8
20035,11/1/19,16388,15871,517,3.2
20037,11/1/19,18851,18159,692,3.7
20039,11/1/19,1277,1238,39,3.1
20041,11/1/19,8870,8604,266,3
20043,11/1/19,4167,4039,128,3.1
20045,11/1/19,67073,65294,1779,2.7
20047,11/1/19,1589,1554,35,2.2
20049,11/1/19,1197,1160,37,3.1
20051,11/1/19,17301,16951,350,2
20053,11/1/19,2740,2675,65,2.4
20055,11/1/19,20803,20356,447,2.1
20057,11/1/19,17204,16812,392,2.3
20059,11/1/19,14189,13786,403,2.8
20061,11/1/19,11449,11000,449,3.9
20063,11/1/19,1496,1466,30,2
20065,11/1/19,1133,1100,33,2.9
20067,11/1/19,3259,3169,90,2.8
20069,11/1/19,3348,3281,67,2
20071,11/1/19,798,782,16,2
20073,11/1/19,3352,3262,90,2.7
20075,11/1/19,1673,1645,28,1.7
20077,11/1/19,2862,2790,72,2.5
20079,11/1/19,17096,16628,468,2.7
20081,11/1/19,2218,2176,42,1.9
20083,11/1/19,1027,1002,25,2.4
20085,11/1/19,7123,6949,174,2.4
20087,11/1/19,10060,9782,278,2.8
20089,11/1/19,1282,1247,35,2.7
20091,11/1/19,341329,332762,8567,2.5
20093,11/1/19,2095,2051,44,2.1
20095,11/1/19,3477,3373,104,3
20097,11/1/19,1339,1311,28,2.1
20099,11/1/19,9974,9622,352,3.5
20101,11/1/19,796,777,19,2.4
20103,11/1/19,36715,35589,1126,3.1
20105,11/1/19,1763,1733,30,1.7
20107,11/1/19,4459,4232,227,5.1
20109,11/1/19,1661,1633,28,1.7
20111,11/1/19,16768,16268,500,3
20113,11/1/19,17171,16823,348,2
20115,11/1/19,6085,5920,165,2.7
20117,11/1/19,5537,5405,132,2.4
20119,11/1/19,2149,2103,46,2.1
20121,11/1/19,17575,17075,500,2.8
20123,11/1/19,3297,3228,69,2.1
20125,11/1/19,14809,14207,602,4.1
20127,11/1/19,3064,2974,90,2.9
20129,11/1/19,1168,1140,28,2.4
20131,11/1/19,5406,5263,143,2.6
20133,11/1/19,6210,5944,266,4.3
20135,11/1/19,1361,1328,33,2.4
20137,11/1/19,2717,2666,51,1.9
20139,11/1/19,7947,7688,259,3.3
20141,11/1/19,2100,2063,37,1.8
20143,11/1/19,3037,2961,76,2.5
20145,11/1/19,2895,2821,74,2.6
20147,11/1/19,2656,2593,63,2.4
20149,11/1/19,12840,12530,310,2.4
20151,11/1/19,4964,4853,111,2.2
20153,11/1/19,1532,1499,33,2.2
20155,11/1/19,29738,28860,878,3
20157,11/1/19,2304,2246,58,2.5
20159,11/1/19,5195,5065,130,2.5
20161,11/1/19,36289,35370,919,2.5
20163,11/1/19,2583,2509,74,2.9
20165,11/1/19,1641,1604,37,2.3
20167,11/1/19,3294,3208,86,2.6
20169,11/1/19,30212,29380,832,2.8
20171,11/1/19,2897,2848,49,1.7
20173,11/1/19,252101,244039,8062,3.2
20175,11/1/19,9458,9190,268,2.8
20177,11/1/19,89887,87094,2793,3.1
20179,11/1/19,1437,1407,30,2.1
20181,11/1/19,2835,2754,81,2.9
20183,11/1/19,1995,1949,46,2.3
20185,11/1/19,2088,2032,56,2.7
20187,11/1/19,1005,980,25,2.5
20189,11/1/19,2576,2511,65,2.5
20191,11/1/19,10962,10638,324,3
20193,11/1/19,4363,4271,92,2.1
20195,11/1/19,1457,1420,37,2.5
20197,11/1/19,3654,3543,111,3
20199,11/1/19,815,794,21,2.6
20201,11/1/19,2966,2910,56,1.9
20203,11/1/19,1251,1225,26,2.1
20205,11/1/19,3999,3846,153,3.8
20207,11/1/19,1576,1516,60,3.8
20209,11/1/19,77574,74665,2909,3.7
21001,11/1/19,7174,6834,340,4.7
21003,11/1/19,9175,8848,327,3.6
21005,11/1/19,12415,11994,421,3.4
21007,11/1/19,3532,3369,163,4.6
21009,11/1/19,18757,18016,741,4
21011,11/1/19,4648,4401,247,5.3
21013,11/1/19,8471,7923,548,6.5
21015,11/1/19,71447,69247,2200,3.1
21017,11/1/19,9980,9639,341,3.4
21019,11/1/19,17835,16957,878,4.9
21021,11/1/19,12464,11960,504,4
21023,11/1/19,3819,3671,148,3.9
21025,11/1/19,3427,3175,252,7.4
21027,11/1/19,7877,7508,369,4.7
21029,11/1/19,43042,41498,1544,3.6
21031,11/1/19,5157,4938,219,4.2
21033,11/1/19,5510,5271,239,4.3
21035,11/1/19,18668,17992,676,3.6
21037,11/1/19,51055,49469,1586,3.1
21039,11/1/19,2281,2196,85,3.7
21041,11/1/19,5396,5222,174,3.2
21043,11/1/19,9732,9106,626,6.4
21045,11/1/19,6697,6458,239,3.6
21047,11/1/19,25284,24057,1227,4.9
21049,11/1/19,17338,16746,592,3.4
21051,11/1/19,5203,4863,340,6.5
21053,11/1/19,3961,3764,197,5
21055,11/1/19,3816,3673,143,3.7
21057,11/1/19,3181,3072,109,3.4
21059,11/1/19,47437,45857,1580,3.3
21061,11/1/19,4874,4676,198,4.1
21063,11/1/19,2045,1899,146,7.1
21065,11/1/19,5467,5213,254,4.6
21067,11/1/19,177029,171926,5103,2.9
21069,11/1/19,6129,5849,280,4.6
21071,11/1/19,11070,10399,671,6.1
21073,11/1/19,25934,25115,819,3.2
21075,11/1/19,2068,1972,96,4.6
21077,11/1/19,4112,3971,141,3.4
21079,11/1/19,7736,7422,314,4.1
21081,11/1/19,11774,11355,419,3.6
21083,11/1/19,15896,15256,640,4
21085,11/1/19,11079,10603,476,4.3
21087,11/1/19,5209,5009,200,3.8
21089,11/1/19,13399,12637,762,5.7
21091,11/1/19,3987,3854,133,3.3
21093,11/1/19,48942,47161,1781,3.6
21095,11/1/19,6658,5927,731,11
21097,11/1/19,8901,8573,328,3.7
21099,11/1/19,7921,7471,450,5.7
21101,11/1/19,22204,21403,801,3.6
21103,11/1/19,8281,8029,252,3
21105,11/1/19,1773,1692,81,4.6
21107,11/1/19,18521,17801,720,3.9
21109,11/1/19,4174,3930,244,5.8
21111,11/1/19,401806,387931,13875,3.5
21113,11/1/19,26776,25933,843,3.1
21115,11/1/19,6765,6362,403,6
21117,11/1/19,88393,85539,2854,3.2
21119,11/1/19,4512,4215,297,6.6
21121,11/1/19,9992,9451,541,5.4
21123,11/1/19,5940,5711,229,3.9
21125,11/1/19,24793,23732,1061,4.3
21127,11/1/19,5289,4956,333,6.3
21129,11/1/19,2039,1935,104,5.1
21131,11/1/19,2750,2493,257,9.3
21133,11/1/19,6469,5947,522,8.1
21135,11/1/19,4624,4247,377,8.2
21137,11/1/19,9243,8858,385,4.2
21139,11/1/19,3675,3512,163,4.4
21141,11/1/19,12655,12180,475,3.8
21143,11/1/19,3018,2898,120,4
21145,11/1/19,29394,28169,1225,4.2
21147,11/1/19,4689,4437,252,5.4
21149,11/1/19,4240,4074,166,3.9
21151,11/1/19,48517,46907,1610,3.3
21153,11/1/19,3258,2900,358,11
21155,11/1/19,9691,9374,317,3.3
21157,11/1/19,15107,14535,572,3.8
21159,11/1/19,2739,2554,185,6.8
21161,11/1/19,7105,6751,354,5
21163,11/1/19,12276,11762,514,4.2
21165,11/1/19,2319,2194,125,5.4
21167,11/1/19,10075,9635,440,4.4
21169,11/1/19,4122,3919,203,4.9
21171,11/1/19,4743,4590,153,3.2
21173,11/1/19,11743,11216,527,4.5
21175,11/1/19,4584,4373,211,4.6
21177,11/1/19,10395,9805,590,5.7
21179,11/1/19,23293,22425,868,3.7
21181,11/1/19,3348,3211,137,4.1
21183,11/1/19,9781,9337,444,4.5
21185,11/1/19,33503,32552,951,2.8
21187,11/1/19,5126,4942,184,3.6
21189,11/1/19,1127,1057,70,6.2
21191,11/1/19,6991,6772,219,3.1
21193,11/1/19,8344,7824,520,6.2
21195,11/1/19,20281,19153,1128,5.6
21197,11/1/19,5061,4816,245,4.8
21199,11/1/19,26954,25818,1136,4.2
21201,11/1/19,845,801,44,5.2
21203,11/1/19,6838,6560,278,4.1
21205,11/1/19,10578,10064,514,4.9
21207,11/1/19,6207,5885,322,5.2
21209,11/1/19,29517,28584,933,3.2
21211,11/1/19,25683,24945,738,2.9
21213,11/1/19,8949,8570,379,4.2
21215,11/1/19,10264,9942,322,3.1
21217,11/1/19,13288,12815,473,3.6
21219,11/1/19,5537,5332,205,3.7
21221,11/1/19,6081,5850,231,3.8
21223,11/1/19,3907,3757,150,3.8
21225,11/1/19,6214,5954,260,4.2
21227,11/1/19,66082,63870,2212,3.3
21229,11/1/19,6322,6107,215,3.4
21231,11/1/19,7480,7109,371,5
21233,11/1/19,5693,5478,215,3.8
21235,11/1/19,13854,13188,666,4.8
21237,11/1/19,1988,1863,125,6.3
21239,11/1/19,15203,14745,458,3
22001,11/1/19,23813,22505,1308,5.5
22003,11/1/19,8948,8424,524,5.9
22005,11/1/19,64467,61697,2770,4.3
22007,11/1/19,8909,8369,540,6.1
22009,11/1/19,15037,14120,917,6.1
22011,11/1/19,14784,14008,776,5.2
22013,11/1/19,5497,5158,339,6.2
22015,11/1/19,57966,55358,2608,4.5
22017,11/1/19,104107,98300,5807,5.6
22019,11/1/19,105412,100846,4566,4.3
22021,11/1/19,3777,3509,268,7.1
22023,11/1/19,3896,3748,148,3.8
22025,11/1/19,3367,3153,214,6.4
22027,11/1/19,5884,5482,402,6.8
22029,11/1/19,7108,6654,454,6.4
22031,11/1/19,10930,10228,702,6.4
22033,11/1/19,232303,221726,10577,4.6
22035,11/1/19,1875,1671,204,10.9
22037,11/1/19,8006,7633,373,4.7
22039,11/1/19,11842,11116,726,6.1
22041,11/1/19,7285,6764,521,7.2
22043,11/1/19,8206,7691,515,6.3
22045,11/1/19,28098,26502,1596,5.7
22047,11/1/19,14121,13251,870,6.2
22049,11/1/19,6853,6516,337,4.9
22051,11/1/19,216130,207079,9051,4.2
22053,11/1/19,13250,12602,648,4.9
22055,11/1/19,114106,108971,5135,4.5
22057,11/1/19,42270,40373,1897,4.5
22059,11/1/19,6805,6508,297,4.4
22061,11/1/19,22548,21327,1221,5.4
22063,11/1/19,69083,66219,2864,4.1
22065,11/1/19,3465,3173,292,8.4
22067,11/1/19,10042,9152,890,8.9
22069,11/1/19,16534,15543,991,6
22071,11/1/19,180866,171945,8921,4.9
22073,11/1/19,70609,66679,3930,5.6
22075,11/1/19,10105,9658,447,4.4
22077,11/1/19,9838,9317,521,5.3
22079,11/1/19,55182,52323,2859,5.2
22081,11/1/19,3714,3510,204,5.5
22083,11/1/19,8145,7601,544,6.7
22085,11/1/19,9107,8606,501,5.5
22087,11/1/19,20039,19029,1010,5
22089,11/1/19,25467,24320,1147,4.5
22091,11/1/19,4285,4024,261,6.1
22093,11/1/19,9335,8768,567,6.1
22095,11/1/19,19961,18776,1185,5.9
22097,11/1/19,31977,29906,2071,6.5
22099,11/1/19,22265,21091,1174,5.3
22101,11/1/19,19975,18743,1232,6.2
22103,11/1/19,120597,115474,5123,4.2
22105,11/1/19,55370,52297,3073,5.5
22107,11/1/19,1348,1226,122,9.1
22109,11/1/19,46605,44373,2232,4.8
22111,11/1/19,9100,8547,553,6.1
22113,11/1/19,24029,22815,1214,5.1
22115,11/1/19,16038,15064,974,6.1
22117,11/1/19,16793,15811,982,5.8
22119,11/1/19,14593,13662,931,6.4
22121,11/1/19,13739,13119,620,4.5
22123,11/1/19,3588,3188,400,11.1
22125,11/1/19,5410,5167,243,4.5
22127,11/1/19,4822,4496,326,6.8
23001,11/1/19,55674,54140,1534,2.8
23003,11/1/19,29922,28676,1246,4.2
23005,11/1/19,164997,161219,3778,2.3
23007,11/1/19,14152,13657,495,3.5
23009,11/1/19,27747,26856,891,3.2
23011,11/1/19,61717,60021,1696,2.7
23013,11/1/19,19543,19009,534,2.7
23015,11/1/19,16329,15872,457,2.8
23017,11/1/19,25679,24806,873,3.4
23019,11/1/19,77726,75427,2299,3
23021,11/1/19,7175,6913,262,3.7
23023,11/1/19,19304,18883,421,2.2
23025,11/1/19,22013,21094,919,4.2
23027,11/1/19,20441,19852,589,2.9
23029,11/1/19,13857,13319,538,3.9
23031,11/1/19,113383,110394,2989,2.6
24001,11/1/19,32409,30906,1503,4.6
24003,11/1/19,318901,310287,8614,2.7
24005,11/1/19,459033,443909,15124,3.3
24009,11/1/19,50909,49546,1363,2.7
24011,11/1/19,18013,17429,584,3.2
24013,11/1/19,96278,93853,2425,2.5
24015,11/1/19,53266,51425,1841,3.5
24017,11/1/19,88828,85958,2870,3.2
24019,11/1/19,15246,14605,641,4.2
24021,11/1/19,135685,131900,3785,2.8
24023,11/1/19,15078,14448,630,4.2
24025,11/1/19,142173,138057,4116,2.9
24027,11/1/19,189939,185399,4540,2.4
24029,11/1/19,9654,9328,326,3.4
24031,11/1/19,569674,554911,14763,2.6
24033,11/1/19,518677,501124,17553,3.4
24035,11/1/19,27847,27090,757,2.7
24037,11/1/19,57429,55816,1613,2.8
24039,11/1/19,8734,8256,478,5.5
24041,11/1/19,19320,18755,565,2.9
24043,11/1/19,76577,74055,2522,3.3
24045,11/1/19,50225,48031,2194,4.4
24047,11/1/19,25404,23255,2149,8.5
24510,11/1/19,291299,277897,13402,4.6
25001,11/1/19,110574,106945,3629,3.3
25003,11/1/19,64189,62416,1773,2.8
25005,11/1/19,305287,296490,8797,2.9
25007,11/1/19,8563,8229,334,3.9
25009,11/1/19,430547,420382,10165,2.4
25011,11/1/19,41480,40615,865,2.1
25013,11/1/19,231841,224473,7368,3.2
25015,11/1/19,91756,89953,1803,2
25017,11/1/19,932770,915739,17031,1.8
25019,11/1/19,6688,6440,248,3.7
25021,11/1/19,397748,389692,8056,2
25023,11/1/19,287417,280603,6814,2.4
25025,11/1/19,463731,453962,9769,2.1
25027,11/1/19,452930,441783,11147,2.5
26001,11/1/19,3791,3602,189,5
26003,11/1/19,3030,2820,210,6.9
26005,11/1/19,61980,60513,1467,2.4
26007,11/1/19,13263,12813,450,3.4
26009,11/1/19,9813,9425,388,4
26011,11/1/19,5928,5629,299,5
26013,11/1/19,3177,3019,158,5
26015,11/1/19,31527,30752,775,2.5
26017,11/1/19,49855,48058,1797,3.6
26019,11/1/19,8724,8402,322,3.7
26021,11/1/19,72846,70581,2265,3.1
26023,11/1/19,19388,18774,614,3.2
26025,11/1/19,62723,60732,1991,3.2
26027,11/1/19,24393,23603,790,3.2
26029,11/1/19,12184,11740,444,3.6
26031,11/1/19,9786,9076,710,7.3
26033,11/1/19,15769,15035,734,4.7
26035,11/1/19,11539,10994,545,4.7
26037,11/1/19,41710,40770,940,2.3
26039,11/1/19,5501,5226,275,5
26041,11/1/19,16921,16214,707,4.2
26043,11/1/19,12184,11755,429,3.5
26045,11/1/19,58086,56610,1476,2.5
26047,11/1/19,17036,16323,713,4.2
26049,11/1/19,183897,177003,6894,3.7
26051,11/1/19,9746,9280,466,4.8
26053,11/1/19,5914,5675,239,4
26055,11/1/19,49225,47961,1264,2.6
26057,11/1/19,18138,17556,582,3.2
26059,11/1/19,20428,19748,680,3.3
26061,11/1/19,16530,15946,584,3.5
26063,11/1/19,15146,14697,449,3
26065,11/1/19,153357,149407,3950,2.6
26067,11/1/19,30360,29592,768,2.5
26069,11/1/19,10175,9697,478,4.7
26071,11/1/19,5055,4865,190,3.8
26073,11/1/19,34737,33756,981,2.8
26075,11/1/19,74151,71956,2195,3
26077,11/1/19,134891,131372,3519,2.6
26079,11/1/19,7816,7461,355,4.5
26081,11/1/19,359449,351206,8243,2.3
26083,11/1/19,905,850,55,6.1
26085,11/1/19,3824,3626,198,5.2
26087,11/1/19,41036,39393,1643,4
26089,11/1/19,10364,10090,274,2.6
26091,11/1/19,46753,45380,1373,2.9
26093,11/1/19,104014,101199,2815,2.7
26095,11/1/19,2257,2127,130,5.8
26097,11/1/19,4221,3821,400,9.5
26099,11/1/19,449612,433993,15619,3.5
26101,11/1/19,10235,9792,443,4.3
26103,11/1/19,32953,31811,1142,3.5
26105,11/1/19,13297,12731,566,4.3
26107,11/1/19,18522,17900,622,3.4
26109,11/1/19,10939,10613,326,3
26111,11/1/19,40076,38878,1198,3
26113,11/1/19,6810,6580,230,3.4
26115,11/1/19,75770,73615,2155,2.8
26117,11/1/19,28089,27259,830,3
26119,11/1/19,2979,2733,246,8.3
26121,11/1/19,77174,74406,2768,3.6
26123,11/1/19,23281,22531,750,3.2
26125,11/1/19,679379,660200,19179,2.8
26127,11/1/19,11583,11070,513,4.4
26129,11/1/19,7842,7451,391,5
26131,11/1/19,2062,1937,125,6.1
26133,11/1/19,11217,10894,323,2.9
26135,11/1/19,2976,2795,181,6.1
26137,11/1/19,11349,10873,476,4.2
26139,11/1/19,160667,157205,3462,2.2
26141,11/1/19,4784,4509,275,5.7
26143,11/1/19,7474,7046,428,5.7
26145,11/1/19,86708,83397,3311,3.8
26147,11/1/19,75789,72845,2944,3.9
26149,11/1/19,27653,26714,939,3.4
26151,11/1/19,19280,18639,641,3.3
26153,11/1/19,3268,3106,162,5
26155,11/1/19,33549,32527,1022,3
26157,11/1/19,23727,22863,864,3.6
26159,11/1/19,35100,33888,1212,3.5
26161,11/1/19,202006,197622,4384,2.2
26163,11/1/19,806697,772995,33702,4.2
26165,11/1/19,14718,14200,518,3.5
27001,11/1/19,7284,6861,423,5.8
27003,11/1/19,200387,194997,5390,2.7
27005,11/1/19,18834,18183,651,3.5
27007,11/1/19,24835,23830,1005,4
27009,11/1/19,22333,21593,740,3.3
27011,11/1/19,2490,2406,84,3.4
27013,11/1/19,41894,41023,871,2.1
27015,11/1/19,14398,13987,411,2.9
27017,11/1/19,18016,17283,733,4.1
27019,11/1/19,59364,57975,1389,2.3
27021,11/1/19,14205,13401,804,5.7
27023,11/1/19,7015,6806,209,3
27025,11/1/19,30345,29371,974,3.2
27027,11/1/19,36683,35867,816,2.2
27029,11/1/19,4528,4223,305,6.7
27031,11/1/19,3007,2877,130,4.3
27033,11/1/19,6050,5897,153,2.5
27035,11/1/19,32083,30689,1394,4.3
27037,11/1/19,245003,238851,6152,2.5
27039,11/1/19,11942,11622,320,2.7
27041,11/1/19,20924,20369,555,2.7
27043,11/1/19,7068,6781,287,4.1
27045,11/1/19,11610,11320,290,2.5
27047,11/1/19,16317,15798,519,3.2
27049,11/1/19,27315,26639,676,2.5
27051,11/1/19,3315,3199,116,3.5
27053,11/1/19,717092,699188,17904,2.5
27055,11/1/19,10556,10303,253,2.4
27057,11/1/19,9890,9354,536,5.4
27059,11/1/19,21540,20812,728,3.4
27061,11/1/19,21871,20565,1306,6
27063,11/1/19,5737,5612,125,2.2
27065,11/1/19,9163,8669,494,5.4
27067,11/1/19,24419,23782,637,2.6
27069,11/1/19,2389,2323,66,2.8
27071,11/1/19,5854,5451,403,6.9
27073,11/1/19,3624,3528,96,2.6
27075,11/1/19,5421,5200,221,4.1
27077,11/1/19,2403,2280,123,5.1
27079,11/1/19,16281,15710,571,3.5
27081,11/1/19,3294,3188,106,3.2
27083,11/1/19,14611,14254,357,2.4
27085,11/1/19,19312,18732,580,3
27087,11/1/19,2291,2178,113,4.9
27089,11/1/19,5469,5208,261,4.8
27091,11/1/19,10045,9770,275,2.7
27093,11/1/19,13428,13013,415,3.1
27095,11/1/19,13062,12457,605,4.6
27097,11/1/19,17635,16764,871,4.9
27099,11/1/19,20541,20002,539,2.6
27101,11/1/19,4801,4675,126,2.6
27103,11/1/19,21622,21214,408,1.9
27105,11/1/19,11388,11096,292,2.6
27107,11/1/19,3225,3109,116,3.6
27109,11/1/19,89243,87337,1906,2.1
27111,11/1/19,31355,30249,1106,3.5
27113,11/1/19,8683,8405,278,3.2
27115,11/1/19,15146,14465,681,4.5
27117,11/1/19,4960,4842,118,2.4
27119,11/1/19,16798,16306,492,2.9
27121,11/1/19,6618,6434,184,2.8
27123,11/1/19,293841,285973,7868,2.7
27125,11/1/19,2226,2142,84,3.8
27127,11/1/19,7662,7434,228,3
27129,11/1/19,8774,8484,290,3.3
27131,11/1/19,37403,36505,898,2.4
27133,11/1/19,5684,5568,116,2
27135,11/1/19,7821,7602,219,2.8
27137,11/1/19,103145,99191,3954,3.8
27139,11/1/19,84747,82689,2058,2.4
27141,11/1/19,53064,51503,1561,2.9
27143,11/1/19,8658,8388,270,3.1
27145,11/1/19,91894,89509,2385,2.6
27147,11/1/19,21535,20986,549,2.5
27149,11/1/19,5482,5359,123,2.2
27151,11/1/19,5056,4798,258,5.1
27153,11/1/19,13777,13199,578,4.2
27155,11/1/19,1765,1713,52,2.9
27157,11/1/19,12471,12066,405,3.2
27159,11/1/19,6045,5726,319,5.3
27161,11/1/19,9062,8742,320,3.5
27163,11/1/19,145306,141766,3540,2.4
27165,11/1/19,6512,6284,228,3.5
27167,11/1/19,3474,3395,79,2.3
27169,11/1/19,29076,28343,733,2.5
27171,11/1/19,76717,74543,2174,2.8
27173,11/1/19,5449,5296,153,2.8
28001,11/1/19,11344,10592,752,6.6
28003,11/1/19,15831,15106,725,4.6
28005,11/1/19,4338,4046,292,6.7
28007,11/1/19,6936,6521,415,6
28009,11/1/19,3106,2916,190,6.1
28011,11/1/19,11944,11135,809,6.8
28013,11/1/19,5511,5199,312,5.7
28015,11/1/19,3447,3238,209,6.1
28017,11/1/19,6808,6447,361,5.3
28019,11/1/19,3683,3488,195,5.3
28021,11/1/19,2994,2699,295,9.9
28023,11/1/19,5817,5461,356,6.1
28025,11/1/19,7776,7145,631,8.1
28027,11/1/19,8176,7614,562,6.9
28029,11/1/19,11200,10524,676,6
28031,11/1/19,8185,7811,374,4.6
28033,11/1/19,92721,88857,3864,4.2
28035,11/1/19,33963,32389,1574,4.6
28037,11/1/19,2736,2546,190,6.9
28039,11/1/19,8718,8125,593,6.8
28041,11/1/19,4304,4001,303,7
28043,11/1/19,9301,8846,455,4.9
28045,11/1/19,18779,17772,1007,5.4
28047,11/1/19,87010,82660,4350,5
28049,11/1/19,107844,102520,5324,4.9
28051,11/1/19,5650,5123,527,9.3
28053,11/1/19,2137,1928,209,9.8
28055,11/1/19,363,330,33,9.1
28057,11/1/19,10565,10092,473,4.5
28059,11/1/19,58926,55591,3335,5.7
28061,11/1/19,6124,5718,406,6.6
28063,11/1/19,2006,1714,292,14.6
28065,11/1/19,4129,3875,254,6.2
28067,11/1/19,26099,24734,1365,5.2
28069,11/1/19,3494,3196,298,8.5
28071,11/1/19,29832,28634,1198,4
28073,11/1/19,31475,30244,1231,3.9
28075,11/1/19,30226,28601,1625,5.4
28077,11/1/19,4573,4285,288,6.3
28079,11/1/19,7771,7342,429,5.5
28081,11/1/19,41562,39831,1731,4.2
28083,11/1/19,9958,9280,678,6.8
28085,11/1/19,14600,13814,786,5.4
28087,11/1/19,25772,24481,1291,5
28089,11/1/19,53640,51446,2194,4.1
28091,11/1/19,9932,9411,521,5.2
28093,11/1/19,14669,13853,816,5.6
28095,11/1/19,15684,14878,806,5.1
28097,11/1/19,3875,3651,224,5.8
28099,11/1/19,9980,9392,588,5.9
28101,11/1/19,8838,8368,470,5.3
28103,11/1/19,3719,3444,275,7.4
28105,11/1/19,23173,21961,1212,5.2
28107,11/1/19,12562,11791,771,6.1
28109,11/1/19,23876,22679,1197,5
28111,11/1/19,4349,4089,260,6
28113,11/1/19,14389,13497,892,6.2
28115,11/1/19,14845,14207,638,4.3
28117,11/1/19,11302,10779,523,4.6
28119,11/1/19,2287,2109,178,7.8
28121,11/1/19,76872,73943,2929,3.8
28123,11/1/19,12461,11922,539,4.3
28125,11/1/19,1572,1445,127,8.1
28127,11/1/19,10764,10248,516,4.8
28129,11/1/19,6707,6354,353,5.3
28131,11/1/19,6928,6501,427,6.2
28133,11/1/19,7566,6874,692,9.1
28135,11/1/19,5089,4824,265,5.2
28137,11/1/19,12495,11814,681,5.5
28139,11/1/19,9394,8954,440,4.7
28141,11/1/19,8493,8056,437,5.1
28143,11/1/19,4452,4208,244,5.5
28145,11/1/19,14378,13783,595,4.1
28147,11/1/19,4850,4507,343,7.1
28149,11/1/19,20310,19168,1142,5.6
28151,11/1/19,16821,15614,1207,7.2
28153,11/1/19,7289,6841,448,6.1
28155,11/1/19,3967,3758,209,5.3
28157,11/1/19,2825,2556,269,9.5
28159,11/1/19,7391,6979,412,5.6
28161,11/1/19,5037,4783,254,5
28163,11/1/19,9322,8773,549,5.9
29001,11/1/19,10433,10105,328,3.1
29003,11/1/19,9764,9540,224,2.3
29005,11/1/19,2677,2596,81,3
29007,11/1/19,10678,10351,327,3.1
29009,11/1/19,15536,14984,552,3.6
29011,11/1/19,5193,5031,162,3.1
29013,11/1/19,7887,7630,257,3.3
29015,11/1/19,7210,6878,332,4.6
29017,11/1/19,5525,5311,214,3.9
29019,11/1/19,99976,97734,2242,2.2
29021,11/1/19,44757,43534,1223,2.7
29023,11/1/19,18002,17313,689,3.8
29025,11/1/19,4381,4249,132,3
29027,11/1/19,21355,20778,577,2.7
29029,11/1/19,18275,17406,869,4.8
29031,11/1/19,41300,40080,1220,3
29033,11/1/19,4741,4573,168,3.5
29035,11/1/19,2514,2413,101,4
29037,11/1/19,55217,53720,1497,2.7
29039,11/1/19,5770,5559,211,3.7
29041,11/1/19,3766,3659,107,2.8
29043,11/1/19,45464,44270,1194,2.6
29045,11/1/19,3199,3096,103,3.2
29047,11/1/19,137536,133935,3601,2.6
29049,11/1/19,10746,10480,266,2.5
29051,11/1/19,39092,38118,974,2.5
29053,11/1/19,7556,7318,238,3.1
29055,11/1/19,10985,10559,426,3.9
29057,11/1/19,3553,3450,103,2.9
29059,11/1/19,7170,6807,363,5.1
29061,11/1/19,4098,3975,123,3
29063,11/1/19,4814,4691,123,2.6
29065,11/1/19,6301,6080,221,3.5
29067,11/1/19,5078,4834,244,4.8
29069,11/1/19,11408,10867,541,4.7
29071,11/1/19,53505,51881,1624,3
29073,11/1/19,7733,7493,240,3.1
29075,11/1/19,3464,3370,94,2.7
29077,11/1/19,153203,149009,4194,2.7
29079,11/1/19,4417,4252,165,3.7
29081,11/1/19,3780,3672,108,2.9
29083,11/1/19,9702,9378,324,3.3
29085,11/1/19,3806,3657,149,3.9
29087,11/1/19,2545,2486,59,2.3
29089,11/1/19,4928,4788,140,2.8
29091,11/1/19,16755,16031,724,4.3
29093,11/1/19,3499,3349,150,4.3
29095,11/1/19,365901,353495,12406,3.4
29097,11/1/19,57883,56188,1695,2.9
29099,11/1/19,118964,115469,3495,2.9
29101,11/1/19,23430,22618,812,3.5
29103,11/1/19,1764,1721,43,2.4
29105,11/1/19,17589,16017,1572,8.9
29107,11/1/19,16908,16422,486,2.9
29109,11/1/19,18122,17496,626,3.5
29111,11/1/19,4984,4838,146,2.9
29113,11/1/19,28521,27673,848,3
29115,11/1/19,5182,4951,231,4.5
29117,11/1/19,7283,7095,188,2.6
29119,11/1/19,10849,10489,360,3.3
29121,11/1/19,7537,7314,223,3
29123,11/1/19,5480,5301,179,3.3
29125,11/1/19,3901,3771,130,3.3
29127,11/1/19,14828,14393,435,2.9
29129,11/1/19,1859,1808,51,2.7
29131,11/1/19,12291,11829,462,3.8
29133,11/1/19,5760,5540,220,3.8
29135,11/1/19,7269,7071,198,2.7
29137,11/1/19,3922,3763,159,4.1
29139,11/1/19,5740,5582,158,2.8
29141,11/1/19,8045,7698,347,4.3
29143,11/1/19,8211,7873,338,4.1
29145,11/1/19,27597,26743,854,3.1
29147,11/1/19,10983,10697,286,2.6
29149,11/1/19,4020,3870,150,3.7
29151,11/1/19,7094,6931,163,2.3
29153,11/1/19,3365,3174,191,5.7
29155,11/1/19,6318,6033,285,4.5
29157,11/1/19,10014,9748,266,2.7
29159,11/1/19,21276,20400,876,4.1
29161,11/1/19,19915,19289,626,3.1
29163,11/1/19,7483,7227,256,3.4
29165,11/1/19,59208,57757,1451,2.5
29167,11/1/19,14665,14220,445,3
29169,11/1/19,14780,14151,629,4.3
29171,11/1/19,2237,2172,65,2.9
29173,11/1/19,5745,5583,162,2.8
29175,11/1/19,10513,10117,396,3.8
29177,11/1/19,11067,10720,347,3.1
29179,11/1/19,2992,2882,110,3.7
29181,11/1/19,4990,4780,210,4.2
29183,11/1/19,228381,222847,5534,2.4
29185,11/1/19,3711,3566,145,3.9
29186,11/1/19,9178,8938,240,2.6
29187,11/1/19,26717,25766,951,3.6
29189,11/1/19,536436,520839,15597,2.9
29195,11/1/19,10595,10260,335,3.2
29197,11/1/19,1943,1875,68,3.5
29199,11/1/19,2386,2325,61,2.6
29201,11/1/19,19960,19274,686,3.4
29203,11/1/19,3197,3016,181,5.7
29205,11/1/19,3060,2983,77,2.5
29207,11/1/19,13009,12481,528,4.1
29209,11/1/19,13924,13379,545,3.9
29211,11/1/19,2640,2558,82,3.1
29213,11/1/19,27038,26112,926,3.4
29215,11/1/19,9064,8671,393,4.3
29217,11/1/19,9407,9095,312,3.3
29219,11/1/19,18056,17563,493,2.7
29221,11/1/19,10236,9807,429,4.2
29223,11/1/19,5259,5044,215,4.1
29225,11/1/19,17452,16828,624,3.6
29227,11/1/19,1166,1139,27,2.3
29229,11/1/19,7565,7147,418,5.5
29510,11/1/19,153834,148255,5579,3.6
30001,11/1/19,5080,4925,155,3.1
30003,11/1/19,4833,4512,321,6.6
30005,11/1/19,2540,2450,90,3.5
30007,11/1/19,2599,2494,105,4
30009,11/1/19,5520,5329,191,3.5
30011,11/1/19,681,667,14,2.1
30013,11/1/19,38082,36867,1215,3.2
30015,11/1/19,2526,2465,61,2.4
30017,11/1/19,6149,5987,162,2.6
30019,11/1/19,912,892,20,2.2
30021,11/1/19,4600,4483,117,2.5
30023,11/1/19,4951,4804,147,3
30025,11/1/19,1718,1681,37,2.2
30027,11/1/19,6107,5931,176,2.9
30029,11/1/19,47350,45110,2240,4.7
30031,11/1/19,69227,67352,1875,2.7
30033,11/1/19,750,732,18,2.4
30035,11/1/19,5531,5124,407,7.4
30037,11/1/19,372,356,16,4.3
30039,11/1/19,1598,1501,97,6.1
30041,11/1/19,7715,7445,270,3.5
30043,11/1/19,5704,5516,188,3.3
30045,11/1/19,1023,996,27,2.6
30047,11/1/19,13246,12717,529,4
30049,11/1/19,35722,34728,994,2.8
30051,11/1/19,986,958,28,2.8
30053,11/1/19,8117,7544,573,7.1
30055,11/1/19,971,953,18,1.9
30057,11/1/19,4429,4241,188,4.2
30059,11/1/19,978,947,31,3.2
30061,11/1/19,1714,1624,90,5.3
30063,11/1/19,64012,62028,1984,3.1
30065,11/1/19,2301,2211,90,3.9
30067,11/1/19,8811,8484,327,3.7
30069,11/1/19,288,277,11,3.8
30071,11/1/19,1919,1855,64,3.3
30073,11/1/19,2671,2590,81,3
30075,11/1/19,1000,976,24,2.4
30077,11/1/19,3037,2930,107,3.5
30079,11/1/19,495,478,17,3.4
30081,11/1/19,20408,19677,731,3.6
30083,11/1/19,5971,5827,144,2.4
30085,11/1/19,4505,4343,162,3.6
30087,11/1/19,3848,3676,172,4.5
30089,11/1/19,4849,4616,233,4.8
30091,11/1/19,1758,1718,40,2.3
30093,11/1/19,17202,16570,632,3.7
30095,11/1/19,5352,5201,151,2.8
30097,11/1/19,1837,1790,47,2.6
30099,11/1/19,2779,2689,90,3.2
30101,11/1/19,2115,2054,61,2.9
30103,11/1/19,348,341,7,2
30105,11/1/19,4115,3977,138,3.4
30107,11/1/19,819,791,28,3.4
30109,11/1/19,461,447,14,3
30111,11/1/19,81685,79231,2454,3
31001,11/1/19,16798,16351,447,2.7
31003,11/1/19,3604,3528,76,2.1
31005,11/1/19,234,220,14,6
31007,11/1/19,393,377,16,4.1
31009,11/1/19,270,258,12,4.4
31011,11/1/19,2990,2922,68,2.3
31013,11/1/19,5402,5256,146,2.7
31015,11/1/19,1091,1065,26,2.4
31017,11/1/19,1410,1368,42,3
31019,11/1/19,27858,27216,642,2.3
31021,11/1/19,3484,3378,106,3
31023,11/1/19,4499,4389,110,2.4
31025,11/1/19,13600,13237,363,2.7
31027,11/1/19,4512,4410,102,2.3
31029,11/1/19,2304,2256,48,2.1
31031,11/1/19,3425,3361,64,1.9
31033,11/1/19,4358,4202,156,3.6
31035,11/1/19,3308,3232,76,2.3
31037,11/1/19,5578,5436,142,2.5
31039,11/1/19,4676,4560,116,2.5
31041,11/1/19,6435,6297,138,2.1
31043,11/1/19,10780,10433,347,3.2
31045,11/1/19,4972,4842,130,2.6
31047,11/1/19,13008,12691,317,2.4
31049,11/1/19,965,941,24,2.5
31051,11/1/19,3078,2996,82,2.7
31053,11/1/19,19524,19037,487,2.5
31055,11/1/19,299929,291619,8310,2.8
31057,11/1/19,1200,1170,30,2.5
31059,11/1/19,3149,3087,62,2
31061,11/1/19,1456,1412,44,3
31063,11/1/19,1643,1599,44,2.7
31065,11/1/19,2572,2508,64,2.5
31067,11/1/19,10912,10609,303,2.8
31069,11/1/19,1096,1062,34,3.1
31071,11/1/19,1189,1161,28,2.4
31073,11/1/19,1111,1085,26,2.3
31075,11/1/19,443,431,12,2.7
31077,11/1/19,1219,1191,28,2.3
31079,11/1/19,31535,30655,880,2.8
31081,11/1/19,4776,4646,130,2.7
31083,11/1/19,1781,1737,44,2.5
31085,11/1/19,648,630,18,2.8
31087,11/1/19,1252,1218,34,2.7
31089,11/1/19,5825,5691,134,2.3
31091,11/1/19,441,429,12,2.7
31093,11/1/19,3345,3257,88,2.6
31095,11/1/19,4140,4048,92,2.2
31097,11/1/19,2052,1996,56,2.7
31099,11/1/19,3820,3744,76,2
31101,11/1/19,4545,4401,144,3.2
31103,11/1/19,614,600,14,2.3
31105,11/1/19,2019,1965,54,2.7
31107,11/1/19,4627,4521,106,2.3
31109,11/1/19,178736,174345,4391,2.5
31111,11/1/19,18267,17698,569,3.1
31113,11/1/19,490,474,16,3.3
31115,11/1/19,425,403,22,5.2
31117,11/1/19,451,441,10,2.2
31119,11/1/19,19730,19265,465,2.4
31121,11/1/19,4006,3902,104,2.6
31123,11/1/19,2632,2558,74,2.8
31125,11/1/19,1974,1924,50,2.5
31127,11/1/19,3626,3518,108,3
31129,11/1/19,2428,2372,56,2.3
31131,11/1/19,8448,8245,203,2.4
31133,11/1/19,1481,1447,34,2.3
31135,11/1/19,1844,1804,40,2.2
31137,11/1/19,5002,4884,118,2.4
31139,11/1/19,4096,4004,92,2.2
31141,11/1/19,17652,17223,429,2.4
31143,11/1/19,2972,2898,74,2.5
31145,11/1/19,5871,5729,142,2.4
31147,11/1/19,4184,4080,104,2.5
31149,11/1/19,897,877,20,2.2
31151,11/1/19,7344,7143,201,2.7
31153,11/1/19,96840,94360,2480,2.6
31155,11/1/19,11266,10989,277,2.5
31157,11/1/19,18330,17754,576,3.1
31159,11/1/19,9081,8836,245,2.7
31161,11/1/19,2701,2639,62,2.3
31163,11/1/19,1699,1653,46,2.7
31165,11/1/19,751,729,22,2.9
31167,11/1/19,3515,3441,74,2.1
31169,11/1/19,2762,2696,66,2.4
31171,11/1/19,438,422,16,3.7
31173,11/1/19,3100,2972,128,4.1
31175,11/1/19,2116,2064,52,2.5
31177,11/1/19,11332,11053,279,2.5
31179,11/1/19,5871,5727,144,2.5
31181,11/1/19,1701,1649,52,3.1
31183,11/1/19,588,574,14,2.4
31185,11/1/19,7209,7043,166,2.3
32001,11/1/19,11202,10865,337,3
32003,11/1/19,1139511,1098734,40777,3.6
32005,11/1/19,23070,22281,789,3.4
32007,11/1/19,26857,26159,698,2.6
32009,11/1/19,464,450,14,3
32011,11/1/19,1125,1104,21,1.9
32013,11/1/19,8344,8116,228,2.7
32015,11/1/19,3196,3104,92,2.9
32017,11/1/19,2157,2089,68,3.2
32019,11/1/19,23368,22444,924,4
32021,11/1/19,1991,1926,65,3.3
32023,11/1/19,17591,16814,777,4.4
32027,11/1/19,2584,2492,92,3.6
32029,11/1/19,2072,2007,65,3.1
32031,11/1/19,260090,253047,7043,2.7
32033,11/1/19,4664,4549,115,2.5
32510,11/1/19,26314,25443,871,3.3
33001,11/1/19,31041,30337,704,2.3
33003,11/1/19,22928,22399,529,2.3
33005,11/1/19,41362,40416,946,2.3
33007,11/1/19,14464,14077,387,2.7
33009,11/1/19,49826,48824,1002,2
33011,11/1/19,243591,237725,5866,2.4
33013,11/1/19,84025,82321,1704,2
33015,11/1/19,188306,183633,4673,2.5
33017,11/1/19,74873,73276,1597,2.1
33019,11/1/19,23029,22551,478,2.1
34001,11/1/19,120041,114037,6004,5
34003,11/1/19,489572,475909,13663,2.8
34005,11/1/19,232663,225271,7392,3.2
34007,11/1/19,255265,245085,10180,4
34009,11/1/19,43106,39343,3763,8.7
34011,11/1/19,65723,62244,3479,5.3
34013,11/1/19,371879,355565,16314,4.4
34015,11/1/19,151019,145590,5429,3.6
34017,11/1/19,366921,355070,11851,3.2
34019,11/1/19,65123,63441,1682,2.6
34021,11/1/19,206167,199965,6202,3
34023,11/1/19,441938,428540,13398,3
34025,11/1/19,331470,321235,10235,3.1
34027,11/1/19,258765,251804,6961,2.7
34029,11/1/19,277419,267366,10053,3.6
34031,11/1/19,245597,235549,10048,4.1
34033,11/1/19,29501,28104,1397,4.7
34035,11/1/19,172728,167718,5010,2.9
34037,11/1/19,74596,72187,2409,3.2
34039,11/1/19,278298,268452,9846,3.5
34041,11/1/19,56988,55213,1775,3.1
35001,11/1/19,338926,324718,14208,4.2
35003,11/1/19,1179,1101,78,6.6
35005,11/1/19,27300,25961,1339,4.9
35006,11/1/19,9043,8491,552,6.1
35007,11/1/19,5062,4820,242,4.8
35009,11/1/19,21718,20864,854,3.9
35011,11/1/19,804,773,31,3.9
35013,11/1/19,99237,93970,5267,5.3
35015,11/1/19,35578,34506,1072,3
35017,11/1/19,12528,11955,573,4.6
35019,11/1/19,1533,1465,68,4.4
35021,11/1/19,282,269,13,4.6
35023,11/1/19,2027,1939,88,4.3
35025,11/1/19,32436,31198,1238,3.8
35027,11/1/19,8873,8464,409,4.6
35028,11/1/19,9418,9134,284,3
35029,11/1/19,9787,8485,1302,13.3
35031,11/1/19,24344,22751,1593,6.5
35033,11/1/19,2200,2069,131,6
35035,11/1/19,24952,23766,1186,4.8
35037,11/1/19,3210,3062,148,4.6
35039,11/1/19,16822,15978,844,5
35041,11/1/19,8042,7698,344,4.3
35043,11/1/19,67442,64377,3065,4.5
35045,11/1/19,52437,49496,2941,5.6
35047,11/1/19,11062,10453,609,5.5
35049,11/1/19,76493,73747,2746,3.6
35051,11/1/19,3935,3720,215,5.5
35053,11/1/19,6457,6106,351,5.4
35055,11/1/19,15303,14422,881,5.8
35057,11/1/19,5863,5484,379,6.5
35059,11/1/19,1793,1722,71,4
35061,11/1/19,31115,29548,1567,5
36001,11/1/19,158717,153352,5365,3.4
36003,11/1/19,19846,18823,1023,5.2
36005,11/1/19,592846,565253,27593,4.7
36007,11/1/19,83101,79476,3625,4.4
36009,11/1/19,34014,32368,1646,4.8
36011,11/1/19,35611,34211,1400,3.9
36013,11/1/19,53613,51212,2401,4.5
36015,11/1/19,34987,33640,1347,3.9
36017,11/1/19,21840,20942,898,4.1
36019,11/1/19,36545,35082,1463,4
36021,11/1/19,30966,30060,906,2.9
36023,11/1/19,22974,21925,1049,4.6
36025,11/1/19,19012,18189,823,4.3
36027,11/1/19,144472,139508,4964,3.4
36029,11/1/19,441202,423233,17969,4.1
36031,11/1/19,16183,15437,746,4.6
36033,11/1/19,19466,18564,902,4.6
36035,11/1/19,22650,21586,1064,4.7
36037,11/1/19,29515,28403,1112,3.8
36039,11/1/19,19930,19073,857,4.3
36041,11/1/19,2098,1946,152,7.2
36043,11/1/19,27710,26460,1250,4.5
36045,11/1/19,43582,41017,2565,5.9
36047,11/1/19,1189795,1148557,41238,3.5
36049,11/1/19,11628,11065,563,4.8
36051,11/1/19,30673,29505,1168,3.8
36053,11/1/19,32692,31417,1275,3.9
36055,11/1/19,361419,346865,14554,4
36057,11/1/19,22449,21392,1057,4.7
36059,11/1/19,709026,685255,23771,3.4
36061,11/1/19,906015,878954,27061,3
36063,11/1/19,98686,94064,4622,4.7
36065,11/1/19,100473,96429,4044,4
36067,11/1/19,220786,212563,8223,3.7
36069,11/1/19,55307,53333,1974,3.6
36071,11/1/19,185012,178197,6815,3.7
36073,11/1/19,17574,16792,782,4.4
36075,11/1/19,52937,50252,2685,5.1
36077,11/1/19,27941,26857,1084,3.9
36079,11/1/19,51413,49566,1847,3.6
36081,11/1/19,1132200,1099168,33032,2.9
36083,11/1/19,81709,78878,2831,3.5
36085,11/1/19,220678,213599,7079,3.2
36087,11/1/19,155142,149876,5266,3.4
36089,11/1/19,43781,41597,2184,5
36091,11/1/19,119920,116147,3773,3.1
36093,11/1/19,76648,73902,2746,3.6
36095,11/1/19,14674,14111,563,3.8
36097,11/1/19,7955,7605,350,4.4
36099,11/1/19,16101,15523,578,3.6
36101,11/1/19,42357,40532,1825,4.3
36103,11/1/19,778538,751074,27464,3.5
36105,11/1/19,36499,35063,1436,3.9
36107,11/1/19,22597,21747,850,3.8
36109,11/1/19,49795,48154,1641,3.3
36111,11/1/19,87788,84741,3047,3.5
36113,11/1/19,30909,29472,1437,4.6
36115,11/1/19,27424,26386,1038,3.8
36117,11/1/19,43819,42186,1633,3.7
36119,11/1/19,484262,466686,17576,3.6
36121,11/1/19,17853,17137,716,4
36123,11/1/19,11880,11452,428,3.6
37001,11/1/19,82915,80149,2766,3.3
37003,11/1/19,18187,17666,521,2.9
37005,11/1/19,4470,4282,188,4.2
37007,11/1/19,10942,10511,431,3.9
37009,11/1/19,13178,12787,391,3
37011,11/1/19,7274,7037,237,3.3
37013,11/1/19,19591,18772,819,4.2
37015,11/1/19,7824,7487,337,4.3
37017,11/1/19,14565,13931,634,4.4
37019,11/1/19,53737,51202,2535,4.7
37021,11/1/19,143075,139326,3749,2.6
37023,11/1/19,41520,40116,1404,3.4
37025,11/1/19,110546,106940,3606,3.3
37027,11/1/19,36989,35672,1317,3.6
37029,11/1/19,4656,4487,169,3.6
37031,11/1/19,31993,30892,1101,3.4
37033,11/1/19,10034,9616,418,4.2
37035,11/1/19,79794,77186,2608,3.3
37037,11/1/19,36302,35216,1086,3
37039,11/1/19,11280,10828,452,4
37041,11/1/19,5565,5339,226,4.1
37043,11/1/19,4207,4049,158,3.8
37045,11/1/19,49167,47278,1889,3.8
37047,11/1/19,23159,22128,1031,4.5
37049,11/1/19,42109,40589,1520,3.6
37051,11/1/19,128764,122722,6042,4.7
37053,11/1/19,14102,13656,446,3.2
37055,11/1/19,18789,18065,724,3.9
37057,11/1/19,81744,78942,2802,3.4
37059,11/1/19,20833,20193,640,3.1
37061,11/1/19,25538,24623,915,3.6
37063,11/1/19,173168,167907,5261,3
37065,11/1/19,21538,20400,1138,5.3
37067,11/1/19,189341,182990,6351,3.4
37069,11/1/19,31688,30574,1114,3.5
37071,11/1/19,112797,108584,4213,3.7
37073,11/1/19,5339,5145,194,3.6
37075,11/1/19,3181,3029,152,4.8
37077,11/1/19,30052,29128,924,3.1
37079,11/1/19,9584,9260,324,3.4
37081,11/1/19,266867,257121,9746,3.7
37083,11/1/19,20476,19317,1159,5.7
37085,11/1/19,54175,52020,2155,4
37087,11/1/19,30458,29564,894,2.9
37089,11/1/19,56053,54452,1601,2.9
37091,11/1/19,9202,8790,412,4.5
37093,11/1/19,20321,19393,928,4.6
37095,11/1/19,1944,1737,207,10.6
37097,11/1/19,90819,87772,3047,3.4
37099,11/1/19,20193,19512,681,3.4
37101,11/1/19,100524,97208,3316,3.3
37103,11/1/19,4420,4275,145,3.3
37105,11/1/19,26137,25079,1058,4
37107,11/1/19,28003,26972,1031,3.7
37109,11/1/19,44221,42761,1460,3.3
37111,11/1/19,20606,19859,747,3.6
37113,11/1/19,15701,15180,521,3.3
37115,11/1/19,10331,10013,318,3.1
37117,11/1/19,9130,8727,403,4.4
37119,11/1/19,630869,609814,21055,3.3
37121,11/1/19,6090,5853,237,3.9
37123,11/1/19,11595,11177,418,3.6
37125,11/1/19,42718,41269,1449,3.4
37127,11/1/19,43906,42019,1887,4.3
37129,11/1/19,126424,122534,3890,3.1
37131,11/1/19,7769,7389,380,4.9
37133,11/1/19,65882,63180,2702,4.1
37135,11/1/19,79901,77682,2219,2.8
37137,11/1/19,5374,5199,175,3.3
37139,11/1/19,16759,16055,704,4.2
37141,11/1/19,29460,28416,1044,3.5
37143,11/1/19,4995,4769,226,4.5
37145,11/1/19,18619,17932,687,3.7
37147,11/1/19,91146,87680,3466,3.8
37149,11/1/19,9050,8749,301,3.3
37151,11/1/19,67365,65109,2256,3.3
37153,11/1/19,16774,15940,834,5
37155,11/1/19,50655,48148,2507,4.9
37157,11/1/19,40877,39217,1660,4.1
37159,11/1/19,67378,64745,2633,3.9
37161,11/1/19,25486,24361,1125,4.4
37163,11/1/19,29755,28737,1018,3.4
37165,11/1/19,11654,10933,721,6.2
37167,11/1/19,30597,29553,1044,3.4
37169,11/1/19,21959,21244,715,3.3
37171,11/1/19,34232,33071,1161,3.4
37173,11/1/19,6905,6675,230,3.3
37175,11/1/19,14651,14186,465,3.2
37177,11/1/19,1394,1315,79,5.7
37179,11/1/19,125666,121822,3844,3.1
37181,11/1/19,17435,16481,954,5.5
37183,11/1/19,603895,585916,17979,3
37185,11/1/19,6720,6366,354,5.3
37187,11/1/19,4436,4203,233,5.3
37189,11/1/19,30137,29294,843,2.8
37191,11/1/19,52152,50214,1938,3.7
37193,11/1/19,29577,28529,1048,3.5
37195,11/1/19,34946,33100,1846,5.3
37197,11/1/19,17883,17326,557,3.1
37199,11/1/19,8566,8282,284,3.3
38001,11/1/19,1027,1001,26,2.5
38003,11/1/19,5085,4975,110,2.2
38005,11/1/19,2263,2185,78,3.4
38007,11/1/19,355,345,10,2.8
38009,11/1/19,2855,2786,69,2.4
38011,11/1/19,1689,1656,33,2
38013,11/1/19,1017,998,19,1.9
38015,11/1/19,48917,47933,984,2
38017,11/1/19,102607,100878,1729,1.7
38019,11/1/19,1849,1810,39,2.1
38021,11/1/19,2202,2166,36,1.6
38023,11/1/19,1369,1347,22,1.6
38025,11/1/19,3112,3069,43,1.4
38027,11/1/19,1177,1140,37,3.1
38029,11/1/19,1387,1344,43,3.1
38031,11/1/19,1423,1394,29,2
38033,11/1/19,795,783,12,1.5
38035,11/1/19,37199,36565,634,1.7
38037,11/1/19,1134,1113,21,1.9
38039,11/1/19,978,950,28,2.9
38041,11/1/19,1331,1306,25,1.9
38043,11/1/19,1181,1152,29,2.5
38045,11/1/19,1985,1954,31,1.6
38047,11/1/19,851,833,18,2.1
38049,11/1/19,2950,2875,75,2.5
38051,11/1/19,1063,1038,25,2.4
38053,11/1/19,10277,10110,167,1.6
38055,11/1/19,4510,4385,125,2.8
38057,11/1/19,3376,3237,139,4.1
38059,11/1/19,16009,15607,402,2.5
38061,11/1/19,7386,7282,104,1.4
38063,11/1/19,1323,1292,31,2.3
38065,11/1/19,842,816,26,3.1
38067,11/1/19,3191,3112,79,2.5
38069,11/1/19,1637,1598,39,2.4
38071,11/1/19,5390,5258,132,2.4
38073,11/1/19,2750,2708,42,1.5
38075,11/1/19,1192,1164,28,2.3
38077,11/1/19,8347,8189,158,1.9
38079,11/1/19,4466,4180,286,6.4
38081,11/1/19,2585,2545,40,1.5
38083,11/1/19,647,616,31,4.8
38085,11/1/19,1215,1178,37,3
38087,11/1/19,384,374,10,2.6
38089,11/1/19,18168,17825,343,1.9
38091,11/1/19,937,923,14,1.5
38093,11/1/19,10005,9804,201,2
38095,11/1/19,1047,1021,26,2.5
38097,11/1/19,4289,4211,78,1.8
38099,11/1/19,4924,4802,122,2.5
38101,11/1/19,31058,30420,638,2.1
38103,11/1/19,1800,1757,43,2.4
38105,11/1/19,24290,23869,421,1.7
39001,11/1/19,10576,9946,630,6
39003,11/1/19,47691,45916,1775,3.7
39005,11/1/19,26645,25631,1014,3.8
39007,11/1/19,44147,42236,1911,4.3
39009,11/1/19,29411,28122,1289,4.4
39011,11/1/19,24785,24112,673,2.7
39013,11/1/19,30513,28759,1754,5.7
39015,11/1/19,19561,18681,880,4.5
39017,11/1/19,195670,188945,6725,3.4
39019,11/1/19,12972,12340,632,4.9
39021,11/1/19,20143,19445,698,3.5
39023,11/1/19,63271,60614,2657,4.2
39025,11/1/19,107016,103469,3547,3.3
39027,11/1/19,17752,17004,748,4.2
39029,11/1/19,47252,45214,2038,4.3
39031,11/1/19,14081,13297,784,5.6
39033,11/1/19,18144,17352,792,4.4
39035,11/1/19,612496,591283,21213,3.5
39037,11/1/19,25584,24720,864,3.4
39039,11/1/19,18037,17327,710,3.9
39041,11/1/19,111602,108363,3239,2.9
39043,11/1/19,35567,33836,1731,4.9
39045,11/1/19,78740,76076,2664,3.4
39047,11/1/19,13929,13456,473,3.4
39049,11/1/19,705714,682946,22768,3.2
39051,11/1/19,22407,21618,789,3.5
39053,11/1/19,12113,11534,579,4.8
39055,11/1/19,48973,47637,1336,2.7
39057,11/1/19,83500,80676,2824,3.4
39059,11/1/19,18401,17430,971,5.3
39061,11/1/19,417324,403046,14278,3.4
39063,11/1/19,41904,40666,1238,3
39065,11/1/19,13669,13156,513,3.8
39067,11/1/19,6699,6320,379,5.7
39069,11/1/19,13243,12758,485,3.7
39071,11/1/19,16973,16136,837,4.9
39073,11/1/19,13172,12659,513,3.9
39075,11/1/19,20450,19901,549,2.7
39077,11/1/19,27405,25971,1434,5.2
39079,11/1/19,12538,11803,735,5.9
39081,11/1/19,27658,26154,1504,5.4
39083,11/1/19,31503,30419,1084,3.4
39085,11/1/19,126159,122461,3698,2.9
39087,11/1/19,23846,22751,1095,4.6
39089,11/1/19,91325,88246,3079,3.4
39091,11/1/19,22640,21864,776,3.4
39093,11/1/19,153505,148017,5488,3.6
39095,11/1/19,210971,202313,8658,4.1
39097,11/1/19,20897,20267,630,3
39099,11/1/19,102263,96889,5374,5.3
39101,11/1/19,28161,27170,991,3.5
39103,11/1/19,97482,94769,2713,2.8
39105,11/1/19,9080,8531,549,6
39107,11/1/19,22982,22438,544,2.4
39109,11/1/19,54297,52477,1820,3.4
39111,11/1/19,5299,4864,435,8.2
39113,11/1/19,253625,243925,9700,3.8
39115,11/1/19,6625,6220,405,6.1
39117,11/1/19,16940,16313,627,3.7
39119,11/1/19,39895,38141,1754,4.4
39121,11/1/19,4635,4337,298,6.4
39123,11/1/19,20238,19040,1198,5.9
39125,11/1/19,8559,8217,342,4
39127,11/1/19,16050,15269,781,4.9
39129,11/1/19,26628,25687,941,3.5
39131,11/1/19,10690,10065,625,5.8
39133,11/1/19,87685,84283,3402,3.9
39135,11/1/19,21100,20395,705,3.3
39137,11/1/19,18601,18082,519,2.8
39139,11/1/19,52036,49776,2260,4.3
39141,11/1/19,35462,33999,1463,4.1
39143,11/1/19,30147,28913,1234,4.1
39145,11/1/19,28964,27349,1615,5.6
39147,11/1/19,27129,26110,1019,3.8
39149,11/1/19,23838,23093,745,3.1
39151,11/1/19,186121,178234,7887,4.2
39153,11/1/19,273367,262926,10441,3.8
39155,11/1/19,86139,81205,4934,5.7
39157,11/1/19,44630,42827,1803,4
39159,11/1/19,29164,28294,870,3
39161,11/1/19,14897,14399,498,3.3
39163,11/1/19,5525,5217,308,5.6
39165,11/1/19,119510,115715,3795,3.2
39167,11/1/19,27404,26013,1391,5.1
39169,11/1/19,61802,59961,1841,3
39171,11/1/19,18876,18297,579,3.1
39173,11/1/19,71443,69137,2306,3.2
39175,11/1/19,12797,12431,366,2.9
40001,11/1/19,8174,7846,328,4
40003,11/1/19,2859,2797,62,2.2
40005,11/1/19,4963,4740,223,4.5
40007,11/1/19,2936,2882,54,1.8
40009,11/1/19,10053,9647,406,4
40011,11/1/19,4739,4637,102,2.2
40013,11/1/19,21354,20744,610,2.9
40015,11/1/19,11918,11473,445,3.7
40017,11/1/19,75151,72962,2189,2.9
40019,11/1/19,21594,20848,746,3.5
40021,11/1/19,18747,18062,685,3.7
40023,11/1/19,5377,5120,257,4.8
40025,11/1/19,1367,1345,22,1.6
40027,11/1/19,143943,140173,3770,2.6
40029,11/1/19,2425,2313,112,4.6
40031,11/1/19,48424,46733,1691,3.5
40033,11/1/19,2759,2665,94,3.4
40035,11/1/19,5919,5709,210,3.5
40037,11/1/19,31809,30641,1168,3.7
40039,11/1/19,15746,15311,435,2.8
40041,11/1/19,17984,17343,641,3.6
40043,11/1/19,2920,2839,81,2.8
40045,11/1/19,2136,2075,61,2.9
40047,11/1/19,26875,26067,808,3
40049,11/1/19,12572,12153,419,3.3
40051,11/1/19,26847,25967,880,3.3
40053,11/1/19,2650,2604,46,1.7
40055,11/1/19,1863,1785,78,4.2
40057,11/1/19,1183,1151,32,2.7
40059,11/1/19,1795,1738,57,3.2
40061,11/1/19,4242,3976,266,6.3
40063,11/1/19,5368,5107,261,4.9
40065,11/1/19,10777,10468,309,2.9
40067,11/1/19,2526,2451,75,3
40069,11/1/19,3712,3534,178,4.8
40071,11/1/19,18313,17561,752,4.1
40073,11/1/19,9167,8989,178,1.9
40075,11/1/19,3468,3345,123,3.5
40077,11/1/19,3158,2930,228,7.2
40079,11/1/19,19154,18260,894,4.7
40081,11/1/19,15926,15379,547,3.4
40083,11/1/19,22288,21697,591,2.7
40085,11/1/19,6207,6065,142,2.3
40087,11/1/19,19882,19323,559,2.8
40089,11/1/19,14618,13778,840,5.7
40091,11/1/19,7170,6735,435,6.1
40093,11/1/19,3842,3764,78,2
40095,11/1/19,6873,6648,225,3.3
40097,11/1/19,19463,18904,559,2.9
40099,11/1/19,6338,6140,198,3.1
40101,11/1/19,29837,28765,1072,3.6
40103,11/1/19,5656,5516,140,2.5
40105,11/1/19,4615,4476,139,3
40107,11/1/19,4614,4386,228,4.9
40109,11/1/19,387919,376283,11636,3
40111,11/1/19,15842,15061,781,4.9
40113,11/1/19,20835,20088,747,3.6
40115,11/1/19,14057,13622,435,3.1
40117,11/1/19,7412,7124,288,3.9
40119,11/1/19,37990,36988,1002,2.6
40121,11/1/19,17094,16301,793,4.6
40123,11/1/19,19355,18823,532,2.7
40125,11/1/19,32734,31553,1181,3.6
40127,11/1/19,4302,4084,218,5.1
40129,11/1/19,1895,1830,65,3.4
40131,11/1/19,45417,44080,1337,2.9
40133,11/1/19,9560,9090,470,4.9
40135,11/1/19,16283,15587,696,4.3
40137,11/1/19,18461,17566,895,4.8
40139,11/1/19,11356,11158,198,1.7
40141,11/1/19,3012,2904,108,3.6
40143,11/1/19,325137,315066,10071,3.1
40145,11/1/19,38243,37035,1208,3.2
40147,11/1/19,22177,21463,714,3.2
40149,11/1/19,5272,5060,212,4
40151,11/1/19,4660,4579,81,1.7
40153,11/1/19,8946,8619,327,3.7
41001,11/1/19,7170,6898,272,3.8
41003,11/1/19,49105,48079,1026,2.1
41005,11/1/19,220206,214357,5849,2.7
41007,11/1/19,19154,18556,598,3.1
41009,11/1/19,24464,23567,897,3.7
41011,11/1/19,25951,24988,963,3.7
41013,11/1/19,9494,9078,416,4.4
41015,11/1/19,8732,8347,385,4.4
41017,11/1/19,95449,92618,2831,3
41019,11/1/19,46139,44373,1766,3.8
41021,11/1/19,860,832,28,3.3
41023,11/1/19,3109,2942,167,5.4
41025,11/1/19,3534,3417,117,3.3
41027,11/1/19,13745,13416,329,2.4
41029,11/1/19,103552,100344,3208,3.1
41031,11/1/19,9892,9516,376,3.8
41033,11/1/19,35590,34207,1383,3.9
41035,11/1/19,28736,27303,1433,5
41037,11/1/19,3566,3441,125,3.5
41039,11/1/19,181668,175938,5730,3.2
41041,11/1/19,20362,19601,761,3.7
41043,11/1/19,58829,56836,1993,3.4
41045,11/1/19,12360,11997,363,2.9
41047,11/1/19,161709,156807,4902,3
41049,11/1/19,5592,5413,179,3.2
41051,11/1/19,456657,444753,11904,2.6
41053,11/1/19,40068,38821,1247,3.1
41055,11/1/19,919,888,31,3.4
41057,11/1/19,11586,11231,355,3.1
41059,11/1/19,36003,34726,1277,3.5
41061,11/1/19,11758,11348,410,3.5
41063,11/1/19,3268,3131,137,4.2
41065,11/1/19,12552,12124,428,3.4
41067,11/1/19,326588,318684,7904,2.4
41069,11/1/19,719,694,25,3.5
41071,11/1/19,54687,53222,1465,2.7
42001,11/1/19,55091,53335,1756,3.2
42003,11/1/19,654502,627714,26788,4.1
42005,11/1/19,32557,30842,1715,5.3
42007,11/1/19,84788,80923,3865,4.6
42009,11/1/19,23433,22358,1075,4.6
42011,11/1/19,217344,207931,9413,4.3
42013,11/1/19,59482,56762,2720,4.6
42015,11/1/19,28757,27477,1280,4.5
42017,11/1/19,346722,333495,13227,3.8
42019,11/1/19,100589,96713,3876,3.9
42021,11/1/19,58468,55391,3077,5.3
42023,11/1/19,2054,1923,131,6.4
42025,11/1/19,32625,30914,1711,5.2
42027,11/1/19,82187,79502,2685,3.3
42029,11/1/19,286184,277109,9075,3.2
42031,11/1/19,17307,16458,849,4.9
42033,11/1/19,36198,34314,1884,5.2
42035,11/1/19,18308,17338,970,5.3
42037,11/1/19,33913,32437,1476,4.4
42039,11/1/19,38604,36708,1896,4.9
42041,11/1/19,133740,129291,4449,3.3
42043,11/1/19,146182,140351,5831,4
42045,11/1/19,303962,291669,12293,4
42047,11/1/19,15421,14466,955,6.2
42049,11/1/19,129217,123269,5948,4.6
42051,11/1/19,57706,54216,3490,6
42053,11/1/19,1788,1669,119,6.7
42055,11/1/19,78498,75533,2965,3.8
42057,11/1/19,7857,7532,325,4.1
42059,11/1/19,16809,15900,909,5.4
42061,11/1/19,20060,18867,1193,5.9
42063,11/1/19,39734,37733,2001,5
42065,11/1/19,20490,19479,1011,4.9
42067,11/1/19,12493,11993,500,4
42069,11/1/19,106306,101152,5154,4.8
42071,11/1/19,286594,276970,9624,3.4
42073,11/1/19,40777,38709,2068,5.1
42075,11/1/19,72858,70039,2819,3.9
42077,11/1/19,195668,187255,8413,4.3
42079,11/1/19,159300,150351,8949,5.6
42081,11/1/19,57158,54444,2714,4.7
42083,11/1/19,17388,16365,1023,5.9
42085,11/1/19,49103,46591,2512,5.1
42087,11/1/19,21064,20086,978,4.6
42089,11/1/19,83705,79119,4586,5.5
42091,11/1/19,458352,442325,16027,3.5
42093,11/1/19,9235,8925,310,3.4
42095,11/1/19,163805,156802,7003,4.3
42097,11/1/19,42750,40293,2457,5.7
42099,11/1/19,24698,23788,910,3.7
42101,11/1/19,733292,692512,40780,5.6
42103,11/1/19,25465,24031,1434,5.6
42105,11/1/19,7118,6681,437,6.1
42107,11/1/19,66547,62923,3624,5.4
42109,11/1/19,20192,19213,979,4.8
42111,11/1/19,33529,31702,1827,5.4
42113,11/1/19,2658,2497,161,6.1
42115,11/1/19,20478,19601,877,4.3
42117,11/1/19,19277,18266,1011,5.2
42119,11/1/19,20015,19261,754,3.8
42121,11/1/19,22311,21158,1153,5.2
42123,11/1/19,18859,17996,863,4.6
42125,11/1/19,108144,103183,4961,4.6
42127,11/1/19,21984,20982,1002,4.6
42129,11/1/19,182665,174577,8088,4.4
42131,11/1/19,13721,13049,672,4.9
42133,11/1/19,238331,229333,8998,3.8
44001,11/1/19,26301,25547,754,2.9
44003,11/1/19,91638,88933,2705,3
44005,11/1/19,44690,43451,1239,2.8
44007,11/1/19,328354,316914,11440,3.5
44009,11/1/19,69503,67409,2094,3
45001,11/1/19,10104,9802,302,3
45003,11/1/19,74754,73038,1716,2.3
45005,11/1/19,2644,2527,117,4.4
45007,11/1/19,91561,89578,1983,2.2
45009,11/1/19,4933,4704,229,4.6
45011,11/1/19,8157,7876,281,3.4
45013,11/1/19,77607,76027,1580,2
45015,11/1/19,104458,102325,2133,2
45017,11/1/19,6600,6418,182,2.8
45019,11/1/19,211899,208118,3781,1.8
45021,11/1/19,25289,24654,635,2.5
45023,11/1/19,13478,13019,459,3.4
45025,11/1/19,21903,21401,502,2.3
45027,11/1/19,12641,12235,406,3.2
45029,11/1/19,16694,16269,425,2.5
45031,11/1/19,30439,29616,823,2.7
45033,11/1/19,12969,12535,434,3.3
45035,11/1/19,78389,76867,1522,1.9
45037,11/1/19,10671,10433,238,2.2
45039,11/1/19,9626,9281,345,3.6
45041,11/1/19,66991,65446,1545,2.3
45043,11/1/19,25458,24714,744,2.9
45045,11/1/19,256029,251056,4973,1.9
45047,11/1/19,31514,30708,806,2.6
45049,11/1/19,8356,8180,176,2.1
45051,11/1/19,145239,141181,4058,2.8
45053,11/1/19,12562,12327,235,1.9
45055,11/1/19,29398,28702,696,2.4
45057,11/1/19,41483,40332,1151,2.8
45059,11/1/19,30280,29529,751,2.5
45061,11/1/19,6632,6394,238,3.6
45063,11/1/19,150943,148155,2788,1.8
45065,11/1/19,3357,3274,83,2.5
45067,11/1/19,12812,12383,429,3.3
45069,11/1/19,9185,8851,334,3.6
45071,11/1/19,19111,18673,438,2.3
45073,11/1/19,35230,34478,752,2.1
45075,11/1/19,34763,33373,1390,4
45077,11/1/19,57671,56334,1337,2.3
45079,11/1/19,200123,195721,4402,2.2
45081,11/1/19,8910,8711,199,2.2
45083,11/1/19,153532,150364,3168,2.1
45085,11/1/19,43661,42451,1210,2.8
45087,11/1/19,11649,11326,323,2.8
45089,11/1/19,11815,11367,448,3.8
45091,11/1/19,141067,137920,3147,2.2
46003,11/1/19,1500,1458,42,2.8
46005,11/1/19,9548,9249,299,3.1
46007,11/1/19,1105,1041,64,5.8
46009,11/1/19,2850,2752,98,3.4
46011,11/1/19,19770,19071,699,3.5
46013,11/1/19,20878,20243,635,3
46015,11/1/19,2450,2377,73,3
46017,11/1/19,685,627,58,8.5
46019,11/1/19,5043,4861,182,3.6
46021,11/1/19,765,738,27,3.5
46023,11/1/19,3725,3569,156,4.2
46025,11/1/19,1900,1838,62,3.3
46027,11/1/19,7851,7561,290,3.7
46029,11/1/19,15631,15179,452,2.9
46031,11/1/19,1388,1305,83,6
46033,11/1/19,3971,3797,174,4.4
46035,11/1/19,11116,10797,319,2.9
46037,11/1/19,2757,2647,110,4
46039,11/1/19,2141,2064,77,3.6
46041,11/1/19,2232,2066,166,7.4
46043,11/1/19,1572,1531,41,2.6
46045,11/1/19,2031,1975,56,2.8
46047,11/1/19,2893,2769,124,4.3
46049,11/1/19,1060,1023,37,3.5
46051,11/1/19,4413,4289,124,2.8
46053,11/1/19,2107,2039,68,3.2
46055,11/1/19,1057,1024,33,3.1
46057,11/1/19,3374,3279,95,2.8
46059,11/1/19,1805,1753,52,2.9
46061,11/1/19,1741,1658,83,4.8
46063,11/1/19,727,706,21,2.9
46065,11/1/19,10052,9789,263,2.6
46067,11/1/19,3577,3473,104,2.9
46069,11/1/19,677,656,21,3.1
46071,11/1/19,1198,1121,77,6.4
46073,11/1/19,1117,1086,31,2.8
46075,11/1/19,527,512,15,2.8
46077,11/1/19,2627,2552,75,2.9
46079,11/1/19,6782,6543,239,3.5
46081,11/1/19,13426,12976,450,3.4
46083,11/1/19,34961,34075,886,2.5
46085,11/1/19,1695,1622,73,4.3
46087,11/1/19,3088,3003,85,2.8
46089,11/1/19,1009,963,46,4.6
46091,11/1/19,2365,2280,85,3.6
46093,11/1/19,14051,13566,485,3.5
46095,11/1/19,741,689,52,7
46097,11/1/19,1189,1150,39,3.3
46099,11/1/19,114338,111092,3246,2.8
46101,11/1/19,4029,3902,127,3.2
46102,11/1/19,3625,3243,382,10.5
46103,11/1/19,56602,54604,1998,3.5
46105,11/1/19,1410,1364,46,3.3
46107,11/1/19,1036,1001,35,3.4
46109,11/1/19,4948,4751,197,4
46111,11/1/19,1144,1109,35,3.1
46115,11/1/19,3133,3035,98,3.1
46117,11/1/19,1838,1790,48,2.6
46119,11/1/19,790,769,21,2.7
46121,11/1/19,3164,2950,214,6.8
46123,11/1/19,3070,2985,85,2.8
46125,11/1/19,4714,4577,137,2.9
46127,11/1/19,8644,8331,313,3.6
46129,11/1/19,2106,2006,100,4.7
46135,11/1/19,11949,11598,351,2.9
46137,11/1/19,939,885,54,5.8
47001,11/1/19,35045,33924,1121,3.2
47003,11/1/19,21327,20598,729,3.4
47005,11/1/19,6899,6627,272,3.9
47007,11/1/19,4471,4247,224,5
47009,11/1/19,64482,62598,1884,2.9
47011,11/1/19,54464,52807,1657,3
47013,11/1/19,15067,14412,655,4.3
47015,11/1/19,6777,6590,187,2.8
47017,11/1/19,12121,11618,503,4.1
47019,11/1/19,24276,23416,860,3.5
47021,11/1/19,22430,21893,537,2.4
47023,11/1/19,8684,8407,277,3.2
47025,11/1/19,13222,12708,514,3.9
47027,11/1/19,2813,2653,160,5.7
47029,11/1/19,15013,14420,593,3.9
47031,11/1/19,25930,25084,846,3.3
47033,11/1/19,7188,6960,228,3.2
47035,11/1/19,23880,22850,1030,4.3
47037,11/1/19,413696,404061,9635,2.3
47039,11/1/19,4596,4373,223,4.9
47041,11/1/19,7843,7531,312,4
47043,11/1/19,27691,26951,740,2.7
47045,11/1/19,16698,15967,731,4.4
47047,11/1/19,19650,18948,702,3.6
47049,11/1/19,7733,7421,312,4
47051,11/1/19,20702,20026,676,3.3
47053,11/1/19,22458,21546,912,4.1
47055,11/1/19,15175,14630,545,3.6
47057,11/1/19,9703,9346,357,3.7
47059,11/1/19,29719,28508,1211,4.1
47061,11/1/19,5105,4905,200,3.9
47063,11/1/19,28633,27595,1038,3.6
47065,11/1/19,185417,179784,5633,3
47067,11/1/19,2156,2049,107,5
47069,11/1/19,9684,9200,484,5
47071,11/1/19,10536,10113,423,4
47073,11/1/19,23949,23009,940,3.9
47075,11/1/19,7882,7547,335,4.3
47077,11/1/19,12377,11885,492,4
47079,11/1/19,14288,13737,551,3.9
47081,11/1/19,11744,11419,325,2.8
47083,11/1/19,3341,3203,138,4.1
47085,11/1/19,9003,8684,319,3.5
47087,11/1/19,4749,4555,194,4.1
47089,11/1/19,24959,24148,811,3.2
47091,11/1/19,7832,7582,250,3.2
47093,11/1/19,247278,240724,6554,2.7
47095,11/1/19,1772,1689,83,4.7
47097,11/1/19,9893,9396,497,5
47099,11/1/19,19678,18947,731,3.7
47101,11/1/19,5335,5162,173,3.2
47103,11/1/19,16761,16021,740,4.4
47105,11/1/19,23976,23223,753,3.1
47107,11/1/19,23988,23155,833,3.5
47109,11/1/19,8665,8245,420,4.8
47111,11/1/19,11744,11404,340,2.9
47113,11/1/19,49425,47792,1633,3.3
47115,11/1/19,12600,12087,513,4.1
47117,11/1/19,15897,15344,553,3.5
47119,11/1/19,50644,49229,1415,2.8
47121,11/1/19,5246,5036,210,4
47123,11/1/19,20412,19707,705,3.5
47125,11/1/19,86707,83629,3078,3.5
47127,11/1/19,3707,3609,98,2.6
47129,11/1/19,8010,7722,288,3.6
47131,11/1/19,12592,12092,500,4
47133,11/1/19,10203,9876,327,3.2
47135,11/1/19,3136,3003,133,4.2
47137,11/1/19,2410,2304,106,4.4
47139,11/1/19,7862,7596,266,3.4
47141,11/1/19,35860,34735,1125,3.1
47143,11/1/19,13622,12991,631,4.6
47145,11/1/19,23709,22863,846,3.6
47147,11/1/19,39148,38118,1030,2.6
47149,11/1/19,188619,184095,4524,2.4
47151,11/1/19,8309,7984,325,3.9
47153,11/1/19,6262,6015,247,3.9
47155,11/1/19,54890,53515,1375,2.5
47157,11/1/19,450811,434025,16786,3.7
47159,11/1/19,9723,9462,261,2.7
47161,11/1/19,5575,5356,219,3.9
47163,11/1/19,70666,68295,2371,3.4
47165,11/1/19,104891,102260,2631,2.5
47167,11/1/19,28632,27597,1035,3.6
47169,11/1/19,5570,5421,149,2.7
47171,11/1/19,7268,6940,328,4.5
47173,11/1/19,7725,7449,276,3.6
47175,11/1/19,2065,1985,80,3.9
47177,11/1/19,16909,16276,633,3.7
47179,11/1/19,61210,59255,1955,3.2
47181,11/1/19,6282,6002,280,4.5
47183,11/1/19,16408,15844,564,3.4
47185,11/1/19,12441,12018,423,3.4
47187,11/1/19,131645,128670,2975,2.3
47189,11/1/19,78634,76686,1948,2.5
48001,11/1/19,24148,23468,680,2.8
48003,11/1/19,9863,9632,231,2.3
48005,11/1/19,36071,34659,1412,3.9
48007,11/1/19,9445,9072,373,3.9
48009,11/1/19,4154,4043,111,2.7
48011,11/1/19,928,905,23,2.5
48013,11/1/19,21929,21163,766,3.5
48015,11/1/19,14222,13737,485,3.4
48017,11/1/19,2415,2333,82,3.4
48019,11/1/19,10155,9847,308,3
48021,11/1/19,43397,42178,1219,2.8
48023,11/1/19,1783,1744,39,2.2
48025,11/1/19,9848,9408,440,4.5
48027,11/1/19,145914,140640,5274,3.6
48029,11/1/19,962122,933297,28825,3
48031,11/1/19,6486,6341,145,2.2
48033,11/1/19,422,413,9,2.1
48035,11/1/19,8327,8046,281,3.4
48037,11/1/19,40176,38554,1622,4
48039,11/1/19,181882,174206,7676,4.2
48041,11/1/19,123148,120063,3085,2.5
48043,11/1/19,4190,4079,111,2.6
48045,11/1/19,563,544,19,3.4
48047,11/1/19,2569,2442,127,4.9
48049,11/1/19,15509,14932,577,3.7
48051,11/1/19,8640,8364,276,3.2
48053,11/1/19,23638,23004,634,2.7
48055,11/1/19,19904,19277,627,3.2
48057,11/1/19,12196,11793,403,3.3
48059,11/1/19,6209,6028,181,2.9
48061,11/1/19,167329,158361,8968,5.4
48063,11/1/19,5003,4794,209,4.2
48065,11/1/19,3013,2938,75,2.5
48067,11/1/19,12414,11900,514,4.1
48069,11/1/19,3351,3268,83,2.5
48071,11/1/19,19696,18845,851,4.3
48073,11/1/19,20929,20121,808,3.9
48075,11/1/19,2911,2820,91,3.1
48077,11/1/19,4938,4798,140,2.8
48079,11/1/19,1084,1049,35,3.2
48081,11/1/19,1467,1422,45,3.1
48083,11/1/19,2847,2729,118,4.1
48085,11/1/19,572761,556059,16702,2.9
48087,11/1/19,1144,1105,39,3.4
48089,11/1/19,9797,9508,289,2.9
48091,11/1/19,74243,72119,2124,2.9
48093,11/1/19,5605,5414,191,3.4
48095,11/1/19,1307,1269,38,2.9
48097,11/1/19,19784,19236,548,2.8
48099,11/1/19,24466,23544,922,3.8
48101,11/1/19,549,521,28,5.1
48103,11/1/19,1577,1513,64,4.1
48105,11/1/19,1617,1561,56,3.5
48107,11/1/19,2464,2379,85,3.4
48109,11/1/19,1054,1012,42,4
48111,11/1/19,3837,3761,76,2
48113,11/1/19,1386025,1340838,45187,3.3
48115,11/1/19,4635,4455,180,3.9
48117,11/1/19,8419,8191,228,2.7
48119,11/1/19,2452,2369,83,3.4
48121,11/1/19,502765,488652,14113,2.8
48123,11/1/19,9777,9518,259,2.6
48125,11/1/19,664,636,28,4.2
48127,11/1/19,7338,7151,187,2.5
48129,11/1/19,1393,1348,45,3.2
48131,11/1/19,4920,4691,229,4.7
48133,11/1/19,8201,7947,254,3.1
48135,11/1/19,88379,85816,2563,2.9
48137,11/1/19,1132,1112,20,1.8
48139,11/1/19,94079,91364,2715,2.9
48141,11/1/19,367074,353523,13551,3.7
48143,11/1/19,20957,20264,693,3.3
48145,11/1/19,6588,6389,199,3
48147,11/1/19,17432,16975,457,2.6
48149,11/1/19,12000,11697,303,2.5
48151,11/1/19,1612,1568,44,2.7
48153,11/1/19,2516,2425,91,3.6
48155,11/1/19,584,568,16,2.7
48157,11/1/19,396637,383473,13164,3.3
48159,11/1/19,4626,4464,162,3.5
48161,11/1/19,6367,6054,313,4.9
48163,11/1/19,10324,10058,266,2.6
48165,11/1/19,9715,9480,235,2.4
48167,11/1/19,167238,160772,6466,3.9
48169,11/1/19,2157,2100,57,2.6
48171,11/1/19,13593,13283,310,2.3
48173,11/1/19,774,759,15,1.9
48175,11/1/19,3283,3166,117,3.6
48177,11/1/19,9484,9227,257,2.7
48179,11/1/19,8054,7759,295,3.7
48181,11/1/19,64467,62526,1941,3
48183,11/1/19,58633,56528,2105,3.6
48185,11/1/19,11378,10934,444,3.9
48187,11/1/19,82531,80234,2297,2.8
48189,11/1/19,11994,11493,501,4.2
48191,11/1/19,1046,996,50,4.8
48193,11/1/19,3634,3536,98,2.7
48195,11/1/19,2703,2643,60,2.2
48197,11/1/19,1721,1670,51,3
48199,11/1/19,25500,24367,1133,4.4
48201,11/1/19,2343231,2256589,86642,3.7
48203,11/1/19,29692,28521,1171,3.9
48205,11/1/19,2763,2715,48,1.7
48207,11/1/19,2270,2198,72,3.2
48209,11/1/19,121499,118328,3171,2.6
48211,11/1/19,1895,1842,53,2.8
48213,11/1/19,36778,35539,1239,3.4
48215,11/1/19,356747,334685,22062,6.2
48217,11/1/19,16563,16049,514,3.1
48219,11/1/19,11210,10900,310,2.8
48221,11/1/19,27974,27046,928,3.3
48223,11/1/19,17607,17085,522,3
48225,11/1/19,10488,10165,323,3.1
48227,11/1/19,14107,13666,441,3.1
48229,11/1/19,1824,1745,79,4.3
48231,11/1/19,44059,42565,1494,3.4
48233,11/1/19,8731,8360,371,4.2
48235,11/1/19,754,738,16,2.1
48237,11/1/19,3435,3318,117,3.4
48239,11/1/19,7652,7427,225,2.9
48241,11/1/19,12845,12069,776,6
48243,11/1/19,985,954,31,3.1
48245,11/1/19,107505,101593,5912,5.5
48247,11/1/19,1870,1785,85,4.5
48249,11/1/19,16678,15836,842,5
48251,11/1/19,83581,80974,2607,3.1
48253,11/1/19,5798,5571,227,3.9
48255,11/1/19,7343,7159,184,2.5
48257,11/1/19,65668,63603,2065,3.1
48259,11/1/19,22328,21748,580,2.6
48261,11/1/19,200,191,9,4.5
48263,11/1/19,471,458,13,2.8
48265,11/1/19,22417,21775,642,2.9
48267,11/1/19,1833,1776,57,3.1
48269,11/1/19,230,226,4,1.7
48271,11/1/19,1381,1331,50,3.6
48273,11/1/19,13628,13043,585,4.3
48275,11/1/19,1402,1358,44,3.1
48277,11/1/19,24302,23505,797,3.3
48279,11/1/19,5226,5046,180,3.4
48281,11/1/19,9329,9028,301,3.2
48283,11/1/19,4302,4185,117,2.7
48285,11/1/19,8472,8229,243,2.9
48287,11/1/19,10023,9756,267,2.7
48289,11/1/19,6325,6058,267,4.2
48291,11/1/19,33452,31787,1665,5
48293,11/1/19,8622,8292,330,3.8
48295,11/1/19,1606,1567,39,2.4
48297,11/1/19,5650,5479,171,3
48299,11/1/19,8700,8424,276,3.2
48301,11/1/19,654,650,4,0.6
48303,11/1/19,159358,155193,4165,2.6
48305,11/1/19,2754,2677,77,2.8
48307,11/1/19,3339,3180,159,4.8
48309,11/1/19,120631,116878,3753,3.1
48311,11/1/19,888,873,15,1.7
48313,11/1/19,4532,4351,181,4
48315,11/1/19,4250,4064,186,4.4
48317,11/1/19,2891,2808,83,2.9
48319,11/1/19,1744,1690,54,3.1
48321,11/1/19,16749,15792,957,5.7
48323,11/1/19,23914,22238,1676,7
48325,11/1/19,22048,21377,671,3
48327,11/1/19,869,840,29,3.3
48329,11/1/19,108232,105951,2281,2.1
48331,11/1/19,9701,9274,427,4.4
48333,11/1/19,1906,1846,60,3.1
48335,11/1/19,2328,2243,85,3.7
48337,11/1/19,9399,9143,256,2.7
48339,11/1/19,287306,277749,9557,3.3
48341,11/1/19,10832,10586,246,2.3
48343,11/1/19,4805,4565,240,5
48345,11/1/19,471,455,16,3.4
48347,11/1/19,28231,27211,1020,3.6
48349,11/1/19,24593,23883,710,2.9
48351,11/1/19,5201,4893,308,5.9
48353,11/1/19,7209,7001,208,2.9
48355,11/1/19,168435,161845,6590,3.9
48357,11/1/19,4312,4186,126,2.9
48359,11/1/19,916,890,26,2.8
48361,11/1/19,36662,34823,1839,5
48363,11/1/19,13625,13223,402,3
48365,11/1/19,10139,9720,419,4.1
48367,11/1/19,68425,66491,1934,2.8
48369,11/1/19,4813,4708,105,2.2
48371,11/1/19,6358,6131,227,3.6
48373,11/1/19,18200,17338,862,4.7
48375,11/1/19,55722,54246,1476,2.6
48377,11/1/19,3137,2889,248,7.9
48379,11/1/19,6027,5860,167,2.8
48381,11/1/19,72723,71054,1669,2.3
48383,11/1/19,1907,1856,51,2.7
48385,11/1/19,995,956,39,3.9
48387,11/1/19,5138,4910,228,4.4
48389,11/1/19,12051,11839,212,1.8
48391,11/1/19,3123,3009,114,3.7
48393,11/1/19,415,405,10,2.4
48395,11/1/19,7866,7606,260,3.3
48397,11/1/19,52915,51363,1552,2.9
48399,11/1/19,4595,4466,129,2.8
48401,11/1/19,23193,22354,839,3.6
48403,11/1/19,3663,3423,240,6.6
48405,11/1/19,3424,3249,175,5.1
48407,11/1/19,11854,11313,541,4.6
48409,11/1/19,30024,28481,1543,5.1
48411,11/1/19,2564,2492,72,2.8
48413,11/1/19,1299,1258,41,3.2
48415,11/1/19,6731,6518,213,3.2
48417,11/1/19,1875,1834,41,2.2
48419,11/1/19,11213,10773,440,3.9
48421,11/1/19,1351,1319,32,2.4
48423,11/1/19,108146,104653,3493,3.2
48425,11/1/19,4432,4283,149,3.4
48427,11/1/19,25426,22643,2783,10.9
48429,11/1/19,4036,3922,114,2.8
48431,11/1/19,561,542,19,3.4
48433,11/1/19,564,546,18,3.2
48435,11/1/19,1296,1239,57,4.4
48437,11/1/19,2575,2481,94,3.7
48439,11/1/19,1100806,1066663,34143,3.1
48441,11/1/19,68204,66341,1863,2.7
48443,11/1/19,371,358,13,3.5
48445,11/1/19,4909,4739,170,3.5
48447,11/1/19,640,615,25,3.9
48449,11/1/19,13094,12585,509,3.9
48451,11/1/19,54772,53163,1609,2.9
48453,11/1/19,751192,732931,18261,2.4
48455,11/1/19,5327,5057,270,5.1
48457,11/1/19,7129,6711,418,5.9
48459,11/1/19,18011,17331,680,3.8
48461,11/1/19,1675,1634,41,2.4
48463,11/1/19,11350,10950,400,3.5
48465,11/1/19,23099,22314,785,3.4
48467,11/1/19,26090,25269,821,3.1
48469,11/1/19,43066,41543,1523,3.5
48471,11/1/19,24393,23490,903,3.7
48473,11/1/19,23690,22828,862,3.6
48475,11/1/19,7584,7398,186,2.5
48477,11/1/19,15237,14768,469,3.1
48479,11/1/19,119514,115308,4206,3.5
48481,11/1/19,21766,21037,729,3.3
48483,11/1/19,2239,2163,76,3.4
48485,11/1/19,56729,55047,1682,3
48487,11/1/19,4958,4788,170,3.4
48489,11/1/19,6650,6181,469,7.1
48491,11/1/19,318419,309903,8516,2.7
48493,11/1/19,25183,24487,696,2.8
48495,11/1/19,4051,3930,121,3
48497,11/1/19,32358,31363,995,3.1
48499,11/1/19,17796,17119,677,3.8
48501,11/1/19,3640,3529,111,3
48503,11/1/19,8050,7816,234,2.9
48505,11/1/19,4856,4590,266,5.5
48507,11/1/19,3323,3053,270,8.1
49001,11/1/19,2793,2729,64,2.3
49003,11/1/19,26058,25530,528,2
49005,11/1/19,65258,64194,1064,1.6
49007,11/1/19,8551,8305,246,2.9
49009,11/1/19,361,348,13,3.6
49011,11/1/19,175536,172121,3415,1.9
49013,11/1/19,7825,7576,249,3.2
49015,11/1/19,4266,4132,134,3.1
49017,11/1/19,2534,2394,140,5.5
49019,11/1/19,5992,5800,192,3.2
49021,11/1/19,24879,24326,553,2.2
49023,11/1/19,5835,5731,104,1.8
49025,11/1/19,3673,3588,85,2.3
49027,11/1/19,5853,5726,127,2.2
49029,11/1/19,5608,5503,105,1.9
49031,11/1/19,483,462,21,4.3
49033,11/1/19,1027,995,32,3.1
49035,11/1/19,644632,631537,13095,2
49037,11/1/19,5563,5326,237,4.3
49039,11/1/19,12438,12123,315,2.5
49041,11/1/19,9686,9463,223,2.3
49043,11/1/19,24657,24089,568,2.3
49045,11/1/19,34496,33722,774,2.2
49047,11/1/19,13615,13100,515,3.8
49049,11/1/19,314426,308533,5893,1.9
49051,11/1/19,16417,16033,384,2.3
49053,11/1/19,77464,75633,1831,2.4
49055,11/1/19,1358,1292,66,4.9
49057,11/1/19,128437,125656,2781,2.2
50001,11/1/19,20414,19984,430,2.1
50003,11/1/19,17737,17176,561,3.2
50005,11/1/19,14332,13979,353,2.5
50007,11/1/19,96047,94355,1692,1.8
50009,11/1/19,2644,2570,74,2.8
50011,11/1/19,27062,26484,578,2.1
50013,11/1/19,4042,3910,132,3.3
50015,11/1/19,13692,13284,408,3
50017,11/1/19,15814,15493,321,2
50019,11/1/19,13115,12639,476,3.6
50021,11/1/19,30164,29388,776,2.6
50023,11/1/19,34223,33540,683,2
50025,11/1/19,21622,21063,559,2.6
50027,11/1/19,28465,27859,606,2.1
51001,11/1/19,16553,16055,498,3
51003,11/1/19,58238,56983,1255,2.2
51005,11/1/19,6858,6635,223,3.3
51007,11/1/19,6382,6210,172,2.7
51009,11/1/19,15164,14733,431,2.8
51011,11/1/19,7230,7006,224,3.1
51013,11/1/19,157073,154441,2632,1.7
51015,11/1/19,38025,37200,825,2.2
51017,11/1/19,2510,2456,54,2.2
51019,11/1/19,38801,37826,975,2.5
51021,11/1/19,2871,2795,76,2.6
51023,11/1/19,17528,17121,407,2.3
51025,11/1/19,6007,5759,248,4.1
51027,11/1/19,6644,6272,372,5.6
51029,11/1/19,6541,6294,247,3.8
51031,11/1/19,26217,25480,737,2.8
51033,11/1/19,15478,15044,434,2.8
51035,11/1/19,13207,12795,412,3.1
51036,11/1/19,3713,3612,101,2.7
51037,11/1/19,5282,5116,166,3.1
51041,11/1/19,190312,185708,4604,2.4
51043,11/1/19,7749,7588,161,2.1
51045,11/1/19,2313,2250,63,2.7
51047,11/1/19,25061,24507,554,2.2
51049,11/1/19,4649,4526,123,2.6
51051,11/1/19,4762,4535,227,4.8
51053,11/1/19,13876,13490,386,2.8
51057,11/1/19,5505,5336,169,3.1
51059,11/1/19,646369,633377,12992,2
51061,11/1/19,37959,37171,788,2.1
51063,11/1/19,8350,8167,183,2.2
51065,11/1/19,14153,13863,290,2
51067,11/1/19,26620,25891,729,2.7
51069,11/1/19,48944,47914,1030,2.1
51071,11/1/19,8001,7780,221,2.8
51073,11/1/19,19669,19219,450,2.3
51075,11/1/19,11404,11128,276,2.4
51077,11/1/19,8129,7909,220,2.7
51079,11/1/19,10687,10466,221,2.1
51081,11/1/19,4287,4160,127,3
51083,11/1/19,15545,15001,544,3.5
51085,11/1/19,60163,58896,1267,2.1
51087,11/1/19,184710,180149,4561,2.5
51089,11/1/19,23698,22973,725,3.1
51091,11/1/19,1233,1198,35,2.8
51093,11/1/19,19540,19048,492,2.5
51095,11/1/19,36717,35860,857,2.3
51097,11/1/19,3867,3774,93,2.4
51099,11/1/19,13625,13302,323,2.4
51101,11/1/19,9309,9089,220,2.4
51103,11/1/19,5462,5310,152,2.8
51105,11/1/19,8279,7955,324,3.9
51107,11/1/19,226387,221820,4567,2
51109,11/1/19,20369,19891,478,2.3
51111,11/1/19,5300,5152,148,2.8
51113,11/1/19,7668,7524,144,1.9
51115,11/1/19,4161,4050,111,2.7
51117,11/1/19,12420,11963,457,3.7
51119,11/1/19,5343,5229,114,2.1
51121,11/1/19,50794,49549,1245,2.5
51125,11/1/19,7595,7424,171,2.3
51127,11/1/19,12679,12417,262,2.1
51131,11/1/19,5486,5286,200,3.6
51133,11/1/19,5755,5577,178,3.1
51135,11/1/19,7359,7166,193,2.6
51137,11/1/19,17663,17215,448,2.5
51139,11/1/19,12072,11718,354,2.9
51141,11/1/19,7206,6975,231,3.2
51143,11/1/19,30332,29433,899,3
51145,11/1/19,14382,14049,333,2.3
51147,11/1/19,10322,9974,348,3.4
51149,11/1/19,15309,14847,462,3
51153,11/1/19,249663,244138,5525,2.2
51155,11/1/19,16249,15795,454,2.8
51157,11/1/19,3777,3697,80,2.1
51159,11/1/19,4119,4020,99,2.4
51161,11/1/19,49645,48500,1145,2.3
51163,11/1/19,10883,10621,262,2.4
51165,11/1/19,42832,41988,844,2
51167,11/1/19,11227,10820,407,3.6
51169,11/1/19,9154,8910,244,2.7
51171,11/1/19,22423,21928,495,2.2
51173,11/1/19,13857,13388,469,3.4
51175,11/1/19,9177,8959,218,2.4
51177,11/1/19,68133,66433,1700,2.5
51179,11/1/19,73236,71444,1792,2.4
51181,11/1/19,3778,3667,111,2.9
51183,11/1/19,3889,3733,156,4
51185,11/1/19,15670,15055,615,3.9
51187,11/1/19,20787,20275,512,2.5
51191,11/1/19,26813,26038,775,2.9
51193,11/1/19,9648,9358,290,3
51195,11/1/19,13443,12879,564,4.2
51197,11/1/19,13790,13350,440,3.2
51199,11/1/19,32868,32073,795,2.4
51510,11/1/19,103116,101176,1940,1.9
51520,11/1/19,7225,6978,247,3.4
51530,11/1/19,3533,3451,82,2.3
51540,11/1/19,26824,26300,524,2
51550,11/1/19,122966,119807,3159,2.6
51570,11/1/19,8936,8679,257,2.9
51580,11/1/19,2371,2282,89,3.8
51590,11/1/19,19347,18541,806,4.2
51595,11/1/19,2274,2180,94,4.1
51600,11/1/19,13694,13432,262,1.9
51610,11/1/19,8748,8593,155,1.8
51620,11/1/19,3597,3460,137,3.8
51630,11/1/19,14359,13945,414,2.9
51640,11/1/19,2917,2830,87,3
51650,11/1/19,64402,62265,2137,3.3
51660,11/1/19,25446,24769,677,2.7
51670,11/1/19,9810,9431,379,3.9
51678,11/1/19,2108,2022,86,4.1
51680,11/1/19,36552,35386,1166,3.2
51683,11/1/19,22409,21931,478,2.1
51685,11/1/19,9534,9335,199,2.1
51690,11/1/19,5487,5281,206,3.8
51700,11/1/19,88843,86165,2678,3
51710,11/1/19,111683,108303,3380,3
51720,11/1/19,1688,1633,55,3.3
51730,11/1/19,13171,12520,651,4.9
51735,11/1/19,6418,6281,137,2.1
51740,11/1/19,44329,42766,1563,3.5
51750,11/1/19,8738,8474,264,3
51760,11/1/19,120010,116548,3462,2.9
51770,11/1/19,49378,48046,1332,2.7
51775,11/1/19,13027,12707,320,2.5
51790,11/1/19,12367,12085,282,2.3
51800,11/1/19,44706,43508,1198,2.7
51810,11/1/19,233715,228046,5669,2.4
51820,11/1/19,10798,10530,268,2.5
51830,11/1/19,6685,6467,218,3.3
51840,11/1/19,15051,14687,364,2.4
53001,11/1/19,9257,8748,509,5.5
53003,11/1/19,10682,10291,391,3.7
53005,11/1/19,103890,99040,4850,4.7
53007,11/1/19,43665,41648,2017,4.6
53009,11/1/19,29296,27577,1719,5.9
53011,11/1/19,246005,235364,10641,4.3
53013,11/1/19,1878,1778,100,5.3
53015,11/1/19,48596,45978,2618,5.4
53017,11/1/19,21483,20336,1147,5.3
53019,11/1/19,2430,2188,242,10
53021,11/1/19,42399,39964,2435,5.7
53023,11/1/19,927,874,53,5.7
53025,11/1/19,45380,42446,2934,6.5
53027,11/1/19,29213,27290,1923,6.6
53029,11/1/19,37238,35577,1661,4.5
53031,11/1/19,13339,12658,681,5.1
53033,11/1/19,1298436,1265360,33076,2.5
53035,11/1/19,131624,126391,5233,4
53037,11/1/19,24220,23088,1132,4.7
53039,11/1/19,10027,9514,513,5.1
53041,11/1/19,35428,33422,2006,5.7
53043,11/1/19,4992,4768,224,4.5
53045,11/1/19,26705,25248,1457,5.5
53047,11/1/19,19224,17978,1246,6.5
53049,11/1/19,8556,7977,579,6.8
53051,11/1/19,5171,4791,380,7.3
53053,11/1/19,449788,428706,21082,4.7
53055,11/1/19,8533,8235,298,3.5
53057,11/1/19,63525,60306,3219,5.1
53059,11/1/19,5622,5349,273,4.9
53061,11/1/19,441899,429513,12386,2.8
53063,11/1/19,259520,247834,11686,4.5
53065,11/1/19,19276,18141,1135,5.9
53067,11/1/19,146356,139933,6423,4.4
53069,11/1/19,1384,1296,88,6.4
53071,11/1/19,31486,30193,1293,4.1
53073,11/1/19,116639,111274,5365,4.6
53075,11/1/19,24734,23794,940,3.8
53077,11/1/19,129158,120859,8299,6.4
54001,11/1/19,7378,6968,410,5.6
54003,11/1/19,60227,58436,1791,3
54005,11/1/19,7457,7032,425,5.7
54007,11/1/19,5257,4830,427,8.1
54009,11/1/19,10050,9503,547,5.4
54011,11/1/19,41918,40337,1581,3.8
54013,11/1/19,2612,2226,386,14.8
54015,11/1/19,3166,2867,299,9.4
54017,11/1/19,4041,3848,193,4.8
54019,11/1/19,16255,15293,962,5.9
54021,11/1/19,2471,2289,182,7.4
54023,11/1/19,5920,5598,322,5.4
54025,11/1/19,15657,14981,676,4.3
54027,11/1/19,10762,10409,353,3.3
54029,11/1/19,13138,12467,671,5.1
54031,11/1/19,5728,5468,260,4.5
54033,11/1/19,34965,33372,1593,4.6
54035,11/1/19,13367,12685,682,5.1
54037,11/1/19,30376,29541,835,2.7
54039,11/1/19,82202,78614,3588,4.4
54041,11/1/19,6735,6243,492,7.3
54043,11/1/19,7296,6838,458,6.3
54045,11/1/19,11303,10591,712,6.3
54047,11/1/19,4471,4091,380,8.5
54049,11/1/19,25924,24631,1293,5
54051,11/1/19,14433,13534,899,6.2
54053,11/1/19,10277,9728,549,5.3
54055,11/1/19,21359,20261,1098,5.1
54057,11/1/19,12722,11994,728,5.7
54059,11/1/19,6998,6466,532,7.6
54061,11/1/19,55862,54023,1839,3.3
54063,11/1/19,5917,5676,241,4.1
54065,11/1/19,8160,7879,281,3.4
54067,11/1/19,9622,8955,667,6.9
54069,11/1/19,21688,20671,1017,4.7
54071,11/1/19,3693,3560,133,3.6
54073,11/1/19,2963,2747,216,7.3
54075,11/1/19,3670,3403,267,7.3
54077,11/1/19,15811,15129,682,4.3
54079,11/1/19,26930,25889,1041,3.9
54081,11/1/19,30355,28978,1377,4.5
54083,11/1/19,12367,11628,739,6
54085,11/1/19,4408,4133,275,6.2
54087,11/1/19,5230,4705,525,10
54089,11/1/19,4316,4085,231,5.4
54091,11/1/19,8015,7635,380,4.7
54093,11/1/19,3348,3183,165,4.9
54095,11/1/19,3107,2880,227,7.3
54097,11/1/19,9593,9012,581,6.1
54099,11/1/19,15945,15152,793,5
54101,11/1/19,3319,3084,235,7.1
54103,11/1/19,6738,6230,508,7.5
54105,11/1/19,2317,2127,190,8.2
54107,11/1/19,37149,35335,1814,4.9
54109,11/1/19,6697,6257,440,6.6
55001,11/1/19,8053,7681,372,4.6
55003,11/1/19,7815,7491,324,4.1
55005,11/1/19,24097,23289,808,3.4
55007,11/1/19,7539,7164,375,5
55009,11/1/19,141948,138000,3948,2.8
55011,11/1/19,6388,6148,240,3.8
55013,11/1/19,7032,6716,316,4.5
55015,11/1/19,27408,26703,705,2.6
55017,11/1/19,33143,32108,1035,3.1
55019,11/1/19,17497,17030,467,2.7
55021,11/1/19,31824,30961,863,2.7
55023,11/1/19,7587,7313,274,3.6
55025,11/1/19,325396,318319,7077,2.2
55027,11/1/19,47187,45865,1322,2.8
55029,11/1/19,14544,14071,473,3.3
55031,11/1/19,23035,22141,894,3.9
55033,11/1/19,24575,23889,686,2.8
55035,11/1/19,58970,57470,1500,2.5
55037,11/1/19,2206,2090,116,5.3
55039,11/1/19,57087,55652,1435,2.5
55041,11/1/19,3963,3795,168,4.2
55043,11/1/19,28208,27417,791,2.8
55045,11/1/19,21175,20664,511,2.4
55047,11/1/19,9220,8904,316,3.4
55049,11/1/19,13790,13474,316,2.3
55051,11/1/19,2530,2389,141,5.6
55053,11/1/19,10124,9781,343,3.4
55055,11/1/19,45680,44447,1233,2.7
55057,11/1/19,13240,12868,372,2.8
55059,11/1/19,88679,85411,3268,3.7
55061,11/1/19,10981,10688,293,2.7
55063,11/1/19,66803,65191,1612,2.4
55065,11/1/19,10049,9843,206,2
55067,11/1/19,9162,8836,326,3.6
55069,11/1/19,15041,14544,497,3.3
55071,11/1/19,40716,39342,1374,3.4
55073,11/1/19,73448,71594,1854,2.5
55075,11/1/19,19350,18534,816,4.2
55077,11/1/19,7718,7449,269,3.5
55078,11/1/19,1594,1476,118,7.4
55079,11/1/19,467037,449360,17677,3.8
55081,11/1/19,23134,22545,589,2.5
55083,11/1/19,20555,19934,621,3
55085,11/1/19,17324,16672,652,3.8
55087,11/1/19,102419,99807,2612,2.6
55089,11/1/19,49183,47914,1269,2.6
55091,11/1/19,4128,3993,135,3.3
55093,11/1/19,25268,24519,749,3
55095,11/1/19,24402,23533,869,3.6
55097,11/1/19,38909,37878,1031,2.6
55099,11/1/19,6555,6241,314,4.8
55101,11/1/19,97594,93873,3721,3.8
55103,11/1/19,9091,8843,248,2.7
55105,11/1/19,85334,82325,3009,3.5
55107,11/1/19,6685,6411,274,4.1
55109,11/1/19,50386,48862,1524,3
55111,11/1/19,35029,34078,951,2.7
55113,11/1/19,7791,7450,341,4.4
55115,11/1/19,20803,20212,591,2.8
55117,11/1/19,61032,59397,1635,2.7
55119,11/1/19,10801,10490,311,2.9
55121,11/1/19,15708,15285,423,2.7
55123,11/1/19,15185,14766,419,2.8
55125,11/1/19,9869,9494,375,3.8
55127,11/1/19,58022,56339,1683,2.9
55129,11/1/19,7765,7491,274,3.5
55131,11/1/19,77082,75100,1982,2.6
55133,11/1/19,224979,218950,6029,2.7
55135,11/1/19,25473,24764,709,2.8
55137,11/1/19,11344,10940,404,3.6
55139,11/1/19,91241,88743,2498,2.7
55141,11/1/19,34967,33829,1138,3.3
56001,11/1/19,20984,20388,596,2.8
56003,11/1/19,5410,5193,217,4
56005,11/1/19,23713,22950,763,3.2
56007,11/1/19,8070,7803,267,3.3
56009,11/1/19,9024,8768,256,2.8
56011,11/1/19,3768,3652,116,3.1
56013,11/1/19,18906,18115,791,4.2
56015,11/1/19,6787,6535,252,3.7
56017,11/1/19,2137,2062,75,3.5
56019,11/1/19,4149,4009,140,3.4
56021,11/1/19,48745,47086,1659,3.4
56023,11/1/19,8691,8394,297,3.4
56025,11/1/19,39651,38081,1570,4
56027,11/1/19,1241,1202,39,3.1
56029,11/1/19,14907,14261,646,4.3
56031,11/1/19,4515,4375,140,3.1
56033,11/1/19,15700,15183,517,3.3
56035,11/1/19,4204,4000,204,4.9
56037,11/1/19,21418,20527,891,4.2
56039,11/1/19,13871,13123,748,5.4
56041,11/1/19,9012,8654,358,4
56043,11/1/19,3974,3840,134,3.4
56045,11/1/19,3845,3752,93,2.4
72001,11/1/19,3994,3445,549,13.7
72003,11/1/19,11440,10236,1204,10.5
72005,11/1/19,13960,12509,1451,10.4
72007,11/1/19,6276,5697,579,9.2
72009,11/1/19,6259,5627,632,10.1
72011,11/1/19,8469,7724,745,8.8
72013,11/1/19,23439,21052,2387,10.2
72015,11/1/19,4459,3836,623,14
72017,11/1/19,5706,5034,672,11.8
72019,11/1/19,7151,6528,623,8.7
72021,11/1/19,62470,58336,4134,6.6
72023,11/1/19,13099,11990,1109,8.5
72025,11/1/19,45608,42506,3102,6.8
72027,11/1/19,9271,8439,832,9
72029,11/1/19,15342,14312,1030,6.7
72031,11/1/19,58828,55196,3632,6.2
72033,11/1/19,7490,6920,570,7.6
72035,11/1/19,15389,14289,1100,7.1
72037,11/1/19,3525,3178,347,9.8
72039,11/1/19,3598,3183,415,11.5
72041,11/1/19,14768,13798,970,6.6
72043,11/1/19,9622,8450,1172,12.2
72045,11/1/19,4724,4288,436,9.2
72047,11/1/19,8635,7835,800,9.3
72049,11/1/19,866,836,30,3.5
72051,11/1/19,12644,11874,770,6.1
72053,11/1/19,10419,9359,1060,10.2
72054,11/1/19,3184,2839,345,10.8
72055,11/1/19,3958,3354,604,15.3
72057,11/1/19,10571,9269,1302,12.3
72059,11/1/19,4723,4070,653,13.8
72061,11/1/19,35812,34299,1513,4.2
72063,11/1/19,17256,16269,987,5.7
72065,11/1/19,13564,11634,1930,14.2
72067,11/1/19,5137,4699,438,8.5
72069,11/1/19,16409,14788,1621,9.9
72071,11/1/19,12011,10926,1085,9
72073,11/1/19,4108,3548,560,13.6
72075,11/1/19,14494,13043,1451,10
72077,11/1/19,11794,10781,1013,8.6
72079,11/1/19,5064,4455,609,12
72081,11/1/19,7040,6014,1026,14.6
72083,11/1/19,2524,2209,315,12.5
72085,11/1/19,10839,9841,998,9.2
72087,11/1/19,8133,7437,696,8.6
72089,11/1/19,5917,5349,568,9.6
72091,11/1/19,11077,10162,915,8.3
72093,11/1/19,1910,1638,272,14.2
72095,11/1/19,2757,2395,362,13.1
72097,11/1/19,20828,18675,2153,10.3
72099,11/1/19,10064,9002,1062,10.6
72101,11/1/19,7690,6956,734,9.5
72103,11/1/19,7826,7120,706,9
72105,11/1/19,6799,6203,596,8.8
72107,11/1/19,4771,4275,496,10.4
72109,11/1/19,4086,3482,604,14.8
72111,11/1/19,5690,4877,813,14.3
72113,11/1/19,43759,39495,4264,9.7
72115,11/1/19,5860,5190,670,11.4
72117,11/1/19,4649,3915,734,15.8
72119,11/1/19,16196,15002,1194,7.4
72121,11/1/19,5924,5205,719,12.1
72123,11/1/19,6985,5898,1087,15.6
72125,11/1/19,9358,8341,1017,10.9
72127,11/1/19,127762,120364,7398,5.8
72129,11/1/19,11219,10225,994,8.9
72131,11/1/19,10093,8710,1383,13.7
72133,11/1/19,8621,7521,1100,12.8
72135,11/1/19,25916,24393,1523,5.9
72137,11/1/19,27965,26259,1706,6.1
72139,11/1/19,25801,24546,1255,4.9
72141,11/1/19,6481,5728,753,11.6
72143,11/1/19,9360,8547,813,8.7
72145,11/1/19,12754,11496,1258,9.9
72147,11/1/19,2430,2277,153,6.3
72149,11/1/19,7221,6085,1136,15.7
72151,11/1/19,8523,7351,1172,13.8
72153,11/1/19,9625,8240,1385,14.4
1001,12/1/19,26127,25513,614,2.4
1003,12/1/19,95993,93689,2304,2.4
1005,12/1/19,8624,8349,275,3.2
1007,12/1/19,8752,8534,218,2.5
1009,12/1/19,25508,24930,578,2.3
1011,12/1/19,4757,4588,169,3.6
1013,12/1/19,9225,8906,319,3.5
1015,12/1/19,46320,44930,1390,3
1017,12/1/19,15830,15449,381,2.4
1019,12/1/19,11486,11201,285,2.5
1021,12/1/19,19958,19498,460,2.3
1023,12/1/19,4603,4407,196,4.3
1025,12/1/19,7496,7089,407,5.4
1027,12/1/19,6105,5942,163,2.7
1029,12/1/19,5821,5664,157,2.7
1031,12/1/19,21198,20692,506,2.4
1033,12/1/19,23527,22739,788,3.3
1035,12/1/19,4483,4329,154,3.4
1037,12/1/19,4525,4416,109,2.4
1039,12/1/19,15532,15073,459,3
1041,12/1/19,6350,6201,149,2.3
1043,12/1/19,38760,37929,831,2.1
1045,12/1/19,20648,20126,522,2.5
1047,12/1/19,14546,13915,631,4.3
1049,12/1/19,30958,30235,723,2.3
1051,12/1/19,37543,36694,849,2.3
1053,12/1/19,14787,14334,453,3.1
1055,12/1/19,42804,41591,1213,2.8
1057,12/1/19,6551,6378,173,2.6
1059,12/1/19,14712,14364,348,2.4
1061,12/1/19,10983,10716,267,2.4
1063,12/1/19,2864,2727,137,4.8
1065,12/1/19,6111,5907,204,3.3
1067,12/1/19,6915,6717,198,2.9
1069,12/1/19,46329,45167,1162,2.5
1071,12/1/19,23229,22548,681,2.9
1073,12/1/19,321910,314357,7553,2.3
1075,12/1/19,5846,5691,155,2.7
1077,12/1/19,42304,41101,1203,2.8
1079,12/1/19,14317,13940,377,2.6
1081,12/1/19,77615,75898,1717,2.2
1083,12/1/19,43962,43003,959,2.2
1085,12/1/19,3557,3384,173,4.9
1087,12/1/19,7880,7595,285,3.6
1089,12/1/19,185936,182025,3911,2.1
1091,12/1/19,7617,7388,229,3
1093,12/1/19,12854,12476,378,2.9
1095,12/1/19,43945,43046,899,2
1097,12/1/19,189207,183131,6076,3.2
1099,12/1/19,7367,7041,326,4.4
1101,12/1/19,105682,102896,2786,2.6
1103,12/1/19,58527,57250,1277,2.2
1105,12/1/19,3379,3245,134,4
1107,12/1/19,7939,7728,211,2.7
1109,12/1/19,15461,15024,437,2.8
1111,12/1/19,9646,9409,237,2.5
1113,12/1/19,23875,23273,602,2.5
1115,12/1/19,40911,39994,917,2.2
1117,12/1/19,117216,115105,2111,1.8
1119,12/1/19,4874,4688,186,3.8
1121,12/1/19,35719,34675,1044,2.9
1123,12/1/19,18548,18089,459,2.5
1125,12/1/19,106133,103785,2348,2.2
1127,12/1/19,25553,24838,715,2.8
1129,12/1/19,6818,6514,304,4.5
1131,12/1/19,2740,2560,180,6.6
1133,12/1/19,10080,9778,302,3
2013,12/1/19,1137,1055,82,7.2
2016,12/1/19,2521,2370,151,6
2020,12/1/19,147801,140718,7083,4.8
2050,12/1/19,7158,6368,790,11
2060,12/1/19,234,205,29,12.4
2068,12/1/19,581,466,115,19.8
2070,12/1/19,1584,1452,132,8.3
2090,12/1/19,44329,41985,2344,5.3
2100,12/1/19,979,840,139,14.2
2105,12/1/19,968,827,141,14.6
2110,12/1/19,16284,15572,712,4.4
2122,12/1/19,25535,23643,1892,7.4
2130,12/1/19,6518,6086,432,6.6
2150,12/1/19,5405,4891,514,9.5
2158,12/1/19,2644,2210,434,16.4
2164,12/1/19,573,517,56,9.8
2170,12/1/19,47235,44078,3157,6.7
2180,12/1/19,4178,3802,376,9
2185,12/1/19,3538,3338,200,5.7
2188,12/1/19,3058,2673,385,12.6
2195,12/1/19,1317,1206,111,8.4
2198,12/1/19,2750,2510,240,8.7
2220,12/1/19,4038,3851,187,4.6
2230,12/1/19,627,504,123,19.6
2240,12/1/19,2798,2547,251,9
2261,12/1/19,4236,3831,405,9.6
2275,12/1/19,979,897,82,8.4
2282,12/1/19,231,208,23,10
2290,12/1/19,2432,2153,279,11.5
4001,12/1/19,20475,18461,2014,9.8
4003,12/1/19,51388,48698,2690,5.2
4005,12/1/19,77257,73032,4225,5.5
4007,12/1/19,21538,20445,1093,5.1
4009,12/1/19,15713,15023,690,4.4
4011,12/1/19,4536,4385,151,3.3
4012,12/1/19,9661,9151,510,5.3
4013,12/1/19,2356629,2272589,84040,3.6
4015,12/1/19,88387,83680,4707,5.3
4017,12/1/19,40889,38046,2843,7
4019,12/1/19,504172,483909,20263,4
4021,12/1/19,192051,183536,8515,4.4
4023,12/1/19,19943,18404,1539,7.7
4025,12/1/19,107107,102814,4293,4
4027,12/1/19,101964,87383,14581,14.3
5001,12/1/19,9419,9136,283,3
5003,12/1/19,7585,7158,427,5.6
5005,12/1/19,16140,15523,617,3.8
5007,12/1/19,137770,134463,3307,2.4
5009,12/1/19,15960,15475,485,3
5011,12/1/19,4489,4332,157,3.5
5013,12/1/19,2441,2345,96,3.9
5015,12/1/19,12565,12203,362,2.9
5017,12/1/19,3259,3041,218,6.7
5019,12/1/19,9756,9415,341,3.5
5021,12/1/19,5625,5341,284,5
5023,12/1/19,9065,8638,427,4.7
5025,12/1/19,3208,3081,127,4
5027,12/1/19,9151,8784,367,4
5029,12/1/19,8284,7951,333,4
5031,12/1/19,55922,54519,1403,2.5
5033,12/1/19,26734,25922,812,3
5035,12/1/19,21355,20548,807,3.8
5037,12/1/19,7395,7091,304,4.1
5039,12/1/19,2826,2703,123,4.4
5041,12/1/19,5382,5147,235,4.4
5043,12/1/19,7936,7548,388,4.9
5045,12/1/19,61703,59931,1772,2.9
5047,12/1/19,7417,7179,238,3.2
5049,12/1/19,4931,4758,173,3.5
5051,12/1/19,40408,39008,1400,3.5
5053,12/1/19,8323,8072,251,3
5055,12/1/19,19978,19316,662,3.3
5057,12/1/19,9825,9467,358,3.6
5059,12/1/19,13898,13445,453,3.3
5061,12/1/19,5743,5545,198,3.4
5063,12/1/19,16555,15937,618,3.7
5065,12/1/19,4900,4612,288,5.9
5067,12/1/19,5871,5464,407,6.9
5069,12/1/19,27477,26032,1445,5.3
5071,12/1/19,10216,9824,392,3.8
5073,12/1/19,2439,2343,96,3.9
5075,12/1/19,6835,6560,275,4
5077,12/1/19,2838,2707,131,4.6
5079,12/1/19,3932,3766,166,4.2
5081,12/1/19,5523,5297,226,4.1
5083,12/1/19,8551,8167,384,4.5
5085,12/1/19,34203,33076,1127,3.3
5087,12/1/19,7481,7313,168,2.2
5089,12/1/19,6579,6321,258,3.9
5091,12/1/19,19724,18982,742,3.8
5093,12/1/19,17257,16421,836,4.8
5095,12/1/19,2747,2622,125,4.6
5097,12/1/19,2891,2762,129,4.5
5099,12/1/19,3600,3471,129,3.6
5101,12/1/19,3325,3213,112,3.4
5103,12/1/19,9774,9292,482,4.9
5105,12/1/19,4215,4063,152,3.6
5107,12/1/19,6329,5938,391,6.2
5109,12/1/19,4227,4066,161,3.8
5111,12/1/19,10386,10037,349,3.4
5113,12/1/19,8162,7803,359,4.4
5115,12/1/19,28903,27693,1210,4.2
5117,12/1/19,3599,3442,157,4.4
5119,12/1/19,188032,181818,6214,3.3
5121,12/1/19,7363,7071,292,4
5123,12/1/19,8095,7716,379,4.7
5125,12/1/19,58378,56834,1544,2.6
5127,12/1/19,4320,4176,144,3.3
5129,12/1/19,2819,2674,145,5.1
5131,12/1/19,56319,54555,1764,3.1
5133,12/1/19,5528,5270,258,4.7
5135,12/1/19,5670,5387,283,5
5137,12/1/19,4613,4402,211,4.6
5139,12/1/19,15788,14947,841,5.3
5141,12/1/19,5636,5353,283,5
5143,12/1/19,125398,122658,2740,2.2
5145,12/1/19,33765,32279,1486,4.4
5147,12/1/19,2773,2634,139,5
5149,12/1/19,8418,8135,283,3.4
6001,12/1/19,845181,823865,21316,2.5
6003,12/1/19,608,585,23,3.8
6005,12/1/19,14803,14263,540,3.6
6007,12/1/19,98635,94342,4293,4.4
6009,12/1/19,21678,20943,735,3.4
6011,12/1/19,10507,9014,1493,14.2
6013,12/1/19,562014,547030,14984,2.7
6015,12/1/19,9552,9006,546,5.7
6017,12/1/19,92267,89444,2823,3.1
6019,12/1/19,449548,418389,31159,6.9
6021,12/1/19,12957,12261,696,5.4
6023,12/1/19,62522,60597,1925,3.1
6025,12/1/19,71883,59622,12261,17.1
6027,12/1/19,8662,8395,267,3.1
6029,12/1/19,389804,362153,27651,7.1
6031,12/1/19,57722,53282,4440,7.7
6033,12/1/19,28784,27317,1467,5.1
6035,12/1/19,9674,9277,397,4.1
6037,12/1/19,5158181,4951091,207090,4
6039,12/1/19,61963,57803,4160,6.7
6041,12/1/19,140629,137879,2750,2
6043,12/1/19,7124,6808,316,4.4
6045,12/1/19,38382,36948,1434,3.7
6047,12/1/19,114943,105874,9069,7.9
6049,12/1/19,3033,2818,215,7.1
6051,12/1/19,8734,8450,284,3.3
6053,12/1/19,210947,195663,15284,7.2
6055,12/1/19,71939,69883,2056,2.9
6057,12/1/19,48863,47443,1420,2.9
6059,12/1/19,1631145,1592027,39118,2.4
6061,12/1/19,188635,183581,5054,2.7
6063,12/1/19,7512,6932,580,7.7
6065,12/1/19,1111894,1071322,40572,3.6
6067,12/1/19,714835,691943,22892,3.2
6069,12/1/19,31303,29775,1528,4.9
6071,12/1/19,975489,943280,32209,3.3
6073,12/1/19,1597099,1552857,44242,2.8
6075,12/1/19,589286,578146,11140,1.9
6077,12/1/19,325993,307645,18348,5.6
6079,12/1/19,139351,135817,3534,2.5
6081,12/1/19,464779,456645,8134,1.8
6083,12/1/19,214976,207294,7682,3.6
6085,12/1/19,1058880,1035852,23028,2.2
6087,12/1/19,139049,132443,6606,4.8
6089,12/1/19,74102,71028,3074,4.1
6091,12/1/19,1322,1262,60,4.5
6093,12/1/19,16852,15784,1068,6.3
6095,12/1/19,209564,202607,6957,3.3
6097,12/1/19,259689,253575,6114,2.4
6099,12/1/19,242518,229013,13505,5.6
6101,12/1/19,46236,42929,3307,7.2
6103,12/1/19,25386,24148,1238,4.9
6105,12/1/19,4474,4239,235,5.3
6107,12/1/19,202541,183652,18889,9.3
6109,12/1/19,21469,20635,834,3.9
6111,12/1/19,424525,410292,14233,3.4
6113,12/1/19,108879,104652,4227,3.9
6115,12/1/19,30800,29092,1708,5.5
8001,12/1/19,277770,270813,6957,2.5
8003,12/1/19,8932,8656,276,3.1
8005,12/1/19,370624,362076,8548,2.3
8007,12/1/19,6783,6600,183,2.7
8009,12/1/19,2285,2255,30,1.3
8011,12/1/19,2025,1981,44,2.2
8013,12/1/19,197746,193839,3907,2
8014,12/1/19,40845,40001,844,2.1
8015,12/1/19,9651,9447,204,2.1
8017,12/1/19,1274,1257,17,1.3
8019,12/1/19,6135,6016,119,1.9
8021,12/1/19,4327,4194,133,3.1
8023,12/1/19,1927,1864,63,3.3
8025,12/1/19,1534,1480,54,3.5
8027,12/1/19,2110,2054,56,2.7
8029,12/1/19,14730,14296,434,2.9
8031,12/1/19,423917,414090,9827,2.3
8033,12/1/19,1210,1180,30,2.5
8035,12/1/19,197525,193632,3893,2
8037,12/1/19,38840,38137,703,1.8
8039,12/1/19,15602,15321,281,1.8
8041,12/1/19,343832,334234,9598,2.8
8043,12/1/19,14865,14274,591,4
8045,12/1/19,33835,33012,823,2.4
8047,12/1/19,3834,3761,73,1.9
8049,12/1/19,10483,10302,181,1.7
8051,12/1/19,12000,11774,226,1.9
8053,12/1/19,389,375,14,3.6
8055,12/1/19,2545,2416,129,5.1
8057,12/1/19,1050,1031,19,1.8
8059,12/1/19,340652,333266,7386,2.2
8061,12/1/19,1059,1048,11,1
8063,12/1/19,4562,4496,66,1.4
8065,12/1/19,5265,5181,84,1.6
8067,12/1/19,32030,31343,687,2.1
8069,12/1/19,209156,205003,4153,2
8071,12/1/19,6714,6491,223,3.3
8073,12/1/19,2467,2411,56,2.3
8075,12/1/19,11355,11139,216,1.9
8077,12/1/19,76241,73867,2374,3.1
8079,12/1/19,557,546,11,2
8081,12/1/19,7431,7192,239,3.2
8083,12/1/19,12866,12346,520,4
8085,12/1/19,22175,21614,561,2.5
8087,12/1/19,16949,16573,376,2.2
8089,12/1/19,8631,8344,287,3.3
8091,12/1/19,2355,2278,77,3.3
8093,12/1/19,11316,11077,239,2.1
8095,12/1/19,2810,2776,34,1.2
8097,12/1/19,11629,11300,329,2.8
8099,12/1/19,6667,6534,133,2
8101,12/1/19,76594,73860,2734,3.6
8103,12/1/19,3009,2922,87,2.9
8105,12/1/19,5738,5505,233,4.1
8107,12/1/19,17200,16903,297,1.7
8109,12/1/19,3808,3668,140,3.7
8111,12/1/19,507,488,19,3.7
8113,12/1/19,6448,6284,164,2.5
8115,12/1/19,1318,1297,21,1.6
8117,12/1/19,25565,25224,341,1.3
8119,12/1/19,12771,12447,324,2.5
8121,12/1/19,3061,3010,51,1.7
8123,12/1/19,172545,168655,3890,2.3
8125,12/1/19,6394,6313,81,1.3
9001,12/1/19,482315,467277,15038,3.1
9003,12/1/19,485242,468918,16324,3.4
9005,12/1/19,105362,102206,3156,3
9007,12/1/19,94284,91661,2623,2.8
9009,12/1/19,464244,448627,15617,3.4
9011,12/1/19,136738,132425,4313,3.2
9013,12/1/19,87519,85012,2507,2.9
9015,12/1/19,64500,62238,2262,3.5
10001,12/1/19,80327,77341,2986,3.7
10003,12/1/19,301422,291335,10087,3.3
10005,12/1/19,106540,102313,4227,4
11001,12/1/19,411233,390807,20426,5
12001,12/1/19,140376,136953,3423,2.4
12003,12/1/19,12010,11692,318,2.6
12005,12/1/19,81471,79066,2405,3
12007,12/1/19,11192,10898,294,2.6
12009,12/1/19,285212,277466,7746,2.7
12011,12/1/19,1042504,1015693,26811,2.6
12013,12/1/19,4737,4582,155,3.3
12015,12/1/19,72814,70598,2216,3
12017,12/1/19,46961,45017,1944,4.1
12019,12/1/19,109095,106332,2763,2.5
12021,12/1/19,184631,179927,4704,2.5
12023,12/1/19,30325,29525,800,2.6
12027,12/1/19,14711,14271,440,3
12029,12/1/19,5872,5667,205,3.5
12031,12/1/19,497767,484351,13416,2.7
12033,12/1/19,145900,141872,4028,2.8
12035,12/1/19,47053,45498,1555,3.3
12037,12/1/19,4468,4348,120,2.7
12039,12/1/19,18795,18152,643,3.4
12041,12/1/19,7195,6987,208,2.9
12043,12/1/19,5479,5296,183,3.3
12045,12/1/19,5561,5366,195,3.5
12047,12/1/19,4214,4058,156,3.7
12049,12/1/19,8950,8596,354,4
12051,12/1/19,15933,15173,760,4.8
12053,12/1/19,72300,69714,2586,3.6
12055,12/1/19,36638,35223,1415,3.9
12057,12/1/19,757213,737843,19370,2.6
12059,12/1/19,7006,6796,210,3
12061,12/1/19,66150,64044,2106,3.2
12063,12/1/19,17114,16586,528,3.1
12065,12/1/19,5643,5488,155,2.7
12067,12/1/19,2824,2754,70,2.5
12069,12/1/19,160371,155998,4373,2.7
12071,12/1/19,353248,344074,9174,2.6
12073,12/1/19,155941,151948,3993,2.6
12075,12/1/19,16706,16208,498,3
12077,12/1/19,2630,2551,79,3
12079,12/1/19,7497,7255,242,3.2
12081,12/1/19,181336,176542,4794,2.6
12083,12/1/19,137663,133193,4470,3.2
12085,12/1/19,74393,72437,1956,2.6
12086,12/1/19,1392870,1370836,22034,1.6
12087,12/1/19,47857,47029,828,1.7
12089,12/1/19,41728,40684,1044,2.5
12091,12/1/19,94702,92494,2208,2.3
12093,12/1/19,18123,17629,494,2.7
12095,12/1/19,768745,750030,18715,2.4
12097,12/1/19,185651,180524,5127,2.8
12099,12/1/19,735236,715236,20000,2.7
12101,12/1/19,239444,232367,7077,3
12103,12/1/19,497735,485209,12526,2.5
12105,12/1/19,308057,298597,9460,3.1
12107,12/1/19,26496,25501,995,3.8
12109,12/1/19,134084,131113,2971,2.2
12111,12/1/19,145449,140635,4814,3.3
12113,12/1/19,82991,80886,2105,2.5
12115,12/1/19,190002,185038,4964,2.6
12117,12/1/19,257406,251096,6310,2.5
12119,12/1/19,32789,31500,1289,3.9
12121,12/1/19,18033,17496,537,3
12123,12/1/19,8182,7937,245,3
12125,12/1/19,4660,4540,120,2.6
12127,12/1/19,254308,246741,7567,3
12129,12/1/19,14993,14624,369,2.5
12131,12/1/19,30850,30062,788,2.6
12133,12/1/19,9598,9320,278,2.9
13001,12/1/19,9422,9102,320,3.4
13003,12/1/19,4672,4546,126,2.7
13005,12/1/19,4854,4677,177,3.6
13007,12/1/19,1154,1107,47,4.1
13009,12/1/19,17417,16761,656,3.8
13011,12/1/19,9702,9483,219,2.3
13013,12/1/19,40948,40004,944,2.3
13015,12/1/19,51416,49804,1612,3.1
13017,12/1/19,5308,5016,292,5.5
13019,12/1/19,7499,7167,332,4.4
13021,12/1/19,67979,65861,2118,3.1
13023,12/1/19,4445,4275,170,3.8
13025,12/1/19,7150,6896,254,3.6
13027,12/1/19,6848,6647,201,2.9
13029,12/1/19,18160,17703,457,2.5
13031,12/1/19,36161,35042,1119,3.1
13033,12/1/19,9120,8738,382,4.2
13035,12/1/19,10870,10575,295,2.7
13037,12/1/19,2257,2192,65,2.9
13039,12/1/19,20829,20206,623,3
13043,12/1/19,5569,5401,168,3
13045,12/1/19,55806,54244,1562,2.8
13047,12/1/19,33665,32764,901,2.7
13049,12/1/19,4801,4655,146,3
13051,12/1/19,138786,134914,3872,2.8
13053,12/1/19,1984,1912,72,3.6
13055,12/1/19,11134,9775,1359,12.2
13057,12/1/19,137554,134474,3080,2.2
13059,12/1/19,59225,57596,1629,2.8
13061,12/1/19,868,811,57,6.6
13063,12/1/19,139417,134601,4816,3.5
13065,12/1/19,2508,2420,88,3.5
13067,12/1/19,430626,420158,10468,2.4
13069,12/1/19,18949,18142,807,4.3
13071,12/1/19,21063,20496,567,2.7
13073,12/1/19,75115,73255,1860,2.5
13075,12/1/19,8013,7747,266,3.3
13077,12/1/19,75623,73793,1830,2.4
13079,12/1/19,5600,5442,158,2.8
13081,12/1/19,9382,9073,309,3.3
13083,12/1/19,8166,7935,231,2.8
13085,12/1/19,12437,12142,295,2.4
13087,12/1/19,11444,11076,368,3.2
13089,12/1/19,404537,393076,11461,2.8
13091,12/1/19,6961,6635,326,4.7
13093,12/1/19,5096,4929,167,3.3
13095,12/1/19,38552,37006,1546,4
13097,12/1/19,74144,71971,2173,2.9
13099,12/1/19,4439,4278,161,3.6
13101,12/1/19,1896,1851,45,2.4
13103,12/1/19,30746,29992,754,2.5
13105,12/1/19,7646,7371,275,3.6
13107,12/1/19,8257,7875,382,4.6
13109,12/1/19,4858,4722,136,2.8
13111,12/1/19,11376,11050,326,2.9
13113,12/1/19,58750,57354,1396,2.4
13115,12/1/19,44694,43021,1673,3.7
13117,12/1/19,123634,120927,2707,2.2
13119,12/1/19,9816,9509,307,3.1
13121,12/1/19,563666,547729,15937,2.8
13123,12/1/19,11758,11402,356,3
13125,12/1/19,1264,1228,36,2.8
13127,12/1/19,39063,37982,1081,2.8
13129,12/1/19,28137,27165,972,3.5
13131,12/1/19,10303,10006,297,2.9
13133,12/1/19,6890,6649,241,3.5
13135,12/1/19,495462,483334,12128,2.4
13137,12/1/19,19026,18459,567,3
13139,12/1/19,102925,100611,2314,2.2
13141,12/1/19,2449,2313,136,5.6
13143,12/1/19,12703,12345,358,2.8
13145,12/1/19,16592,16158,434,2.6
13147,12/1/19,10884,10551,333,3.1
13149,12/1/19,5307,5159,148,2.8
13151,12/1/19,117073,113759,3314,2.8
13153,12/1/19,70424,68512,1912,2.7
13155,12/1/19,3334,3188,146,4.4
13157,12/1/19,37500,36704,796,2.1
13159,12/1/19,7008,6831,177,2.5
13161,12/1/19,5973,5710,263,4.4
13163,12/1/19,6596,6320,276,4.2
13165,12/1/19,3101,2959,142,4.6
13167,12/1/19,3982,3859,123,3.1
13169,12/1/19,13728,13361,367,2.7
13171,12/1/19,8310,8044,266,3.2
13173,12/1/19,3752,3615,137,3.7
13175,12/1/19,18927,18142,785,4.1
13177,12/1/19,14839,14453,386,2.6
13179,12/1/19,26311,25475,836,3.2
13181,12/1/19,3541,3425,116,3.3
13183,12/1/19,8153,7913,240,2.9
13185,12/1/19,51301,49779,1522,3
13187,12/1/19,16774,16367,407,2.4
13189,12/1/19,8862,8460,402,4.5
13191,12/1/19,6104,5924,180,2.9
13193,12/1/19,4634,4457,177,3.8
13195,12/1/19,13319,12973,346,2.6
13197,12/1/19,3276,3162,114,3.5
13199,12/1/19,8983,8637,346,3.9
13201,12/1/19,2718,2640,78,2.9
13205,12/1/19,8505,8136,369,4.3
13207,12/1/19,13010,12649,361,2.8
13209,12/1/19,3753,3601,152,4.1
13211,12/1/19,9300,9055,245,2.6
13213,12/1/19,15586,14690,896,5.7
13215,12/1/19,77054,74185,2869,3.7
13217,12/1/19,52789,51135,1654,3.1
13219,12/1/19,19550,19158,392,2
13221,12/1/19,6938,6756,182,2.6
13223,12/1/19,87146,85027,2119,2.4
13225,12/1/19,11750,11377,373,3.2
13227,12/1/19,15488,15098,390,2.5
13229,12/1/19,8651,8400,251,2.9
13231,12/1/19,8998,8768,230,2.6
13233,12/1/19,18485,17893,592,3.2
13235,12/1/19,4027,3904,123,3.1
13237,12/1/19,8164,7870,294,3.6
13239,12/1/19,788,754,34,4.3
13241,12/1/19,6917,6706,211,3.1
13243,12/1/19,2510,2409,101,4
13245,12/1/19,84980,81874,3106,3.7
13247,12/1/19,45285,43871,1414,3.1
13249,12/1/19,2211,2143,68,3.1
13251,12/1/19,5069,4777,292,5.8
13253,12/1/19,2977,2858,119,4
13255,12/1/19,28981,28038,943,3.3
13257,12/1/19,10570,10201,369,3.5
13259,12/1/19,2399,2321,78,3.3
13261,12/1/19,12794,12252,542,4.2
13263,12/1/19,2800,2694,106,3.8
13265,12/1/19,557,531,26,4.7
13267,12/1/19,9458,9149,309,3.3
13269,12/1/19,3149,3046,103,3.3
13271,12/1/19,3923,3567,356,9.1
13273,12/1/19,3512,3371,141,4
13275,12/1/19,16236,15684,552,3.4
13277,12/1/19,19830,19256,574,2.9
13279,12/1/19,11466,11040,426,3.7
13281,12/1/19,3741,3586,155,4.1
13283,12/1/19,2546,2439,107,4.2
13285,12/1/19,37460,36485,975,2.6
13287,12/1/19,3130,3014,116,3.7
13289,12/1/19,2893,2755,138,4.8
13291,12/1/19,10194,9921,273,2.7
13293,12/1/19,11352,11011,341,3
13295,12/1/19,31857,30458,1399,4.4
13297,12/1/19,46620,45460,1160,2.5
13299,12/1/19,15528,15004,524,3.4
13301,12/1/19,2880,2762,118,4.1
13303,12/1/19,6963,6703,260,3.7
13305,12/1/19,11199,10832,367,3.3
13307,12/1/19,1015,977,38,3.7
13309,12/1/19,1583,1466,117,7.4
13311,12/1/19,16390,16036,354,2.2
13313,12/1/19,43562,41576,1986,4.6
13315,12/1/19,2651,2547,104,3.9
13317,12/1/19,3775,3595,180,4.8
13319,12/1/19,3980,3848,132,3.3
13321,12/1/19,8942,8644,298,3.3
15001,12/1/19,91694,89111,2583,2.8
15003,12/1/19,452859,443191,9668,2.1
15007,12/1/19,36383,35522,861,2.4
15009,12/1/19,86389,84519,1870,2.2
16001,12/1/19,258737,252619,6118,2.4
16003,12/1/19,1666,1567,99,5.9
16005,12/1/19,43565,42373,1192,2.7
16007,12/1/19,2896,2809,87,3
16009,12/1/19,4061,3885,176,4.3
16011,12/1/19,23300,22656,644,2.8
16013,12/1/19,12529,12204,325,2.6
16015,12/1/19,3579,3426,153,4.3
16017,12/1/19,20186,19342,844,4.2
16019,12/1/19,58135,56792,1343,2.3
16021,12/1/19,5245,5026,219,4.2
16023,12/1/19,1402,1362,40,2.9
16025,12/1/19,679,661,18,2.7
16027,12/1/19,105319,102076,3243,3.1
16029,12/1/19,4106,3982,124,3
16031,12/1/19,12103,11813,290,2.4
16033,12/1/19,373,357,16,4.3
16035,12/1/19,2801,2659,142,5.1
16037,12/1/19,2039,1944,95,4.7
16039,12/1/19,11388,11050,338,3
16041,12/1/19,7132,6973,159,2.2
16043,12/1/19,7922,7726,196,2.5
16045,12/1/19,8413,8123,290,3.4
16047,12/1/19,8225,7983,242,2.9
16049,12/1/19,6394,6104,290,4.5
16051,12/1/19,14200,13876,324,2.3
16053,12/1/19,12178,11844,334,2.7
16055,12/1/19,80167,77136,3031,3.8
16057,12/1/19,20965,20482,483,2.3
16059,12/1/19,3464,3269,195,5.6
16061,12/1/19,1583,1493,90,5.7
16063,12/1/19,2694,2583,111,4.1
16065,12/1/19,22167,21805,362,1.6
16067,12/1/19,11276,10969,307,2.7
16069,12/1/19,21307,20694,613,2.9
16071,12/1/19,2301,2248,53,2.3
16073,12/1/19,5182,4987,195,3.8
16075,12/1/19,11615,11220,395,3.4
16077,12/1/19,3860,3701,159,4.1
16079,12/1/19,5141,4818,323,6.3
16081,12/1/19,6416,6275,141,2.2
16083,12/1/19,41686,40509,1177,2.8
16085,12/1/19,5453,5231,222,4.1
16087,12/1/19,4605,4430,175,3.8
17001,12/1/19,31943,30931,1012,3.2
17003,12/1/19,2050,1934,116,5.7
17005,12/1/19,7710,7437,273,3.5
17007,12/1/19,25982,24416,1566,6
17009,12/1/19,2969,2903,66,2.2
17011,12/1/19,16970,16097,873,5.1
17013,12/1/19,2308,2200,108,4.7
17015,12/1/19,7233,6912,321,4.4
17017,12/1/19,5980,5748,232,3.9
17019,12/1/19,111809,108287,3522,3.2
17021,12/1/19,14216,13521,695,4.9
17023,12/1/19,7600,7257,343,4.5
17025,12/1/19,6370,6103,267,4.2
17027,12/1/19,20291,19729,562,2.8
17029,12/1/19,23947,23128,819,3.4
17031,12/1/19,2563136,2487571,75565,2.9
17033,12/1/19,8597,8229,368,4.3
17035,12/1/19,6100,5902,198,3.2
17037,12/1/19,54976,52852,2124,3.9
17039,12/1/19,7358,7074,284,3.9
17041,12/1/19,10257,9943,314,3.1
17043,12/1/19,502257,491173,11084,2.2
17045,12/1/19,8738,8375,363,4.2
17047,12/1/19,2636,2523,113,4.3
17049,12/1/19,19255,18704,551,2.9
17051,12/1/19,9719,9309,410,4.2
17053,12/1/19,6553,6282,271,4.1
17055,12/1/19,16232,15402,830,5.1
17057,12/1/19,15037,14221,816,5.4
17059,12/1/19,2318,2214,104,4.5
17061,12/1/19,5893,5667,226,3.8
17063,12/1/19,25056,24167,889,3.5
17065,12/1/19,4430,4287,143,3.2
17067,12/1/19,8294,7934,360,4.3
17069,12/1/19,1335,1253,82,6.1
17071,12/1/19,3570,3430,140,3.9
17073,12/1/19,24909,23661,1248,5
17075,12/1/19,14427,13760,667,4.6
17077,12/1/19,27989,27036,953,3.4
17079,12/1/19,4640,4457,183,3.9
17081,12/1/19,17372,16632,740,4.3
17083,12/1/19,10948,10496,452,4.1
17085,12/1/19,10574,10073,501,4.7
17087,12/1/19,4130,3902,228,5.5
17089,12/1/19,273682,261311,12371,4.5
17091,12/1/19,56636,53596,3040,5.4
17093,12/1/19,67811,66035,1776,2.6
17095,12/1/19,21315,20308,1007,4.7
17097,12/1/19,374640,359069,15571,4.2
17099,12/1/19,54628,51740,2888,5.3
17101,12/1/19,5869,5551,318,5.4
17103,12/1/19,17675,16955,720,4.1
17105,12/1/19,16364,15741,623,3.8
17107,12/1/19,12423,11922,501,4
17109,12/1/19,13468,12967,501,3.7
17111,12/1/19,163703,159332,4371,2.7
17113,12/1/19,87529,84643,2886,3.3
17115,12/1/19,48099,45589,2510,5.2
17117,12/1/19,22891,21947,944,4.1
17119,12/1/19,134013,129275,4738,3.5
17121,12/1/19,17429,16682,747,4.3
17123,12/1/19,5243,4980,263,5
17125,12/1/19,6221,5882,339,5.4
17127,12/1/19,5697,5382,315,5.5
17129,12/1/19,6398,6166,232,3.6
17131,12/1/19,8028,7618,410,5.1
17133,12/1/19,18751,18228,523,2.8
17135,12/1/19,11593,10934,659,5.7
17137,12/1/19,16341,15667,674,4.1
17139,12/1/19,7538,7318,220,2.9
17141,12/1/19,24543,23320,1223,5
17143,12/1/19,84068,79755,4313,5.1
17145,12/1/19,8310,7931,379,4.6
17147,12/1/19,8782,8497,285,3.2
17149,12/1/19,6847,6536,311,4.5
17151,12/1/19,1667,1578,89,5.3
17153,12/1/19,2019,1893,126,6.2
17155,12/1/19,3075,2896,179,5.8
17157,12/1/19,14132,13644,488,3.5
17159,12/1/19,7182,6909,273,3.8
17161,12/1/19,71352,67788,3564,5
17163,12/1/19,126402,121344,5058,4
17165,12/1/19,9617,9140,477,5
17167,12/1/19,99716,95963,3753,3.8
17169,12/1/19,3112,2968,144,4.6
17171,12/1/19,2530,2394,136,5.4
17173,12/1/19,10421,10016,405,3.9
17175,12/1/19,2473,2332,141,5.7
17177,12/1/19,21446,20533,913,4.3
17179,12/1/19,62937,60228,2709,4.3
17181,12/1/19,7478,7041,437,5.8
17183,12/1/19,33140,31426,1714,5.2
17185,12/1/19,5940,5761,179,3
17187,12/1/19,8386,8064,322,3.8
17189,12/1/19,10090,9869,221,2.2
17191,12/1/19,6991,6692,299,4.3
17193,12/1/19,6508,6260,248,3.8
17195,12/1/19,28541,27301,1240,4.3
17197,12/1/19,352832,342104,10728,3
17199,12/1/19,32111,30834,1277,4
17201,12/1/19,138050,130045,8005,5.8
17203,12/1/19,18433,17801,632,3.4
18001,12/1/19,16977,16583,394,2.3
18003,12/1/19,184893,179630,5263,2.8
18005,12/1/19,44704,43747,957,2.1
18007,12/1/19,4693,4566,127,2.7
18009,12/1/19,4873,4685,188,3.9
18011,12/1/19,36072,35329,743,2.1
18013,12/1/19,7656,7462,194,2.5
18015,12/1/19,10506,10237,269,2.6
18017,12/1/19,17754,17169,585,3.3
18019,12/1/19,61603,59816,1787,2.9
18021,12/1/19,12045,11663,382,3.2
18023,12/1/19,17180,16786,394,2.3
18025,12/1/19,4808,4612,196,4.1
18027,12/1/19,16728,16338,390,2.3
18029,12/1/19,25777,24953,824,3.2
18031,12/1/19,14674,14292,382,2.6
18033,12/1/19,22611,22048,563,2.5
18035,12/1/19,54147,52302,1845,3.4
18037,12/1/19,22989,22543,446,1.9
18039,12/1/19,110818,107779,3039,2.7
18041,12/1/19,8571,8177,394,4.6
18043,12/1/19,41650,40471,1179,2.8
18045,12/1/19,8029,7756,273,3.4
18047,12/1/19,11276,10937,339,3
18049,12/1/19,9796,9481,315,3.2
18051,12/1/19,19566,19110,456,2.3
18053,12/1/19,32119,31059,1060,3.3
18055,12/1/19,13669,13160,509,3.7
18057,12/1/19,182546,178710,3836,2.1
18059,12/1/19,40013,39058,955,2.4
18061,12/1/19,20306,19727,579,2.9
18063,12/1/19,89402,87333,2069,2.3
18065,12/1/19,22001,21363,638,2.9
18067,12/1/19,36962,35680,1282,3.5
18069,12/1/19,18092,17581,511,2.8
18071,12/1/19,22919,22443,476,2.1
18073,12/1/19,16317,15756,561,3.4
18075,12/1/19,9403,9143,260,2.8
18077,12/1/19,14908,14444,464,3.1
18079,12/1/19,13620,13216,404,3
18081,12/1/19,82491,80583,1908,2.3
18083,12/1/19,18622,18125,497,2.7
18085,12/1/19,41863,40771,1092,2.6
18087,12/1/19,19922,19494,428,2.1
18089,12/1/19,230317,219211,11106,4.8
18091,12/1/19,47670,45716,1954,4.1
18093,12/1/19,21194,20485,709,3.3
18095,12/1/19,58897,56888,2009,3.4
18097,12/1/19,487220,473273,13947,2.9
18099,12/1/19,22852,22208,644,2.8
18101,12/1/19,5360,5247,113,2.1
18103,12/1/19,15214,14657,557,3.7
18105,12/1/19,71013,69166,1847,2.6
18107,12/1/19,18707,18206,501,2.7
18109,12/1/19,36130,35161,969,2.7
18111,12/1/19,6979,6717,262,3.8
18113,12/1/19,23398,22742,656,2.8
18115,12/1/19,3181,3080,101,3.2
18117,12/1/19,8608,8346,262,3
18119,12/1/19,9524,9199,325,3.4
18121,12/1/19,7001,6741,260,3.7
18123,12/1/19,9200,8905,295,3.2
18125,12/1/19,6188,5982,206,3.3
18127,12/1/19,86605,83591,3014,3.5
18129,12/1/19,13558,13221,337,2.5
18131,12/1/19,6473,6269,204,3.2
18133,12/1/19,16700,16191,509,3
18135,12/1/19,11220,10800,420,3.7
18137,12/1/19,14152,13744,408,2.9
18139,12/1/19,8893,8697,196,2.2
18141,12/1/19,135284,130711,4573,3.4
18143,12/1/19,10551,10222,329,3.1
18145,12/1/19,23049,22457,592,2.6
18147,12/1/19,10202,9885,317,3.1
18149,12/1/19,9793,9403,390,4
18151,12/1/19,20618,20152,466,2.3
18153,12/1/19,8433,8078,355,4.2
18155,12/1/19,4959,4812,147,3
18157,12/1/19,101136,98707,2429,2.4
18159,12/1/19,9169,8975,194,2.1
18161,12/1/19,3562,3457,105,2.9
18163,12/1/19,93776,91232,2544,2.7
18165,12/1/19,7012,6665,347,4.9
18167,12/1/19,48101,46227,1874,3.9
18169,12/1/19,15048,14644,404,2.7
18171,12/1/19,4247,4124,123,2.9
18173,12/1/19,32831,31955,876,2.7
18175,12/1/19,13755,13355,400,2.9
18177,12/1/19,30482,29499,983,3.2
18179,12/1/19,14415,14060,355,2.5
18181,12/1/19,13466,13161,305,2.3
18183,12/1/19,17690,17252,438,2.5
19001,12/1/19,4356,4250,106,2.4
19003,12/1/19,2216,2180,36,1.6
19005,12/1/19,7666,7383,283,3.7
19007,12/1/19,6036,5823,213,3.5
19009,12/1/19,3206,3125,81,2.5
19011,12/1/19,13850,13396,454,3.3
19013,12/1/19,69873,67362,2511,3.6
19015,12/1/19,15181,14814,367,2.4
19017,12/1/19,14150,13771,379,2.7
19019,12/1/19,11531,11161,370,3.2
19021,12/1/19,12360,12115,245,2
19023,12/1/19,8205,7918,287,3.5
19025,12/1/19,4384,4268,116,2.6
19027,12/1/19,11287,11068,219,1.9
19029,12/1/19,7005,6815,190,2.7
19031,12/1/19,11048,10746,302,2.7
19033,12/1/19,23902,23228,674,2.8
19035,12/1/19,6325,6164,161,2.5
19037,12/1/19,6775,6545,230,3.4
19039,12/1/19,4951,4811,140,2.8
19041,12/1/19,8742,8485,257,2.9
19043,12/1/19,10355,9881,474,4.6
19045,12/1/19,23216,22270,946,4.1
19047,12/1/19,8520,8151,369,4.3
19049,12/1/19,50443,49381,1062,2.1
19051,12/1/19,4327,4202,125,2.9
19053,12/1/19,4567,4469,98,2.1
19055,12/1/19,10907,10632,275,2.5
19057,12/1/19,19208,18393,815,4.2
19059,12/1/19,9915,9584,331,3.3
19061,12/1/19,57289,55510,1779,3.1
19063,12/1/19,5336,5214,122,2.3
19065,12/1/19,11043,10632,411,3.7
19067,12/1/19,8904,8495,409,4.6
19069,12/1/19,5850,5715,135,2.3
19071,12/1/19,3806,3724,82,2.2
19073,12/1/19,5631,5508,123,2.2
19075,12/1/19,6711,6520,191,2.8
19077,12/1/19,5809,5642,167,2.9
19079,12/1/19,7091,6876,215,3
19081,12/1/19,6068,5906,162,2.7
19083,12/1/19,8255,7998,257,3.1
19085,12/1/19,7639,7442,197,2.6
19087,12/1/19,9972,9679,293,2.9
19089,12/1/19,5370,5218,152,2.8
19091,12/1/19,5279,5122,157,3
19093,12/1/19,4268,4182,86,2
19095,12/1/19,10828,10575,253,2.3
19097,12/1/19,11212,10817,395,3.5
19099,12/1/19,20183,19567,616,3.1
19101,12/1/19,10465,10218,247,2.4
19103,12/1/19,86638,84694,1944,2.2
19105,12/1/19,11036,10633,403,3.7
19107,12/1/19,5380,5200,180,3.3
19109,12/1/19,8705,8518,187,2.1
19111,12/1/19,16464,15815,649,3.9
19113,12/1/19,123808,119946,3862,3.1
19115,12/1/19,6239,6021,218,3.5
19117,12/1/19,4717,4619,98,2.1
19119,12/1/19,7340,7190,150,2
19121,12/1/19,8756,8453,303,3.5
19123,12/1/19,12098,11787,311,2.6
19125,12/1/19,18773,18328,445,2.4
19127,12/1/19,18263,17231,1032,5.7
19129,12/1/19,7629,7442,187,2.5
19131,12/1/19,7310,7185,125,1.7
19133,12/1/19,4544,4402,142,3.1
19135,12/1/19,4141,4021,120,2.9
19137,12/1/19,5140,4993,147,2.9
19139,12/1/19,22142,21472,670,3
19141,12/1/19,8511,8315,196,2.3
19143,12/1/19,3660,3590,70,1.9
19145,12/1/19,6498,6313,185,2.8
19147,12/1/19,4903,4789,114,2.3
19149,12/1/19,15228,14852,376,2.5
19151,12/1/19,4824,4736,88,1.8
19153,12/1/19,272980,265144,7836,2.9
19155,12/1/19,49713,48464,1249,2.5
19157,12/1/19,10749,10431,318,3
19159,12/1/19,2546,2483,63,2.5
19161,12/1/19,5407,5280,127,2.3
19163,12/1/19,90184,86842,3342,3.7
19165,12/1/19,6866,6706,160,2.3
19167,12/1/19,21989,21532,457,2.1
19169,12/1/19,60047,58787,1260,2.1
19171,12/1/19,9697,9306,391,4
19173,12/1/19,3304,3240,64,1.9
19175,12/1/19,6460,6270,190,2.9
19177,12/1/19,3771,3670,101,2.7
19179,12/1/19,17945,17324,621,3.5
19181,12/1/19,28740,28010,730,2.5
19183,12/1/19,12234,11916,318,2.6
19185,12/1/19,2920,2843,77,2.6
19187,12/1/19,20021,19379,642,3.2
19189,12/1/19,5247,5094,153,2.9
19191,12/1/19,12603,12202,401,3.2
19193,12/1/19,56508,54802,1706,3
19195,12/1/19,4353,4218,135,3.1
19197,12/1/19,7182,6996,186,2.6
20001,12/1/19,6386,6175,211,3.3
20003,12/1/19,4219,4104,115,2.7
20005,12/1/19,6996,6659,337,4.8
20007,12/1/19,2373,2309,64,2.7
20009,12/1/19,13337,12916,421,3.2
20011,12/1/19,6637,6390,247,3.7
20013,12/1/19,5365,5213,152,2.8
20015,12/1/19,32601,31602,999,3.1
20017,12/1/19,1523,1482,41,2.7
20019,12/1/19,1460,1411,49,3.4
20021,12/1/19,10159,9872,287,2.8
20023,12/1/19,1390,1361,29,2.1
20025,12/1/19,1117,1092,25,2.2
20027,12/1/19,3842,3737,105,2.7
20029,12/1/19,3796,3688,108,2.8
20031,12/1/19,4169,3991,178,4.3
20033,12/1/19,885,861,24,2.7
20035,12/1/19,16296,15775,521,3.2
20037,12/1/19,18698,18054,644,3.4
20039,12/1/19,1294,1258,36,2.8
20041,12/1/19,8826,8545,281,3.2
20043,12/1/19,4142,4025,117,2.8
20045,12/1/19,66297,64601,1696,2.6
20047,12/1/19,1624,1594,30,1.8
20049,12/1/19,1208,1176,32,2.6
20051,12/1/19,17177,16830,347,2
20053,12/1/19,2747,2683,64,2.3
20055,12/1/19,20752,20336,416,2
20057,12/1/19,17142,16772,370,2.2
20059,12/1/19,14068,13677,391,2.8
20061,12/1/19,11328,10885,443,3.9
20063,12/1/19,1521,1491,30,2
20065,12/1/19,1123,1089,34,3
20067,12/1/19,3247,3166,81,2.5
20069,12/1/19,3340,3276,64,1.9
20071,12/1/19,810,793,17,2.1
20073,12/1/19,3453,3352,101,2.9
20075,12/1/19,1686,1657,29,1.7
20077,12/1/19,2862,2791,71,2.5
20079,12/1/19,17034,16594,440,2.6
20081,12/1/19,2240,2199,41,1.8
20083,12/1/19,1026,999,27,2.6
20085,12/1/19,7106,6925,181,2.5
20087,12/1/19,10038,9749,289,2.9
20089,12/1/19,1287,1255,32,2.5
20091,12/1/19,340790,332435,8355,2.5
20093,12/1/19,2096,2054,42,2
20095,12/1/19,3475,3375,100,2.9
20097,12/1/19,1340,1310,30,2.2
20099,12/1/19,9953,9616,337,3.4
20101,12/1/19,817,797,20,2.4
20103,12/1/19,36699,35558,1141,3.1
20105,12/1/19,1755,1719,36,2.1
20107,12/1/19,4485,4231,254,5.7
20109,12/1/19,1686,1657,29,1.7
20111,12/1/19,16695,16172,523,3.1
20113,12/1/19,17200,16852,348,2
20115,12/1/19,6073,5914,159,2.6
20117,12/1/19,5526,5391,135,2.4
20119,12/1/19,2188,2144,44,2
20121,12/1/19,17600,17059,541,3.1
20123,12/1/19,3286,3217,69,2.1
20125,12/1/19,14691,14089,602,4.1
20127,12/1/19,3050,2967,83,2.7
20129,12/1/19,1153,1123,30,2.6
20131,12/1/19,5437,5297,140,2.6
20133,12/1/19,6185,5926,259,4.2
20135,12/1/19,1370,1334,36,2.6
20137,12/1/19,2705,2651,54,2
20139,12/1/19,7936,7665,271,3.4
20141,12/1/19,2102,2065,37,1.8
20143,12/1/19,3030,2957,73,2.4
20145,12/1/19,2925,2851,74,2.5
20147,12/1/19,2662,2601,61,2.3
20149,12/1/19,12600,12292,308,2.4
20151,12/1/19,4955,4850,105,2.1
20153,12/1/19,1544,1514,30,1.9
20155,12/1/19,29548,28699,849,2.9
20157,12/1/19,2302,2251,51,2.2
20159,12/1/19,5214,5087,127,2.4
20161,12/1/19,35513,34654,859,2.4
20163,12/1/19,2550,2474,76,3
20165,12/1/19,1658,1619,39,2.4
20167,12/1/19,3297,3206,91,2.8
20169,12/1/19,30033,29184,849,2.8
20171,12/1/19,2933,2881,52,1.8
20173,12/1/19,251488,243395,8093,3.2
20175,12/1/19,9427,9168,259,2.7
20177,12/1/19,89595,86710,2885,3.2
20179,12/1/19,1454,1424,30,2.1
20181,12/1/19,2842,2768,74,2.6
20183,12/1/19,2011,1962,49,2.4
20185,12/1/19,2112,2058,54,2.6
20187,12/1/19,1023,998,25,2.4
20189,12/1/19,2552,2491,61,2.4
20191,12/1/19,10949,10624,325,3
20193,12/1/19,4327,4246,81,1.9
20195,12/1/19,1449,1412,37,2.6
20197,12/1/19,3644,3537,107,2.9
20199,12/1/19,812,793,19,2.3
20201,12/1/19,3006,2949,57,1.9
20203,12/1/19,1245,1221,24,1.9
20205,12/1/19,3982,3823,159,4
20207,12/1/19,1610,1544,66,4.1
20209,12/1/19,77490,74592,2898,3.7
21001,12/1/19,7229,6883,346,4.8
21003,12/1/19,9184,8840,344,3.7
21005,12/1/19,12459,12032,427,3.4
21007,12/1/19,3576,3379,197,5.5
21009,12/1/19,18822,18035,787,4.2
21011,12/1/19,4664,4395,269,5.8
21013,12/1/19,8518,7950,568,6.7
21015,12/1/19,71168,69014,2154,3
21017,12/1/19,9930,9581,349,3.5
21019,12/1/19,17851,16904,947,5.3
21021,12/1/19,12347,11842,505,4.1
21023,12/1/19,3854,3687,167,4.3
21025,12/1/19,3458,3157,301,8.7
21027,12/1/19,7941,7543,398,5
21029,12/1/19,43021,41469,1552,3.6
21031,12/1/19,5208,4983,225,4.3
21033,12/1/19,5525,5269,256,4.6
21035,12/1/19,18684,18012,672,3.6
21037,12/1/19,50970,49386,1584,3.1
21039,12/1/19,2290,2202,88,3.8
21041,12/1/19,5375,5182,193,3.6
21043,12/1/19,9868,9054,814,8.2
21045,12/1/19,6723,6478,245,3.6
21047,12/1/19,25276,24036,1240,4.9
21049,12/1/19,17246,16622,624,3.6
21051,12/1/19,5183,4842,341,6.6
21053,12/1/19,4034,3821,213,5.3
21055,12/1/19,3826,3675,151,3.9
21057,12/1/19,3212,3086,126,3.9
21059,12/1/19,47482,45767,1715,3.6
21061,12/1/19,4880,4657,223,4.6
21063,12/1/19,2103,1912,191,9.1
21065,12/1/19,5437,5168,269,4.9
21067,12/1/19,175216,170118,5098,2.9
21069,12/1/19,6162,5850,312,5.1
21071,12/1/19,11035,10320,715,6.5
21073,12/1/19,26034,25216,818,3.1
21075,12/1/19,2058,1962,96,4.7
21077,12/1/19,4110,3968,142,3.5
21079,12/1/19,7703,7369,334,4.3
21081,12/1/19,11775,11351,424,3.6
21083,12/1/19,15994,15328,666,4.2
21085,12/1/19,11138,10649,489,4.4
21087,12/1/19,5210,5009,201,3.9
21089,12/1/19,13465,12592,873,6.5
21091,12/1/19,3972,3841,131,3.3
21093,12/1/19,48895,47094,1801,3.7
21095,12/1/19,6679,5940,739,11.1
21097,12/1/19,8875,8550,325,3.7
21099,12/1/19,8086,7608,478,5.9
21101,12/1/19,22082,21262,820,3.7
21103,12/1/19,8331,8060,271,3.3
21105,12/1/19,1775,1691,84,4.7
21107,12/1/19,18549,17766,783,4.2
21109,12/1/19,4144,3891,253,6.1
21111,12/1/19,402027,388284,13743,3.4
21113,12/1/19,26598,25759,839,3.2
21115,12/1/19,6727,6303,424,6.3
21117,12/1/19,88136,85260,2876,3.3
21119,12/1/19,4446,4153,293,6.6
21121,12/1/19,9813,9256,557,5.7
21123,12/1/19,6029,5776,253,4.2
21125,12/1/19,24306,23239,1067,4.4
21127,12/1/19,5265,4897,368,7
21129,12/1/19,2059,1946,113,5.5
21131,12/1/19,2730,2464,266,9.7
21133,12/1/19,6419,5898,521,8.1
21135,12/1/19,4719,4292,427,9
21137,12/1/19,9168,8760,408,4.5
21139,12/1/19,3687,3499,188,5.1
21141,12/1/19,12678,12192,486,3.8
21143,12/1/19,3026,2899,127,4.2
21145,12/1/19,29533,28175,1358,4.6
21147,12/1/19,4673,4410,263,5.6
21149,12/1/19,4238,4072,166,3.9
21151,12/1/19,48161,46554,1607,3.3
21153,12/1/19,3286,2890,396,12.1
21155,12/1/19,9686,9369,317,3.3
21157,12/1/19,15081,14465,616,4.1
21159,12/1/19,2747,2564,183,6.7
21161,12/1/19,7136,6749,387,5.4
21163,12/1/19,12262,11740,522,4.3
21165,12/1/19,2322,2166,156,6.7
21167,12/1/19,9971,9536,435,4.4
21169,12/1/19,4159,3954,205,4.9
21171,12/1/19,4770,4612,158,3.3
21173,12/1/19,11657,11111,546,4.7
21175,12/1/19,4598,4345,253,5.5
21177,12/1/19,10376,9741,635,6.1
21179,12/1/19,23349,22453,896,3.8
21181,12/1/19,3363,3226,137,4.1
21183,12/1/19,9754,9305,449,4.6
21185,12/1/19,33538,32614,924,2.8
21187,12/1/19,5110,4925,185,3.6
21189,12/1/19,1137,1065,72,6.3
21191,12/1/19,7046,6799,247,3.5
21193,12/1/19,8269,7723,546,6.6
21195,12/1/19,19654,18512,1142,5.8
21197,12/1/19,5101,4816,285,5.6
21199,12/1/19,26837,25671,1166,4.3
21201,12/1/19,836,798,38,4.5
21203,12/1/19,6796,6514,282,4.1
21205,12/1/19,10476,9938,538,5.1
21207,12/1/19,6203,5865,338,5.4
21209,12/1/19,29195,28275,920,3.2
21211,12/1/19,25737,24998,739,2.9
21213,12/1/19,8987,8613,374,4.2
21215,12/1/19,10285,9970,315,3.1
21217,12/1/19,13120,12650,470,3.6
21219,12/1/19,5541,5332,209,3.8
21221,12/1/19,6092,5840,252,4.1
21223,12/1/19,3925,3766,159,4.1
21225,12/1/19,6207,5952,255,4.1
21227,12/1/19,65983,63421,2562,3.9
21229,12/1/19,6347,6121,226,3.6
21231,12/1/19,7514,7125,389,5.2
21233,12/1/19,5669,5451,218,3.8
21235,12/1/19,13514,12850,664,4.9
21237,12/1/19,1997,1847,150,7.5
21239,12/1/19,15141,14689,452,3
22001,12/1/19,23679,22394,1285,5.4
22003,12/1/19,8824,8239,585,6.6
22005,12/1/19,63944,61243,2701,4.2
22007,12/1/19,8837,8303,534,6
22009,12/1/19,14993,14044,949,6.3
22011,12/1/19,14391,13606,785,5.5
22013,12/1/19,5465,5121,344,6.3
22015,12/1/19,57408,54920,2488,4.3
22017,12/1/19,103144,97506,5638,5.5
22019,12/1/19,103592,98969,4623,4.5
22021,12/1/19,3791,3500,291,7.7
22023,12/1/19,3843,3680,163,4.2
22025,12/1/19,3345,3126,219,6.5
22027,12/1/19,5852,5472,380,6.5
22029,12/1/19,7074,6599,475,6.7
22031,12/1/19,10848,10152,696,6.4
22033,12/1/19,230393,220084,10309,4.5
22035,12/1/19,1859,1646,213,11.5
22037,12/1/19,7927,7575,352,4.4
22039,12/1/19,11771,11070,701,6
22041,12/1/19,7273,6731,542,7.5
22043,12/1/19,8226,7648,578,7
22045,12/1/19,27959,26343,1616,5.8
22047,12/1/19,14034,13165,869,6.2
22049,12/1/19,6776,6451,325,4.8
22051,12/1/19,214052,205295,8757,4.1
22053,12/1/19,13009,12393,616,4.7
22055,12/1/19,113213,108278,4935,4.4
22057,12/1/19,41788,39971,1817,4.3
22059,12/1/19,6746,6457,289,4.3
22061,12/1/19,22179,21042,1137,5.1
22063,12/1/19,68528,65724,2804,4.1
22065,12/1/19,3446,3170,276,8
22067,12/1/19,10088,9126,962,9.5
22069,12/1/19,16608,15555,1053,6.3
22071,12/1/19,179138,170426,8712,4.9
22073,12/1/19,70175,66312,3863,5.5
22075,12/1/19,10014,9586,428,4.3
22077,12/1/19,9790,9254,536,5.5
22079,12/1/19,54878,52053,2825,5.1
22081,12/1/19,3716,3503,213,5.7
22083,12/1/19,8124,7567,557,6.9
22085,12/1/19,9068,8600,468,5.2
22087,12/1/19,19843,18860,983,5
22089,12/1/19,25206,24113,1093,4.3
22091,12/1/19,4270,3994,276,6.5
22093,12/1/19,9278,8702,576,6.2
22095,12/1/19,19821,18620,1201,6.1
22097,12/1/19,31849,29758,2091,6.6
22099,12/1/19,22155,20986,1169,5.3
22101,12/1/19,19858,18679,1179,5.9
22103,12/1/19,119335,114440,4895,4.1
22105,12/1/19,54896,51815,3081,5.6
22107,12/1/19,1309,1199,110,8.4
22109,12/1/19,46094,43957,2137,4.6
22111,12/1/19,9056,8510,546,6
22113,12/1/19,23917,22666,1251,5.2
22115,12/1/19,15727,14767,960,6.1
22117,12/1/19,16644,15676,968,5.8
22119,12/1/19,14465,13556,909,6.3
22121,12/1/19,13629,13021,608,4.5
22123,12/1/19,3659,3176,483,13.2
22125,12/1/19,5365,5131,234,4.4
22127,12/1/19,4816,4489,327,6.8
23001,12/1/19,55516,54015,1501,2.7
23003,12/1/19,30000,28709,1291,4.3
23005,12/1/19,163827,160206,3621,2.2
23007,12/1/19,14452,13951,501,3.5
23009,12/1/19,27724,26628,1096,4
23011,12/1/19,61641,59922,1719,2.8
23013,12/1/19,19653,19097,556,2.8
23015,12/1/19,16341,15882,459,2.8
23017,12/1/19,26369,25473,896,3.4
23019,12/1/19,77662,75311,2351,3
23021,12/1/19,7236,6960,276,3.8
23023,12/1/19,19247,18823,424,2.2
23025,12/1/19,22068,21068,1000,4.5
23027,12/1/19,20414,19778,636,3.1
23029,12/1/19,13823,13261,562,4.1
23031,12/1/19,112921,109891,3030,2.7
24001,12/1/19,32023,30591,1432,4.5
24003,12/1/19,318588,310668,7920,2.5
24005,12/1/19,458445,444346,14099,3.1
24009,12/1/19,50681,49400,1281,2.5
24011,12/1/19,18084,17527,557,3.1
24013,12/1/19,96751,94442,2309,2.4
24015,12/1/19,53208,51451,1757,3.3
24017,12/1/19,88445,85770,2675,3
24019,12/1/19,15223,14586,637,4.2
24021,12/1/19,135197,131633,3564,2.6
24023,12/1/19,15486,14786,700,4.5
24025,12/1/19,142311,138454,3857,2.7
24027,12/1/19,189696,185505,4191,2.2
24029,12/1/19,9949,9588,361,3.6
24031,12/1/19,564087,550548,13539,2.4
24033,12/1/19,516196,499789,16407,3.2
24035,12/1/19,28181,27448,733,2.6
24037,12/1/19,57301,55796,1505,2.6
24039,12/1/19,8967,8468,499,5.6
24041,12/1/19,19398,18832,566,2.9
24043,12/1/19,76547,74077,2470,3.2
24045,12/1/19,50287,48021,2266,4.5
24047,12/1/19,25750,23306,2444,9.5
24510,12/1/19,290523,278177,12346,4.2
25001,12/1/19,110894,106645,4249,3.8
25003,12/1/19,65063,63043,2020,3.1
25005,12/1/19,306280,296654,9626,3.1
25007,12/1/19,8560,8163,397,4.6
25009,12/1/19,430487,420080,10407,2.4
25011,12/1/19,41679,40769,910,2.2
25013,12/1/19,231489,223719,7770,3.4
25015,12/1/19,91474,89652,1822,2
25017,12/1/19,930476,913870,16606,1.8
25019,12/1/19,6688,6329,359,5.4
25021,12/1/19,396424,388516,7908,2
25023,12/1/19,287192,279949,7243,2.5
25025,12/1/19,461862,452543,9319,2
25027,12/1/19,454423,442619,11804,2.6
26001,12/1/19,3755,3521,234,6.2
26003,12/1/19,3031,2762,269,8.9
26005,12/1/19,61579,59883,1696,2.8
26007,12/1/19,13229,12667,562,4.2
26009,12/1/19,9928,9436,492,5
26011,12/1/19,5936,5543,393,6.6
26013,12/1/19,3195,2980,215,6.7
26015,12/1/19,31391,30479,912,2.9
26017,12/1/19,49453,47373,2080,4.2
26019,12/1/19,8751,8304,447,5.1
26021,12/1/19,72410,69820,2590,3.6
26023,12/1/19,19155,18516,639,3.3
26025,12/1/19,62350,60200,2150,3.4
26027,12/1/19,24332,23460,872,3.6
26029,12/1/19,12283,11699,584,4.8
26031,12/1/19,9838,8663,1175,11.9
26033,12/1/19,15907,14881,1026,6.4
26035,12/1/19,11564,10855,709,6.1
26037,12/1/19,41124,40102,1022,2.5
26039,12/1/19,5491,5158,333,6.1
26041,12/1/19,17054,16034,1020,6
26043,12/1/19,12216,11684,532,4.4
26045,12/1/19,57356,55749,1607,2.8
26047,12/1/19,17188,16208,980,5.7
26049,12/1/19,183587,176302,7285,4
26051,12/1/19,9679,9130,549,5.7
26053,12/1/19,6038,5754,284,4.7
26055,12/1/19,48974,47436,1538,3.1
26057,12/1/19,18063,17393,670,3.7
26059,12/1/19,20251,19541,710,3.5
26061,12/1/19,16443,15750,693,4.2
26063,12/1/19,15096,14505,591,3.9
26065,12/1/19,151224,147144,4080,2.7
26067,12/1/19,30090,29265,825,2.7
26069,12/1/19,10090,9493,597,5.9
26071,12/1/19,5093,4807,286,5.6
26073,12/1/19,34613,33430,1183,3.4
26075,12/1/19,73961,71582,2379,3.2
26077,12/1/19,133921,130309,3612,2.7
26079,12/1/19,7836,7380,456,5.8
26081,12/1/19,356995,348545,8450,2.4
26083,12/1/19,906,838,68,7.5
26085,12/1/19,3786,3565,221,5.8
26087,12/1/19,41625,39344,2281,5.5
26089,12/1/19,10295,9957,338,3.3
26091,12/1/19,46306,44923,1383,3
26093,12/1/19,104219,101131,3088,3
26095,12/1/19,2262,2107,155,6.9
26097,12/1/19,4188,3486,702,16.8
26099,12/1/19,450438,434047,16391,3.6
26101,12/1/19,10190,9638,552,5.4
26103,12/1/19,32961,31574,1387,4.2
26105,12/1/19,13171,12507,664,5
26107,12/1/19,18273,17496,777,4.3
26109,12/1/19,11042,10494,548,5
26111,12/1/19,39763,38450,1313,3.3
26113,12/1/19,6829,6515,314,4.6
26115,12/1/19,75201,72915,2286,3
26117,12/1/19,28012,27018,994,3.5
26119,12/1/19,2994,2701,293,9.8
26121,12/1/19,76923,74004,2919,3.8
26123,12/1/19,23165,22292,873,3.8
26125,12/1/19,679992,660057,19935,2.9
26127,12/1/19,11455,10766,689,6
26129,12/1/19,7832,7294,538,6.9
26131,12/1/19,2089,1936,153,7.3
26133,12/1/19,11267,10849,418,3.7
26135,12/1/19,2933,2716,217,7.4
26137,12/1/19,11388,10878,510,4.5
26139,12/1/19,159487,155897,3590,2.3
26141,12/1/19,4794,4400,394,8.2
26143,12/1/19,7382,6827,555,7.5
26145,12/1/19,86682,83144,3538,4.1
26147,12/1/19,76151,72793,3358,4.4
26149,12/1/19,27385,26498,887,3.2
26151,12/1/19,19094,18321,773,4
26153,12/1/19,3297,3041,256,7.8
26155,12/1/19,33500,32247,1253,3.7
26157,12/1/19,23646,22624,1022,4.3
26159,12/1/19,34982,33509,1473,4.2
26161,12/1/19,200349,196082,4267,2.1
26163,12/1/19,810632,774479,36153,4.5
26165,12/1/19,14751,14142,609,4.1
27001,12/1/19,7397,6778,619,8.4
27003,12/1/19,200257,193999,6258,3.1
27005,12/1/19,18935,17963,972,5.1
27007,12/1/19,24903,23649,1254,5
27009,12/1/19,22382,21309,1073,4.8
27011,12/1/19,2496,2348,148,5.9
27013,12/1/19,41456,40377,1079,2.6
27015,12/1/19,14387,13806,581,4
27017,12/1/19,18060,17082,978,5.4
27019,12/1/19,59305,57657,1648,2.8
27021,12/1/19,14230,13143,1087,7.6
27023,12/1/19,7112,6796,316,4.4
27025,12/1/19,30564,29201,1363,4.5
27027,12/1/19,36705,35593,1112,3
27029,12/1/19,4701,4211,490,10.4
27031,12/1/19,3019,2828,191,6.3
27033,12/1/19,6100,5899,201,3.3
27035,12/1/19,32164,30279,1885,5.9
27037,12/1/19,244624,237642,6982,2.9
27039,12/1/19,12000,11543,457,3.8
27041,12/1/19,21018,20205,813,3.9
27043,12/1/19,7111,6750,361,5.1
27045,12/1/19,11684,11233,451,3.9
27047,12/1/19,16330,15734,596,3.6
27049,12/1/19,27508,26572,936,3.4
27051,12/1/19,3359,3175,184,5.5
27053,12/1/19,713985,695396,18589,2.6
27055,12/1/19,10592,10220,372,3.5
27057,12/1/19,9963,9260,703,7.1
27059,12/1/19,21802,20701,1101,5
27061,12/1/19,21975,20436,1539,7
27063,12/1/19,5766,5588,178,3.1
27065,12/1/19,9392,8582,810,8.6
27067,12/1/19,24731,23694,1037,4.2
27069,12/1/19,2429,2323,106,4.4
27071,12/1/19,5905,5496,409,6.9
27073,12/1/19,3620,3484,136,3.8
27075,12/1/19,5352,5128,224,4.2
27077,12/1/19,2559,2438,121,4.7
27079,12/1/19,16650,15613,1037,6.2
27081,12/1/19,3364,3191,173,5.1
27083,12/1/19,14659,14138,521,3.6
27085,12/1/19,19445,18614,831,4.3
27087,12/1/19,2320,2180,140,6
27089,12/1/19,5560,5126,434,7.8
27091,12/1/19,10062,9713,349,3.5
27093,12/1/19,13642,12938,704,5.2
27095,12/1/19,13324,12385,939,7
27097,12/1/19,17916,16556,1360,7.6
27099,12/1/19,20484,19836,648,3.2
27101,12/1/19,4930,4666,264,5.4
27103,12/1/19,21410,20874,536,2.5
27105,12/1/19,11372,11053,319,2.8
27107,12/1/19,3315,3136,179,5.4
27109,12/1/19,89100,86818,2282,2.6
27111,12/1/19,31775,30048,1727,5.4
27113,12/1/19,8808,8235,573,6.5
27115,12/1/19,15487,14347,1140,7.4
27117,12/1/19,4944,4759,185,3.7
27119,12/1/19,16872,16203,669,4
27121,12/1/19,6645,6400,245,3.7
27123,12/1/19,292786,284453,8333,2.8
27125,12/1/19,2244,2104,140,6.2
27127,12/1/19,7787,7487,300,3.9
27129,12/1/19,8666,8205,461,5.3
27131,12/1/19,37629,36272,1357,3.6
27133,12/1/19,5727,5581,146,2.5
27135,12/1/19,7959,7626,333,4.2
27137,12/1/19,102499,98065,4434,4.3
27139,12/1/19,84637,82261,2376,2.8
27141,12/1/19,53401,51238,2163,4.1
27143,12/1/19,8753,8328,425,4.9
27145,12/1/19,91549,88354,3195,3.5
27147,12/1/19,21600,20890,710,3.3
27149,12/1/19,5473,5295,178,3.3
27151,12/1/19,5062,4753,309,6.1
27153,12/1/19,13913,13129,784,5.6
27155,12/1/19,1757,1684,73,4.2
27157,12/1/19,12479,11973,506,4.1
27159,12/1/19,6152,5655,497,8.1
27161,12/1/19,9079,8639,440,4.8
27163,12/1/19,145139,141051,4088,2.8
27165,12/1/19,6574,6314,260,4
27167,12/1/19,3495,3374,121,3.5
27169,12/1/19,28882,28031,851,2.9
27171,12/1/19,77000,74124,2876,3.7
27173,12/1/19,5506,5290,216,3.9
28001,12/1/19,11436,10631,805,7
28003,12/1/19,16159,15433,726,4.5
28005,12/1/19,4391,4070,321,7.3
28007,12/1/19,7053,6614,439,6.2
28009,12/1/19,3092,2902,190,6.1
28011,12/1/19,12048,11138,910,7.6
28013,12/1/19,5546,5236,310,5.6
28015,12/1/19,3469,3254,215,6.2
28017,12/1/19,6846,6492,354,5.2
28019,12/1/19,3732,3511,221,5.9
28021,12/1/19,3041,2714,327,10.8
28023,12/1/19,5945,5573,372,6.3
28025,12/1/19,7798,7163,635,8.1
28027,12/1/19,8268,7623,645,7.8
28029,12/1/19,11145,10475,670,6
28031,12/1/19,8159,7780,379,4.6
28033,12/1/19,92289,88522,3767,4.1
28035,12/1/19,33571,32015,1556,4.6
28037,12/1/19,2777,2570,207,7.5
28039,12/1/19,8846,8155,691,7.8
28041,12/1/19,4377,3984,393,9
28043,12/1/19,9364,8905,459,4.9
28045,12/1/19,18915,17887,1028,5.4
28047,12/1/19,87112,82724,4388,5
28049,12/1/19,107238,101994,5244,4.9
28051,12/1/19,5664,5095,569,10
28053,12/1/19,2201,1944,257,11.7
28055,12/1/19,369,336,33,8.9
28057,12/1/19,10585,10132,453,4.3
28059,12/1/19,58958,55515,3443,5.8
28061,12/1/19,6206,5722,484,7.8
28063,12/1/19,2059,1703,356,17.3
28065,12/1/19,4110,3837,273,6.6
28067,12/1/19,26102,24772,1330,5.1
28069,12/1/19,3509,3250,259,7.4
28071,12/1/19,28899,27834,1065,3.7
28073,12/1/19,31079,29879,1200,3.9
28075,12/1/19,30632,29076,1556,5.1
28077,12/1/19,4596,4275,321,7
28079,12/1/19,7800,7376,424,5.4
28081,12/1/19,41672,39976,1696,4.1
28083,12/1/19,10044,9293,751,7.5
28085,12/1/19,14652,13798,854,5.8
28087,12/1/19,25735,24425,1310,5.1
28089,12/1/19,53412,51242,2170,4.1
28091,12/1/19,10007,9455,552,5.5
28093,12/1/19,14676,13832,844,5.8
28095,12/1/19,15676,14871,805,5.1
28097,12/1/19,3894,3660,234,6
28099,12/1/19,10023,9433,590,5.9
28101,12/1/19,8915,8439,476,5.3
28103,12/1/19,3750,3471,279,7.4
28105,12/1/19,22822,21705,1117,4.9
28107,12/1/19,12607,11821,786,6.2
28109,12/1/19,23910,22725,1185,5
28111,12/1/19,4334,4046,288,6.6
28113,12/1/19,14502,13573,929,6.4
28115,12/1/19,14920,14312,608,4.1
28117,12/1/19,11298,10787,511,4.5
28119,12/1/19,2321,2122,199,8.6
28121,12/1/19,76393,73550,2843,3.7
28123,12/1/19,12575,12050,525,4.2
28125,12/1/19,1609,1450,159,9.9
28127,12/1/19,10729,10206,523,4.9
28129,12/1/19,6770,6400,370,5.5
28131,12/1/19,6884,6472,412,6
28133,12/1/19,7713,6902,811,10.5
28135,12/1/19,5199,4874,325,6.3
28137,12/1/19,12444,11786,658,5.3
28139,12/1/19,9427,9003,424,4.5
28141,12/1/19,8572,8117,455,5.3
28143,12/1/19,4459,4182,277,6.2
28145,12/1/19,14444,13854,590,4.1
28147,12/1/19,4899,4547,352,7.2
28149,12/1/19,20417,19230,1187,5.8
28151,12/1/19,16996,15653,1343,7.9
28153,12/1/19,7349,6898,451,6.1
28155,12/1/19,3985,3770,215,5.4
28157,12/1/19,2855,2549,306,10.7
28159,12/1/19,7402,6984,418,5.6
28161,12/1/19,4967,4717,250,5
28163,12/1/19,9333,8766,567,6.1
29001,12/1/19,10369,10030,339,3.3
29003,12/1/19,9789,9528,261,2.7
29005,12/1/19,2662,2573,89,3.3
29007,12/1/19,10678,10333,345,3.2
29009,12/1/19,15483,14889,594,3.8
29011,12/1/19,5192,5013,179,3.4
29013,12/1/19,7893,7595,298,3.8
29015,12/1/19,7185,6838,347,4.8
29017,12/1/19,5531,5317,214,3.9
29019,12/1/19,99481,97069,2412,2.4
29021,12/1/19,44825,43455,1370,3.1
29023,12/1/19,18276,17416,860,4.7
29025,12/1/19,4368,4228,140,3.2
29027,12/1/19,21220,20573,647,3
29029,12/1/19,18301,17164,1137,6.2
29031,12/1/19,41392,40164,1228,3
29033,12/1/19,4714,4543,171,3.6
29035,12/1/19,2554,2432,122,4.8
29037,12/1/19,55207,53529,1678,3
29039,12/1/19,5750,5547,203,3.5
29041,12/1/19,3797,3667,130,3.4
29043,12/1/19,45463,44188,1275,2.8
29045,12/1/19,3197,3075,122,3.8
29047,12/1/19,137324,133415,3909,2.8
29049,12/1/19,10755,10427,328,3
29051,12/1/19,38822,37767,1055,2.7
29053,12/1/19,7526,7273,253,3.4
29055,12/1/19,10985,10510,475,4.3
29057,12/1/19,3533,3415,118,3.3
29059,12/1/19,7189,6780,409,5.7
29061,12/1/19,4071,3937,134,3.3
29063,12/1/19,4815,4670,145,3
29065,12/1/19,6304,6047,257,4.1
29067,12/1/19,5153,4843,310,6
29069,12/1/19,11424,10780,644,5.6
29071,12/1/19,53487,51644,1843,3.4
29073,12/1/19,7695,7423,272,3.5
29075,12/1/19,3464,3365,99,2.9
29077,12/1/19,153178,148575,4603,3
29079,12/1/19,4407,4244,163,3.7
29081,12/1/19,3777,3649,128,3.4
29083,12/1/19,9722,9377,345,3.5
29085,12/1/19,3802,3626,176,4.6
29087,12/1/19,2534,2470,64,2.5
29089,12/1/19,4917,4773,144,2.9
29091,12/1/19,16898,16078,820,4.9
29093,12/1/19,3532,3349,183,5.2
29095,12/1/19,365774,352321,13453,3.7
29097,12/1/19,58049,56206,1843,3.2
29099,12/1/19,118932,115032,3900,3.3
29101,12/1/19,23201,22369,832,3.6
29103,12/1/19,1777,1724,53,3
29105,12/1/19,17760,15981,1779,10
29107,12/1/19,16849,16331,518,3.1
29109,12/1/19,18027,17358,669,3.7
29111,12/1/19,5004,4841,163,3.3
29113,12/1/19,28476,27532,944,3.3
29115,12/1/19,5150,4893,257,5
29117,12/1/19,7328,7128,200,2.7
29119,12/1/19,10864,10485,379,3.5
29121,12/1/19,7594,7330,264,3.5
29123,12/1/19,5509,5301,208,3.8
29125,12/1/19,3902,3763,139,3.6
29127,12/1/19,14724,14258,466,3.2
29129,12/1/19,1852,1794,58,3.1
29131,12/1/19,12307,11770,537,4.4
29133,12/1/19,5784,5534,250,4.3
29135,12/1/19,7193,6984,209,2.9
29137,12/1/19,3906,3733,173,4.4
29139,12/1/19,5730,5553,177,3.1
29141,12/1/19,8131,7737,394,4.8
29143,12/1/19,8232,7853,379,4.6
29145,12/1/19,27615,26731,884,3.2
29147,12/1/19,10953,10661,292,2.7
29149,12/1/19,4043,3858,185,4.6
29151,12/1/19,7027,6862,165,2.3
29153,12/1/19,3371,3118,253,7.5
29155,12/1/19,6354,5995,359,5.6
29157,12/1/19,10061,9786,275,2.7
29159,12/1/19,21095,20388,707,3.4
29161,12/1/19,19934,19258,676,3.4
29163,12/1/19,7504,7225,279,3.7
29165,12/1/19,59109,57523,1586,2.7
29167,12/1/19,14680,14202,478,3.3
29169,12/1/19,14715,14022,693,4.7
29171,12/1/19,2225,2150,75,3.4
29173,12/1/19,5708,5529,179,3.1
29175,12/1/19,10528,10107,421,4
29177,12/1/19,11062,10676,386,3.5
29179,12/1/19,2996,2871,125,4.2
29181,12/1/19,5026,4777,249,5
29183,12/1/19,227773,221693,6080,2.7
29185,12/1/19,3748,3572,176,4.7
29186,12/1/19,9171,8907,264,2.9
29187,12/1/19,26896,25788,1108,4.1
29189,12/1/19,535325,518621,16704,3.1
29195,12/1/19,10566,10221,345,3.3
29197,12/1/19,1932,1860,72,3.7
29199,12/1/19,2365,2310,55,2.3
29201,12/1/19,20054,19310,744,3.7
29203,12/1/19,3209,3000,209,6.5
29205,12/1/19,3060,2962,98,3.2
29207,12/1/19,13062,12434,628,4.8
29209,12/1/19,13731,13082,649,4.7
29211,12/1/19,2661,2563,98,3.7
29213,12/1/19,26567,25463,1104,4.2
29215,12/1/19,9102,8642,460,5.1
29217,12/1/19,9397,9066,331,3.5
29219,12/1/19,18029,17478,551,3.1
29221,12/1/19,10282,9781,501,4.9
29223,12/1/19,5276,5029,247,4.7
29225,12/1/19,17497,16772,725,4.1
29227,12/1/19,1160,1128,32,2.8
29229,12/1/19,7693,7072,621,8.1
29510,12/1/19,153635,147586,6049,3.9
30001,12/1/19,5009,4843,166,3.3
30003,12/1/19,4740,4424,316,6.7
30005,12/1/19,2524,2421,103,4.1
30007,12/1/19,2558,2451,107,4.2
30009,12/1/19,5482,5283,199,3.6
30011,12/1/19,660,647,13,2
30013,12/1/19,37894,36616,1278,3.4
30015,12/1/19,2509,2428,81,3.2
30017,12/1/19,6093,5907,186,3.1
30019,12/1/19,906,883,23,2.5
30021,12/1/19,4603,4478,125,2.7
30023,12/1/19,4904,4738,166,3.4
30025,12/1/19,1708,1669,39,2.3
30027,12/1/19,6038,5820,218,3.6
30029,12/1/19,47451,44991,2460,5.2
30031,12/1/19,68746,67096,1650,2.4
30033,12/1/19,764,738,26,3.4
30035,12/1/19,5431,5028,403,7.4
30037,12/1/19,368,355,13,3.5
30039,12/1/19,1647,1539,108,6.6
30041,12/1/19,7598,7346,252,3.3
30043,12/1/19,5655,5444,211,3.7
30045,12/1/19,1008,976,32,3.2
30047,12/1/19,13112,12547,565,4.3
30049,12/1/19,35311,34244,1067,3
30051,12/1/19,975,952,23,2.4
30053,12/1/19,8038,7334,704,8.8
30055,12/1/19,974,953,21,2.2
30057,12/1/19,5187,5014,173,3.3
30059,12/1/19,1002,967,35,3.5
30061,12/1/19,1683,1573,110,6.5
30063,12/1/19,63663,61408,2255,3.5
30065,12/1/19,2280,2188,92,4
30067,12/1/19,8699,8345,354,4.1
30069,12/1/19,289,276,13,4.5
30071,12/1/19,1928,1842,86,4.5
30073,12/1/19,2656,2570,86,3.2
30075,12/1/19,975,952,23,2.4
30077,12/1/19,3008,2907,101,3.4
30079,12/1/19,481,464,17,3.5
30081,12/1/19,20172,19327,845,4.2
30083,12/1/19,5917,5774,143,2.4
30085,12/1/19,4474,4293,181,4
30087,12/1/19,3779,3621,158,4.2
30089,12/1/19,4771,4476,295,6.2
30091,12/1/19,1741,1699,42,2.4
30093,12/1/19,17016,16346,670,3.9
30095,12/1/19,5310,5140,170,3.2
30097,12/1/19,1816,1765,51,2.8
30099,12/1/19,2759,2647,112,4.1
30101,12/1/19,2102,2042,60,2.9
30103,12/1/19,339,331,8,2.4
30105,12/1/19,4037,3901,136,3.4
30107,12/1/19,810,775,35,4.3
30109,12/1/19,464,451,13,2.8
30111,12/1/19,81095,78573,2522,3.1
31001,12/1/19,16640,16132,508,3.1
31003,12/1/19,3572,3500,72,2
31005,12/1/19,232,219,13,5.6
31007,12/1/19,392,379,13,3.3
31009,12/1/19,269,253,16,5.9
31011,12/1/19,2981,2909,72,2.4
31013,12/1/19,5362,5204,158,2.9
31015,12/1/19,1094,1059,35,3.2
31017,12/1/19,1393,1353,40,2.9
31019,12/1/19,27659,27090,569,2.1
31021,12/1/19,3468,3348,120,3.5
31023,12/1/19,4474,4370,104,2.3
31025,12/1/19,13578,13185,393,2.9
31027,12/1/19,4532,4433,99,2.2
31029,12/1/19,2292,2249,43,1.9
31031,12/1/19,3391,3324,67,2
31033,12/1/19,4314,4172,142,3.3
31035,12/1/19,3293,3189,104,3.2
31037,12/1/19,5540,5409,131,2.4
31039,12/1/19,4655,4540,115,2.5
31041,12/1/19,6402,6274,128,2
31043,12/1/19,10715,10293,422,3.9
31045,12/1/19,4906,4786,120,2.4
31047,12/1/19,12970,12636,334,2.6
31049,12/1/19,955,931,24,2.5
31051,12/1/19,3053,2959,94,3.1
31053,12/1/19,19476,18960,516,2.6
31055,12/1/19,299109,290524,8585,2.9
31057,12/1/19,1202,1170,32,2.7
31059,12/1/19,3147,3078,69,2.2
31061,12/1/19,1452,1409,43,3
31063,12/1/19,1641,1590,51,3.1
31065,12/1/19,2544,2480,64,2.5
31067,12/1/19,10877,10535,342,3.1
31069,12/1/19,1086,1049,37,3.4
31071,12/1/19,1176,1152,24,2
31073,12/1/19,1094,1070,24,2.2
31075,12/1/19,438,427,11,2.5
31077,12/1/19,1230,1203,27,2.2
31079,12/1/19,31446,30473,973,3.1
31081,12/1/19,4748,4620,128,2.7
31083,12/1/19,1763,1710,53,3
31085,12/1/19,637,621,16,2.5
31087,12/1/19,1258,1221,37,2.9
31089,12/1/19,5809,5681,128,2.2
31091,12/1/19,382,369,13,3.4
31093,12/1/19,3325,3239,86,2.6
31095,12/1/19,4143,4047,96,2.3
31097,12/1/19,2050,1986,64,3.1
31099,12/1/19,3787,3720,67,1.8
31101,12/1/19,4503,4356,147,3.3
31103,12/1/19,614,601,13,2.1
31105,12/1/19,1991,1946,45,2.3
31107,12/1/19,4614,4494,120,2.6
31109,12/1/19,177971,173808,4163,2.3
31111,12/1/19,18113,17530,583,3.2
31113,12/1/19,484,471,13,2.7
31115,12/1/19,424,400,24,5.7
31117,12/1/19,450,439,11,2.4
31119,12/1/19,19561,19093,468,2.4
31121,12/1/19,3986,3879,107,2.7
31123,12/1/19,2628,2548,80,3
31125,12/1/19,2025,1921,104,5.1
31127,12/1/19,3599,3492,107,3
31129,12/1/19,2411,2358,53,2.2
31131,12/1/19,8413,8191,222,2.6
31133,12/1/19,1482,1453,29,2
31135,12/1/19,1837,1794,43,2.3
31137,12/1/19,4983,4871,112,2.2
31139,12/1/19,4055,3967,88,2.2
31141,12/1/19,17582,17106,476,2.7
31143,12/1/19,2972,2886,86,2.9
31145,12/1/19,5822,5691,131,2.3
31147,12/1/19,4185,4075,110,2.6
31149,12/1/19,903,876,27,3
31151,12/1/19,7326,7120,206,2.8
31153,12/1/19,96421,94011,2410,2.5
31155,12/1/19,11213,10943,270,2.4
31157,12/1/19,18095,17467,628,3.5
31159,12/1/19,9027,8805,222,2.5
31161,12/1/19,2679,2618,61,2.3
31163,12/1/19,1696,1645,51,3
31165,12/1/19,762,743,19,2.5
31167,12/1/19,3486,3414,72,2.1
31169,12/1/19,2768,2701,67,2.4
31171,12/1/19,435,416,19,4.4
31173,12/1/19,3092,2966,126,4.1
31175,12/1/19,2112,2064,48,2.3
31177,12/1/19,11276,11011,265,2.4
31179,12/1/19,5875,5760,115,2
31181,12/1/19,1688,1635,53,3.1
31183,12/1/19,578,565,13,2.2
31185,12/1/19,7186,7034,152,2.1
32001,12/1/19,11074,10745,329,3
32003,12/1/19,1136500,1096609,39891,3.5
32005,12/1/19,23093,22276,817,3.5
32007,12/1/19,26639,25950,689,2.6
32009,12/1/19,447,428,19,4.3
32011,12/1/19,1070,1046,24,2.2
32013,12/1/19,8147,7938,209,2.6
32015,12/1/19,3184,3089,95,3
32017,12/1/19,2113,2045,68,3.2
32019,12/1/19,23184,22229,955,4.1
32021,12/1/19,1994,1927,67,3.4
32023,12/1/19,17509,16718,791,4.5
32027,12/1/19,2523,2428,95,3.8
32029,12/1/19,2074,2002,72,3.5
32031,12/1/19,259618,252484,7134,2.7
32033,12/1/19,4635,4521,114,2.5
32510,12/1/19,26336,25433,903,3.4
33001,12/1/19,30897,30183,714,2.3
33003,12/1/19,23349,22854,495,2.1
33005,12/1/19,41281,40339,942,2.3
33007,12/1/19,14674,14240,434,3
33009,12/1/19,50242,49280,962,1.9
33011,12/1/19,243268,237512,5756,2.4
33013,12/1/19,84127,82490,1637,1.9
33015,12/1/19,187512,182904,4608,2.5
33017,12/1/19,74679,73123,1556,2.1
33019,12/1/19,23020,22551,469,2
34001,12/1/19,120456,113885,6571,5.5
34003,12/1/19,490413,476456,13957,2.8
34005,12/1/19,233300,225747,7553,3.2
34007,12/1/19,256556,245963,10593,4.1
34009,12/1/19,43012,38504,4508,10.5
34011,12/1/19,65813,61832,3981,6
34013,12/1/19,372921,355956,16965,4.5
34015,12/1/19,151788,146057,5731,3.8
34017,12/1/19,367680,355800,11880,3.2
34019,12/1/19,64974,63215,1759,2.7
34021,12/1/19,206536,200083,6453,3.1
34023,12/1/19,443823,430370,13453,3
34025,12/1/19,332234,321753,10481,3.2
34027,12/1/19,259168,251968,7200,2.8
34029,12/1/19,278635,267909,10726,3.8
34031,12/1/19,246678,235960,10718,4.3
34033,12/1/19,29328,27777,1551,5.3
34035,12/1/19,173038,167867,5171,3
34037,12/1/19,74731,72041,2690,3.6
34039,12/1/19,279272,268924,10348,3.7
34041,12/1/19,56777,54819,1958,3.4
35001,12/1/19,338145,324560,13585,4
35003,12/1/19,1135,1055,80,7
35005,12/1/19,27334,26056,1278,4.7
35006,12/1/19,9061,8531,530,5.8
35007,12/1/19,5271,5040,231,4.4
35009,12/1/19,21898,21085,813,3.7
35011,12/1/19,800,769,31,3.9
35013,12/1/19,99485,94243,5242,5.3
35015,12/1/19,36007,34991,1016,2.8
35017,12/1/19,12521,11959,562,4.5
35019,12/1/19,1528,1463,65,4.3
35021,12/1/19,274,262,12,4.4
35023,12/1/19,2013,1925,88,4.4
35025,12/1/19,32466,31266,1200,3.7
35027,12/1/19,8912,8513,399,4.5
35028,12/1/19,9499,9225,274,2.9
35029,12/1/19,9827,8367,1460,14.9
35031,12/1/19,24420,22866,1554,6.4
35033,12/1/19,2241,2098,143,6.4
35035,12/1/19,25104,23966,1138,4.5
35037,12/1/19,3239,3097,142,4.4
35039,12/1/19,16820,15976,844,5
35041,12/1/19,7805,7488,317,4.1
35043,12/1/19,67247,64341,2906,4.3
35045,12/1/19,52185,49286,2899,5.6
35047,12/1/19,10712,10128,584,5.5
35049,12/1/19,76226,73546,2680,3.5
35051,12/1/19,3901,3673,228,5.8
35053,12/1/19,6433,6103,330,5.1
35055,12/1/19,15723,14861,862,5.5
35057,12/1/19,5851,5482,369,6.3
35059,12/1/19,1792,1719,73,4.1
35061,12/1/19,30987,29501,1486,4.8
36001,12/1/19,157856,152160,5696,3.6
36003,12/1/19,19909,18732,1177,5.9
36005,12/1/19,590723,565019,25704,4.4
36007,12/1/19,83186,79005,4181,5
36009,12/1/19,34622,32608,2014,5.8
36011,12/1/19,35830,34154,1676,4.7
36013,12/1/19,54196,51284,2912,5.4
36015,12/1/19,35098,33527,1571,4.5
36017,12/1/19,22004,20909,1095,5
36019,12/1/19,36453,34753,1700,4.7
36021,12/1/19,31006,29979,1027,3.3
36023,12/1/19,22918,21673,1245,5.4
36025,12/1/19,18944,18021,923,4.9
36027,12/1/19,143918,138687,5231,3.6
36029,12/1/19,440751,420669,20082,4.6
36031,12/1/19,17048,16093,955,5.6
36033,12/1/19,19630,18563,1067,5.4
36035,12/1/19,22711,21472,1239,5.5
36037,12/1/19,29682,28375,1307,4.4
36039,12/1/19,20516,19504,1012,4.9
36041,12/1/19,2114,1912,202,9.6
36043,12/1/19,27843,26334,1509,5.4
36045,12/1/19,43754,40739,3015,6.9
36047,12/1/19,1186163,1148138,38025,3.2
36049,12/1/19,11894,11098,796,6.7
36051,12/1/19,30734,29355,1379,4.5
36053,12/1/19,32948,31315,1633,5
36055,12/1/19,359998,344339,15659,4.3
36057,12/1/19,22489,21251,1238,5.5
36059,12/1/19,707352,683043,24309,3.4
36061,12/1/19,903737,878653,25084,2.8
36063,12/1/19,99089,93529,5560,5.6
36065,12/1/19,100429,95885,4544,4.5
36067,12/1/19,220473,211506,8967,4.1
36069,12/1/19,55321,53005,2316,4.2
36071,12/1/19,183775,176624,7151,3.9
36073,12/1/19,17673,16719,954,5.4
36075,12/1/19,53216,50027,3189,6
36077,12/1/19,27724,26421,1303,4.7
36079,12/1/19,51213,49255,1958,3.8
36081,12/1/19,1129372,1098757,30615,2.7
36083,12/1/19,81341,78286,3055,3.8
36085,12/1/19,220013,213450,6563,3
36087,12/1/19,153959,148534,5425,3.5
36089,12/1/19,43921,41402,2519,5.7
36091,12/1/19,119495,115305,4190,3.5
36093,12/1/19,76287,73332,2955,3.9
36095,12/1/19,14758,14037,721,4.9
36097,12/1/19,7916,7475,441,5.6
36099,12/1/19,16077,15361,716,4.5
36101,12/1/19,42461,40317,2144,5
36103,12/1/19,778232,748689,29543,3.8
36105,12/1/19,36200,34598,1602,4.4
36107,12/1/19,22633,21627,1006,4.4
36109,12/1/19,49738,48073,1665,3.3
36111,12/1/19,87580,84291,3289,3.8
36113,12/1/19,30913,29161,1752,5.7
36115,12/1/19,27402,26168,1234,4.5
36117,12/1/19,44049,41961,2088,4.7
36119,12/1/19,480882,462585,18297,3.8
36121,12/1/19,18141,17172,969,5.3
36123,12/1/19,11973,11437,536,4.5
37001,12/1/19,82658,80033,2625,3.2
37003,12/1/19,18128,17626,502,2.8
37005,12/1/19,4396,4199,197,4.5
37007,12/1/19,10925,10507,418,3.8
37009,12/1/19,13021,12628,393,3
37011,12/1/19,7169,6928,241,3.4
37013,12/1/19,19549,18792,757,3.9
37015,12/1/19,7877,7557,320,4.1
37017,12/1/19,14782,14167,615,4.2
37019,12/1/19,53137,50617,2520,4.7
37021,12/1/19,141638,138003,3635,2.6
37023,12/1/19,41243,39906,1337,3.2
37025,12/1/19,110223,106840,3383,3.1
37027,12/1/19,36706,35461,1245,3.4
37029,12/1/19,4671,4511,160,3.4
37031,12/1/19,31674,30577,1097,3.5
37033,12/1/19,9993,9609,384,3.8
37035,12/1/19,79223,76760,2463,3.1
37037,12/1/19,35988,34946,1042,2.9
37039,12/1/19,11057,10633,424,3.8
37041,12/1/19,5613,5401,212,3.8
37043,12/1/19,4133,3968,165,4
37045,12/1/19,48725,46946,1779,3.7
37047,12/1/19,23137,22121,1016,4.4
37049,12/1/19,41904,40472,1432,3.4
37051,12/1/19,128172,122502,5670,4.4
37053,12/1/19,14067,13620,447,3.2
37055,12/1/19,17629,16823,806,4.6
37057,12/1/19,81266,78610,2656,3.3
37059,12/1/19,20761,20143,618,3
37061,12/1/19,25974,25068,906,3.5
37063,12/1/19,171635,166705,4930,2.9
37065,12/1/19,21462,20434,1028,4.8
37067,12/1/19,188207,182184,6023,3.2
37069,12/1/19,31494,30435,1059,3.4
37071,12/1/19,112328,108414,3914,3.5
37073,12/1/19,5351,5163,188,3.5
37075,12/1/19,3119,2952,167,5.4
37077,12/1/19,29981,29118,863,2.9
37079,12/1/19,9673,9378,295,3
37081,12/1/19,264438,255358,9080,3.4
37083,12/1/19,20406,19341,1065,5.2
37085,12/1/19,53579,51546,2033,3.8
37087,12/1/19,30201,29314,887,2.9
37089,12/1/19,55618,54041,1577,2.8
37091,12/1/19,9195,8811,384,4.2
37093,12/1/19,20265,19381,884,4.4
37095,12/1/19,1844,1655,189,10.2
37097,12/1/19,90564,87683,2881,3.2
37099,12/1/19,19755,19098,657,3.3
37101,12/1/19,100002,96886,3116,3.1
37103,12/1/19,4466,4319,147,3.3
37105,12/1/19,26118,25136,982,3.8
37107,12/1/19,28070,27141,929,3.3
37109,12/1/19,44048,42680,1368,3.1
37111,12/1/19,20452,19741,711,3.5
37113,12/1/19,15463,14956,507,3.3
37115,12/1/19,10245,9937,308,3
37117,12/1/19,9131,8743,388,4.2
37119,12/1/19,627840,608435,19405,3.1
37121,12/1/19,5990,5750,240,4
37123,12/1/19,11489,11088,401,3.5
37125,12/1/19,42403,41022,1381,3.3
37127,12/1/19,43739,41996,1743,4
37129,12/1/19,125535,121794,3741,3
37131,12/1/19,7788,7419,369,4.7
37133,12/1/19,65958,63370,2588,3.9
37135,12/1/19,79138,77019,2119,2.7
37137,12/1/19,5376,5208,168,3.1
37139,12/1/19,16736,16071,665,4
37141,12/1/19,29345,28353,992,3.4
37143,12/1/19,5019,4799,220,4.4
37145,12/1/19,18509,17852,657,3.5
37147,12/1/19,90462,87238,3224,3.6
37149,12/1/19,8999,8706,293,3.3
37151,12/1/19,66941,64788,2153,3.2
37153,12/1/19,16716,15925,791,4.7
37155,12/1/19,50730,48370,2360,4.7
37157,12/1/19,40541,38990,1551,3.8
37159,12/1/19,67192,64656,2536,3.8
37161,12/1/19,25326,24211,1115,4.4
37163,12/1/19,30058,29085,973,3.2
37165,12/1/19,11607,10940,667,5.7
37167,12/1/19,30469,29456,1013,3.3
37169,12/1/19,21837,21141,696,3.2
37171,12/1/19,34066,32961,1105,3.2
37173,12/1/19,6742,6515,227,3.4
37175,12/1/19,14473,14002,471,3.3
37177,12/1/19,1342,1266,76,5.7
37179,12/1/19,125276,121665,3611,2.9
37181,12/1/19,17314,16424,890,5.1
37183,12/1/19,599569,582580,16989,2.8
37185,12/1/19,6664,6319,345,5.2
37187,12/1/19,4405,4170,235,5.3
37189,12/1/19,29799,28991,808,2.7
37191,12/1/19,52215,50391,1824,3.5
37193,12/1/19,29347,28300,1047,3.6
37195,12/1/19,35038,33330,1708,4.9
37197,12/1/19,17873,17326,547,3.1
37199,12/1/19,8407,8122,285,3.4
38001,12/1/19,1044,1018,26,2.5
38003,12/1/19,5109,5001,108,2.1
38005,12/1/19,2275,2189,86,3.8
38007,12/1/19,352,342,10,2.8
38009,12/1/19,2833,2750,83,2.9
38011,12/1/19,1698,1664,34,2
38013,12/1/19,1038,1006,32,3.1
38015,12/1/19,48663,47564,1099,2.3
38017,12/1/19,101697,99842,1855,1.8
38019,12/1/19,1856,1809,47,2.5
38021,12/1/19,2227,2187,40,1.8
38023,12/1/19,1371,1348,23,1.7
38025,12/1/19,3113,3067,46,1.5
38027,12/1/19,1201,1161,40,3.3
38029,12/1/19,1417,1351,66,4.7
38031,12/1/19,1457,1415,42,2.9
38033,12/1/19,792,782,10,1.3
38035,12/1/19,36967,36289,678,1.8
38037,12/1/19,1160,1131,29,2.5
38039,12/1/19,981,957,24,2.4
38041,12/1/19,1334,1304,30,2.2
38043,12/1/19,1213,1166,47,3.9
38045,12/1/19,2000,1967,33,1.7
38047,12/1/19,862,840,22,2.6
38049,12/1/19,2983,2887,96,3.2
38051,12/1/19,1083,1051,32,3
38053,12/1/19,10208,10026,182,1.8
38055,12/1/19,4541,4392,149,3.3
38057,12/1/19,3348,3186,162,4.8
38059,12/1/19,15989,15529,460,2.9
38061,12/1/19,7331,7229,102,1.4
38063,12/1/19,1335,1296,39,2.9
38065,12/1/19,852,815,37,4.3
38067,12/1/19,3220,3115,105,3.3
38069,12/1/19,1653,1607,46,2.8
38071,12/1/19,5383,5221,162,3
38073,12/1/19,2748,2705,43,1.6
38075,12/1/19,1204,1171,33,2.7
38077,12/1/19,8336,8185,151,1.8
38079,12/1/19,4507,4178,329,7.3
38081,12/1/19,2582,2548,34,1.3
38083,12/1/19,688,639,49,7.1
38085,12/1/19,1204,1170,34,2.8
38087,12/1/19,386,377,9,2.3
38089,12/1/19,18030,17675,355,2
38091,12/1/19,946,930,16,1.7
38093,12/1/19,9998,9785,213,2.1
38095,12/1/19,1043,1011,32,3.1
38097,12/1/19,4302,4216,86,2
38099,12/1/19,4940,4791,149,3
38101,12/1/19,30876,30169,707,2.3
38103,12/1/19,1835,1769,66,3.6
38105,12/1/19,24085,23622,463,1.9
39001,12/1/19,10562,9864,698,6.6
39003,12/1/19,47440,45624,1816,3.8
39005,12/1/19,26450,25382,1068,4
39007,12/1/19,43946,41800,2146,4.9
39009,12/1/19,28085,26755,1330,4.7
39011,12/1/19,24791,24089,702,2.8
39013,12/1/19,30307,28468,1839,6.1
39015,12/1/19,19623,18695,928,4.7
39017,12/1/19,195551,188951,6600,3.4
39019,12/1/19,12883,12226,657,5.1
39021,12/1/19,19936,19257,679,3.4
39023,12/1/19,63022,60465,2557,4.1
39025,12/1/19,107032,103467,3565,3.3
39027,12/1/19,17794,17038,756,4.2
39029,12/1/19,47044,44955,2089,4.4
39031,12/1/19,14042,13114,928,6.6
39033,12/1/19,18101,17296,805,4.4
39035,12/1/19,604664,582953,21711,3.6
39037,12/1/19,25480,24595,885,3.5
39039,12/1/19,18013,17280,733,4.1
39041,12/1/19,111107,107946,3161,2.8
39043,12/1/19,35320,33551,1769,5
39045,12/1/19,78541,75831,2710,3.5
39047,12/1/19,13944,13470,474,3.4
39049,12/1/19,702350,680181,22169,3.2
39051,12/1/19,22328,21467,861,3.9
39053,12/1/19,12105,11434,671,5.5
39055,12/1/19,48487,47005,1482,3.1
39057,12/1/19,83394,80577,2817,3.4
39059,12/1/19,18342,17259,1083,5.9
39061,12/1/19,416835,402950,13885,3.3
39063,12/1/19,41802,40574,1228,2.9
39065,12/1/19,13615,13074,541,4
39067,12/1/19,6671,6285,386,5.8
39069,12/1/19,13112,12497,615,4.7
39071,12/1/19,16921,16040,881,5.2
39073,12/1/19,13213,12607,606,4.6
39075,12/1/19,20531,19953,578,2.8
39077,12/1/19,27338,25723,1615,5.9
39079,12/1/19,12577,11753,824,6.6
39081,12/1/19,27534,26007,1527,5.5
39083,12/1/19,31437,30296,1141,3.6
39085,12/1/19,124833,120775,4058,3.3
39087,12/1/19,23755,22632,1123,4.7
39089,12/1/19,91070,87953,3117,3.4
39091,12/1/19,22698,21882,816,3.6
39093,12/1/19,151769,146017,5752,3.8
39095,12/1/19,209140,200401,8739,4.2
39097,12/1/19,20888,20239,649,3.1
39099,12/1/19,101701,96408,5293,5.2
39101,12/1/19,28101,27071,1030,3.7
39103,12/1/19,96353,93492,2861,3
39105,12/1/19,8927,8324,603,6.8
39107,12/1/19,23049,22485,564,2.4
39109,12/1/19,54277,52423,1854,3.4
39111,12/1/19,5300,4827,473,8.9
39113,12/1/19,253002,243485,9517,3.8
39115,12/1/19,6619,6113,506,7.6
39117,12/1/19,16935,16262,673,4
39119,12/1/19,39747,37817,1930,4.9
39121,12/1/19,4616,4283,333,7.2
39123,12/1/19,20057,18729,1328,6.6
39125,12/1/19,8493,8186,307,3.6
39127,12/1/19,16044,15225,819,5.1
39129,12/1/19,26607,25620,987,3.7
39131,12/1/19,10671,10003,668,6.3
39133,12/1/19,86945,83395,3550,4.1
39135,12/1/19,21066,20323,743,3.5
39137,12/1/19,18603,18048,555,3
39139,12/1/19,51966,49597,2369,4.6
39141,12/1/19,35463,33957,1506,4.2
39143,12/1/19,29980,28726,1254,4.2
39145,12/1/19,28795,27032,1763,6.1
39147,12/1/19,27028,25956,1072,4
39149,12/1/19,23812,23032,780,3.3
39151,12/1/19,184552,176328,8224,4.5
39153,12/1/19,270842,260084,10758,4
39155,12/1/19,85589,80791,4798,5.6
39157,12/1/19,44444,42494,1950,4.4
39159,12/1/19,29098,28239,859,3
39161,12/1/19,14887,14403,484,3.3
39163,12/1/19,5533,5196,337,6.1
39165,12/1/19,119443,115715,3728,3.1
39167,12/1/19,27244,25788,1456,5.3
39169,12/1/19,62015,60104,1911,3.1
39171,12/1/19,18871,18263,608,3.2
39173,12/1/19,70841,68515,2326,3.3
39175,12/1/19,12921,12542,379,2.9
40001,12/1/19,7970,7641,329,4.1
40003,12/1/19,2776,2724,52,1.9
40005,12/1/19,4940,4717,223,4.5
40007,12/1/19,2861,2809,52,1.8
40009,12/1/19,9885,9459,426,4.3
40011,12/1/19,4636,4535,101,2.2
40013,12/1/19,21337,20727,610,2.9
40015,12/1/19,11664,11219,445,3.8
40017,12/1/19,74667,72510,2157,2.9
40019,12/1/19,21423,20691,732,3.4
40021,12/1/19,18332,17640,692,3.8
40023,12/1/19,5360,5080,280,5.2
40025,12/1/19,1284,1264,20,1.6
40027,12/1/19,143281,139655,3626,2.5
40029,12/1/19,2429,2317,112,4.6
40031,12/1/19,48291,46690,1601,3.3
40033,12/1/19,2708,2625,83,3.1
40035,12/1/19,5830,5626,204,3.5
40037,12/1/19,31582,30458,1124,3.6
40039,12/1/19,15733,15298,435,2.8
40041,12/1/19,17751,17116,635,3.6
40043,12/1/19,2855,2791,64,2.2
40045,12/1/19,2096,2032,64,3.1
40047,12/1/19,26722,25898,824,3.1
40049,12/1/19,12459,12030,429,3.4
40051,12/1/19,26591,25717,874,3.3
40053,12/1/19,2570,2515,55,2.1
40055,12/1/19,1791,1717,74,4.1
40057,12/1/19,1135,1105,30,2.6
40059,12/1/19,1713,1665,48,2.8
40061,12/1/19,4164,3916,248,6
40063,12/1/19,5303,5035,268,5.1
40065,12/1/19,10654,10354,300,2.8
40067,12/1/19,2485,2405,80,3.2
40069,12/1/19,3676,3496,180,4.9
40071,12/1/19,18092,17371,721,4
40073,12/1/19,9032,8850,182,2
40075,12/1/19,3396,3278,118,3.5
40077,12/1/19,3125,2896,229,7.3
40079,12/1/19,18947,18058,889,4.7
40081,12/1/19,15792,15242,550,3.5
40083,12/1/19,22098,21524,574,2.6
40085,12/1/19,6112,5974,138,2.3
40087,12/1/19,19651,19109,542,2.8
40089,12/1/19,14456,13567,889,6.1
40091,12/1/19,7092,6632,460,6.5
40093,12/1/19,3755,3681,74,2
40095,12/1/19,6812,6576,236,3.5
40097,12/1/19,19286,18730,556,2.9
40099,12/1/19,6269,6071,198,3.2
40101,12/1/19,29746,28661,1085,3.6
40103,12/1/19,5589,5450,139,2.5
40105,12/1/19,4567,4428,139,3
40107,12/1/19,4548,4331,217,4.8
40109,12/1/19,385882,374779,11103,2.9
40111,12/1/19,15674,14926,748,4.8
40113,12/1/19,20659,19914,745,3.6
40115,12/1/19,13897,13474,423,3
40117,12/1/19,7339,7053,286,3.9
40119,12/1/19,37431,36484,947,2.5
40121,12/1/19,16991,16182,809,4.8
40123,12/1/19,19247,18714,533,2.8
40125,12/1/19,32486,31368,1118,3.4
40127,12/1/19,4205,3984,221,5.3
40129,12/1/19,1819,1761,58,3.2
40131,12/1/19,45128,43833,1295,2.9
40133,12/1/19,9469,9005,464,4.9
40135,12/1/19,16116,15421,695,4.3
40137,12/1/19,18367,17511,856,4.7
40139,12/1/19,11076,10870,206,1.9
40141,12/1/19,2967,2843,124,4.2
40143,12/1/19,323297,313599,9698,3
40145,12/1/19,37994,36829,1165,3.1
40147,12/1/19,22038,21355,683,3.1
40149,12/1/19,5136,4927,209,4.1
40151,12/1/19,4570,4494,76,1.7
40153,12/1/19,8831,8496,335,3.8
41001,12/1/19,7056,6788,268,3.8
41003,12/1/19,48517,47530,987,2
41005,12/1/19,219024,213308,5716,2.6
41007,12/1/19,18634,18030,604,3.2
41009,12/1/19,24418,23505,913,3.7
41011,12/1/19,25815,24819,996,3.9
41013,12/1/19,9457,8989,468,4.9
41015,12/1/19,8620,8231,389,4.5
41017,12/1/19,95386,92333,3053,3.2
41019,12/1/19,45829,44025,1804,3.9
41021,12/1/19,868,837,31,3.6
41023,12/1/19,3049,2859,190,6.2
41025,12/1/19,3481,3320,161,4.6
41027,12/1/19,13736,13399,337,2.5
41029,12/1/19,102395,99167,3228,3.2
41031,12/1/19,9802,9390,412,4.2
41033,12/1/19,35320,33918,1402,4
41035,12/1/19,28501,26852,1649,5.8
41037,12/1/19,3547,3398,149,4.2
41039,12/1/19,180491,174928,5563,3.1
41041,12/1/19,19950,19208,742,3.7
41043,12/1/19,58446,56468,1978,3.4
41045,12/1/19,12116,11712,404,3.3
41047,12/1/19,160104,155151,4953,3.1
41049,12/1/19,5441,5247,194,3.6
41051,12/1/19,455097,443644,11453,2.5
41053,12/1/19,39585,38351,1234,3.1
41055,12/1/19,924,892,32,3.5
41057,12/1/19,11416,11025,391,3.4
41059,12/1/19,35266,33868,1398,4
41061,12/1/19,11683,11216,467,4
41063,12/1/19,3224,3072,152,4.7
41065,12/1/19,12236,11784,452,3.7
41067,12/1/19,325176,317612,7564,2.3
41069,12/1/19,697,671,26,3.7
41071,12/1/19,54472,53067,1405,2.6
42001,12/1/19,54708,52876,1832,3.3
42003,12/1/19,651334,624607,26727,4.1
42005,12/1/19,32831,30749,2082,6.3
42007,12/1/19,84645,80559,4086,4.8
42009,12/1/19,23721,22268,1453,6.1
42011,12/1/19,217465,207996,9469,4.4
42013,12/1/19,59652,56650,3002,5
42015,12/1/19,28963,27532,1431,4.9
42017,12/1/19,345150,332013,13137,3.8
42019,12/1/19,100616,96334,4282,4.3
42021,12/1/19,58471,55041,3430,5.9
42023,12/1/19,2081,1908,173,8.3
42025,12/1/19,32744,30801,1943,5.9
42027,12/1/19,81215,78391,2824,3.5
42029,12/1/19,285758,277087,8671,3
42031,12/1/19,17141,16158,983,5.7
42033,12/1/19,36460,34100,2360,6.5
42035,12/1/19,18425,17246,1179,6.4
42037,12/1/19,33705,31879,1826,5.4
42039,12/1/19,38657,36655,2002,5.2
42041,12/1/19,133637,129197,4440,3.3
42043,12/1/19,146005,140115,5890,4
42045,12/1/19,301853,290048,11805,3.9
42047,12/1/19,15528,14417,1111,7.2
42049,12/1/19,128865,122483,6382,5
42051,12/1/19,58045,54004,4041,7
42053,12/1/19,1807,1653,154,8.5
42055,12/1/19,79539,76197,3342,4.2
42057,12/1/19,8109,7573,536,6.6
42059,12/1/19,16720,15765,955,5.7
42061,12/1/19,20279,18664,1615,8
42063,12/1/19,39757,37492,2265,5.7
42065,12/1/19,20684,19405,1279,6.2
42067,12/1/19,12704,12056,648,5.1
42069,12/1/19,105702,100408,5294,5
42071,12/1/19,285807,276305,9502,3.3
42073,12/1/19,40924,38421,2503,6.1
42075,12/1/19,73136,70120,3016,4.1
42077,12/1/19,195539,186442,9097,4.7
42079,12/1/19,158790,149253,9537,6
42081,12/1/19,57240,54074,3166,5.5
42083,12/1/19,17484,16341,1143,6.5
42085,12/1/19,49082,46459,2623,5.3
42087,12/1/19,21193,20107,1086,5.1
42089,12/1/19,83934,79190,4744,5.7
42091,12/1/19,455624,440241,15383,3.4
42093,12/1/19,9120,8771,349,3.8
42095,12/1/19,163441,156126,7315,4.5
42097,12/1/19,42894,40144,2750,6.4
42099,12/1/19,24860,23853,1007,4.1
42101,12/1/19,729738,690247,39491,5.4
42103,12/1/19,25574,24036,1538,6
42105,12/1/19,7282,6728,554,7.6
42107,12/1/19,66833,63037,3796,5.7
42109,12/1/19,20600,19346,1254,6.1
42111,12/1/19,34177,31929,2248,6.6
42113,12/1/19,2683,2493,190,7.1
42115,12/1/19,20662,19634,1028,5
42117,12/1/19,19371,18173,1198,6.2
42119,12/1/19,19997,19148,849,4.2
42121,12/1/19,22314,21128,1186,5.3
42123,12/1/19,18903,17950,953,5
42125,12/1/19,107957,102740,5217,4.8
42127,12/1/19,22165,20889,1276,5.8
42129,12/1/19,182547,173807,8740,4.8
42131,12/1/19,13738,12996,742,5.4
42133,12/1/19,237714,228723,8991,3.8
44001,12/1/19,26188,25482,706,2.7
44003,12/1/19,91457,88708,2749,3
44005,12/1/19,44616,43340,1276,2.9
44007,12/1/19,327222,316112,11110,3.4
44009,12/1/19,69285,67329,1956,2.8
45001,12/1/19,10138,9840,298,2.9
45003,12/1/19,74745,72970,1775,2.4
45005,12/1/19,2676,2543,133,5
45007,12/1/19,91598,89575,2023,2.2
45009,12/1/19,4945,4715,230,4.7
45011,12/1/19,8187,7887,300,3.7
45013,12/1/19,77375,75731,1644,2.1
45015,12/1/19,104569,102348,2221,2.1
45017,12/1/19,6596,6398,198,3
45019,12/1/19,212623,208673,3950,1.9
45021,12/1/19,25239,24562,677,2.7
45023,12/1/19,13492,12996,496,3.7
45025,12/1/19,22029,21488,541,2.5
45027,12/1/19,12702,12272,430,3.4
45029,12/1/19,16765,16315,450,2.7
45031,12/1/19,30527,29673,854,2.8
45033,12/1/19,13056,12601,455,3.5
45035,12/1/19,78491,76917,1574,2
45037,12/1/19,10712,10460,252,2.4
45039,12/1/19,9613,9234,379,3.9
45041,12/1/19,67226,65612,1614,2.4
45043,12/1/19,25442,24595,847,3.3
45045,12/1/19,256113,250986,5127,2
45047,12/1/19,31607,30788,819,2.6
45049,12/1/19,8383,8198,185,2.2
45051,12/1/19,145007,140213,4794,3.3
45053,12/1/19,12631,12372,259,2.1
45055,12/1/19,29296,28555,741,2.5
45057,12/1/19,41494,40297,1197,2.9
45059,12/1/19,30322,29566,756,2.5
45061,12/1/19,6651,6381,270,4.1
45063,12/1/19,150174,147345,2829,1.9
45065,12/1/19,3380,3293,87,2.6
45067,12/1/19,12831,12390,441,3.4
45069,12/1/19,9157,8814,343,3.7
45071,12/1/19,19122,18680,442,2.3
45073,12/1/19,35025,34247,778,2.2
45075,12/1/19,34973,33531,1442,4.1
45077,12/1/19,57692,56367,1325,2.3
45079,12/1/19,198728,194263,4465,2.2
45081,12/1/19,8918,8724,194,2.2
45083,12/1/19,153496,150257,3239,2.1
45085,12/1/19,43703,42381,1322,3
45087,12/1/19,11669,11327,342,2.9
45089,12/1/19,11886,11379,507,4.3
45091,12/1/19,141013,137775,3238,2.3
46003,12/1/19,1526,1479,47,3.1
46005,12/1/19,9552,9244,308,3.2
46007,12/1/19,1098,1040,58,5.3
46009,12/1/19,2886,2780,106,3.7
46011,12/1/19,19486,18767,719,3.7
46013,12/1/19,20786,20119,667,3.2
46015,12/1/19,2441,2364,77,3.2
46017,12/1/19,675,630,45,6.7
46019,12/1/19,5015,4809,206,4.1
46021,12/1/19,792,761,31,3.9
46023,12/1/19,3730,3575,155,4.2
46025,12/1/19,1898,1840,58,3.1
46027,12/1/19,7491,7206,285,3.8
46029,12/1/19,15571,15066,505,3.2
46031,12/1/19,1385,1314,71,5.1
46033,12/1/19,3990,3788,202,5.1
46035,12/1/19,11060,10697,363,3.3
46037,12/1/19,2751,2609,142,5.2
46039,12/1/19,2148,2027,121,5.6
46041,12/1/19,2221,2066,155,7
46043,12/1/19,1605,1553,52,3.2
46045,12/1/19,2045,1979,66,3.2
46047,12/1/19,2859,2736,123,4.3
46049,12/1/19,1082,1045,37,3.4
46051,12/1/19,4439,4287,152,3.4
46053,12/1/19,2103,2026,77,3.7
46055,12/1/19,1055,1021,34,3.2
46057,12/1/19,3355,3245,110,3.3
46059,12/1/19,1818,1765,53,2.9
46061,12/1/19,1750,1655,95,5.4
46063,12/1/19,739,718,21,2.8
46065,12/1/19,9945,9679,266,2.7
46067,12/1/19,3632,3498,134,3.7
46069,12/1/19,685,659,26,3.8
46071,12/1/19,1231,1154,77,6.3
46073,12/1/19,1112,1083,29,2.6
46075,12/1/19,533,514,19,3.6
46077,12/1/19,2641,2564,77,2.9
46079,12/1/19,6674,6431,243,3.6
46081,12/1/19,13336,12881,455,3.4
46083,12/1/19,34565,33628,937,2.7
46085,12/1/19,1692,1613,79,4.7
46087,12/1/19,3082,2985,97,3.1
46089,12/1/19,1036,984,52,5
46091,12/1/19,2418,2310,108,4.5
46093,12/1/19,13950,13444,506,3.6
46095,12/1/19,748,701,47,6.3
46097,12/1/19,1192,1148,44,3.7
46099,12/1/19,113127,109585,3542,3.1
46101,12/1/19,3996,3864,132,3.3
46102,12/1/19,3590,3232,358,10
46103,12/1/19,56118,54069,2049,3.7
46105,12/1/19,1427,1379,48,3.4
46107,12/1/19,1049,1012,37,3.5
46109,12/1/19,4888,4640,248,5.1
46111,12/1/19,1166,1124,42,3.6
46115,12/1/19,3181,3065,116,3.6
46117,12/1/19,1836,1783,53,2.9
46119,12/1/19,795,774,21,2.6
46121,12/1/19,3161,2950,211,6.7
46123,12/1/19,3090,2995,95,3.1
46125,12/1/19,4692,4545,147,3.1
46127,12/1/19,8527,8205,322,3.8
46129,12/1/19,2124,2010,114,5.4
46135,12/1/19,11926,11544,382,3.2
46137,12/1/19,939,889,50,5.3
47001,12/1/19,34972,33881,1091,3.1
47003,12/1/19,21150,20437,713,3.4
47005,12/1/19,6951,6651,300,4.3
47007,12/1/19,4407,4183,224,5.1
47009,12/1/19,64232,62392,1840,2.9
47011,12/1/19,54415,52745,1670,3.1
47013,12/1/19,14995,14361,634,4.2
47015,12/1/19,6747,6566,181,2.7
47017,12/1/19,12148,11583,565,4.7
47019,12/1/19,24293,23404,889,3.7
47021,12/1/19,22363,21845,518,2.3
47023,12/1/19,8649,8390,259,3
47025,12/1/19,13186,12687,499,3.8
47027,12/1/19,2818,2651,167,5.9
47029,12/1/19,15002,14393,609,4.1
47031,12/1/19,25871,25025,846,3.3
47033,12/1/19,7092,6864,228,3.2
47035,12/1/19,23900,22666,1234,5.2
47037,12/1/19,413927,404589,9338,2.3
47039,12/1/19,4621,4386,235,5.1
47041,12/1/19,7755,7455,300,3.9
47043,12/1/19,27670,26940,730,2.6
47045,12/1/19,16649,15910,739,4.4
47047,12/1/19,19465,18783,682,3.5
47049,12/1/19,7572,7266,306,4
47051,12/1/19,20558,19864,694,3.4
47053,12/1/19,22415,21533,882,3.9
47055,12/1/19,15243,14632,611,4
47057,12/1/19,9622,9263,359,3.7
47059,12/1/19,29704,28338,1366,4.6
47061,12/1/19,5024,4827,197,3.9
47063,12/1/19,28675,27655,1020,3.6
47065,12/1/19,185110,179449,5661,3.1
47067,12/1/19,2122,2018,104,4.9
47069,12/1/19,9610,9116,494,5.1
47071,12/1/19,10545,10084,461,4.4
47073,12/1/19,23932,22993,939,3.9
47075,12/1/19,7799,7464,335,4.3
47077,12/1/19,12344,11871,473,3.8
47079,12/1/19,14341,13735,606,4.2
47081,12/1/19,11692,11374,318,2.7
47083,12/1/19,3295,3157,138,4.2
47085,12/1/19,8998,8654,344,3.8
47087,12/1/19,4745,4543,202,4.3
47089,12/1/19,25007,24196,811,3.2
47091,12/1/19,7798,7532,266,3.4
47093,12/1/19,246664,240364,6300,2.6
47095,12/1/19,1741,1653,88,5.1
47097,12/1/19,9854,9360,494,5
47099,12/1/19,19658,18948,710,3.6
47101,12/1/19,5220,5056,164,3.1
47103,12/1/19,16369,15369,1000,6.1
47105,12/1/19,23789,23031,758,3.2
47107,12/1/19,24157,23251,906,3.8
47109,12/1/19,8744,8217,527,6
47111,12/1/19,11551,11228,323,2.8
47113,12/1/19,49527,47958,1569,3.2
47115,12/1/19,12592,12057,535,4.2
47117,12/1/19,15873,15312,561,3.5
47119,12/1/19,50572,49208,1364,2.7
47121,12/1/19,5357,5063,294,5.5
47123,12/1/19,20338,19615,723,3.6
47125,12/1/19,86734,83771,2963,3.4
47127,12/1/19,3684,3577,107,2.9
47129,12/1/19,7961,7683,278,3.5
47131,12/1/19,12559,12026,533,4.2
47133,12/1/19,10128,9805,323,3.2
47135,12/1/19,3123,2973,150,4.8
47137,12/1/19,2385,2275,110,4.6
47139,12/1/19,7860,7568,292,3.7
47141,12/1/19,35817,34716,1101,3.1
47143,12/1/19,13704,12975,729,5.3
47145,12/1/19,23662,22795,867,3.7
47147,12/1/19,38971,37947,1024,2.6
47149,12/1/19,188644,184350,4294,2.3
47151,12/1/19,8293,7972,321,3.9
47153,12/1/19,6226,5983,243,3.9
47155,12/1/19,54840,53390,1450,2.6
47157,12/1/19,451150,434557,16593,3.7
47159,12/1/19,9674,9418,256,2.6
47161,12/1/19,5569,5348,221,4
47163,12/1/19,70675,68298,2377,3.4
47165,12/1/19,104850,102286,2564,2.4
47167,12/1/19,28577,27536,1041,3.6
47169,12/1/19,5557,5405,152,2.7
47171,12/1/19,7214,6872,342,4.7
47173,12/1/19,7692,7414,278,3.6
47175,12/1/19,2043,1965,78,3.8
47177,12/1/19,16663,16047,616,3.7
47179,12/1/19,61231,59308,1923,3.1
47181,12/1/19,6266,5967,299,4.8
47183,12/1/19,16184,15638,546,3.4
47185,12/1/19,12437,12019,418,3.4
47187,12/1/19,131381,128577,2804,2.1
47189,12/1/19,78528,76639,1889,2.4
48001,12/1/19,24104,23450,654,2.7
48003,12/1/19,9829,9600,229,2.3
48005,12/1/19,36017,34638,1379,3.8
48007,12/1/19,9411,9036,375,4
48009,12/1/19,4144,4036,108,2.6
48011,12/1/19,933,908,25,2.7
48013,12/1/19,21938,21201,737,3.4
48015,12/1/19,14210,13749,461,3.2
48017,12/1/19,2436,2364,72,3
48019,12/1/19,10164,9869,295,2.9
48021,12/1/19,43487,42291,1196,2.8
48023,12/1/19,1792,1752,40,2.2
48025,12/1/19,9837,9410,427,4.3
48027,12/1/19,145296,140325,4971,3.4
48029,12/1/19,960322,933181,27141,2.8
48031,12/1/19,6515,6376,139,2.1
48033,12/1/19,423,414,9,2.1
48035,12/1/19,8322,8046,276,3.3
48037,12/1/19,40043,38526,1517,3.8
48039,12/1/19,181774,173972,7802,4.3
48041,12/1/19,120803,117956,2847,2.4
48043,12/1/19,4180,4075,105,2.5
48045,12/1/19,573,555,18,3.1
48047,12/1/19,2616,2485,131,5
48049,12/1/19,15505,14950,555,3.6
48051,12/1/19,8503,8240,263,3.1
48053,12/1/19,23540,22958,582,2.5
48055,12/1/19,19898,19326,572,2.9
48057,12/1/19,12154,11739,415,3.4
48059,12/1/19,6174,5994,180,2.9
48061,12/1/19,167835,158333,9502,5.7
48063,12/1/19,4992,4794,198,4
48065,12/1/19,3017,2949,68,2.3
48067,12/1/19,12401,11908,493,4
48069,12/1/19,3370,3293,77,2.3
48071,12/1/19,19708,18819,889,4.5
48073,12/1/19,20927,20152,775,3.7
48075,12/1/19,2905,2822,83,2.9
48077,12/1/19,4932,4793,139,2.8
48079,12/1/19,1108,1070,38,3.4
48081,12/1/19,1461,1424,37,2.5
48083,12/1/19,2873,2746,127,4.4
48085,12/1/19,573039,557280,15759,2.8
48087,12/1/19,1144,1106,38,3.3
48089,12/1/19,9830,9546,284,2.9
48091,12/1/19,74184,72165,2019,2.7
48093,12/1/19,5624,5438,186,3.3
48095,12/1/19,1330,1296,34,2.6
48097,12/1/19,19767,19249,518,2.6
48099,12/1/19,24366,23496,870,3.6
48101,12/1/19,549,522,27,4.9
48103,12/1/19,1588,1517,71,4.5
48105,12/1/19,1625,1563,62,3.8
48107,12/1/19,2476,2396,80,3.2
48109,12/1/19,1056,1019,37,3.5
48111,12/1/19,3842,3767,75,2
48113,12/1/19,1386624,1343894,42730,3.1
48115,12/1/19,4645,4468,177,3.8
48117,12/1/19,8463,8253,210,2.5
48119,12/1/19,2448,2368,80,3.3
48121,12/1/19,503039,489671,13368,2.7
48123,12/1/19,9786,9535,251,2.6
48125,12/1/19,670,642,28,4.2
48127,12/1/19,7259,7079,180,2.5
48129,12/1/19,1390,1347,43,3.1
48131,12/1/19,4919,4678,241,4.9
48133,12/1/19,8163,7921,242,3
48135,12/1/19,88129,85565,2564,2.9
48137,12/1/19,1126,1108,18,1.6
48139,12/1/19,94182,91598,2584,2.7
48141,12/1/19,365817,352780,13037,3.6
48143,12/1/19,20904,20251,653,3.1
48145,12/1/19,6580,6382,198,3
48147,12/1/19,17422,16997,425,2.4
48149,12/1/19,12026,11740,286,2.4
48151,12/1/19,1612,1575,37,2.3
48153,12/1/19,2524,2427,97,3.8
48155,12/1/19,582,567,15,2.6
48157,12/1/19,395701,383009,12692,3.2
48159,12/1/19,4608,4460,148,3.2
48161,12/1/19,6363,6071,292,4.6
48163,12/1/19,10330,10075,255,2.5
48165,12/1/19,9792,9572,220,2.2
48167,12/1/19,167164,160608,6556,3.9
48169,12/1/19,2170,2108,62,2.9
48171,12/1/19,13634,13348,286,2.1
48173,12/1/19,790,775,15,1.9
48175,12/1/19,3277,3166,111,3.4
48177,12/1/19,9546,9304,242,2.5
48179,12/1/19,8074,7792,282,3.5
48181,12/1/19,64218,62354,1864,2.9
48183,12/1/19,58262,56186,2076,3.6
48185,12/1/19,11200,10782,418,3.7
48187,12/1/19,82389,80227,2162,2.6
48189,12/1/19,11939,11462,477,4
48191,12/1/19,1050,1006,44,4.2
48193,12/1/19,3655,3553,102,2.8
48195,12/1/19,2733,2674,59,2.2
48197,12/1/19,1714,1670,44,2.6
48199,12/1/19,25331,24192,1139,4.5
48201,12/1/19,2340079,2254317,85762,3.7
48203,12/1/19,29512,28360,1152,3.9
48205,12/1/19,2771,2727,44,1.6
48207,12/1/19,2279,2214,65,2.9
48209,12/1/19,121589,118563,3026,2.5
48211,12/1/19,1902,1852,50,2.6
48213,12/1/19,36649,35469,1180,3.2
48215,12/1/19,361012,335734,25278,7
48217,12/1/19,16493,15998,495,3
48219,12/1/19,11184,10893,291,2.6
48221,12/1/19,27914,27021,893,3.2
48223,12/1/19,17530,17032,498,2.8
48225,12/1/19,10466,10153,313,3
48227,12/1/19,14107,13679,428,3
48229,12/1/19,1831,1756,75,4.1
48231,12/1/19,44133,42686,1447,3.3
48233,12/1/19,8758,8365,393,4.5
48235,12/1/19,757,741,16,2.1
48237,12/1/19,3442,3336,106,3.1
48239,12/1/19,7704,7484,220,2.9
48241,12/1/19,12891,12049,842,6.5
48243,12/1/19,991,961,30,3
48245,12/1/19,107105,100882,6223,5.8
48247,12/1/19,1874,1791,83,4.4
48249,12/1/19,16647,15798,849,5.1
48251,12/1/19,83241,80778,2463,3
48253,12/1/19,5779,5547,232,4
48255,12/1/19,7294,7124,170,2.3
48257,12/1/19,65696,63739,1957,3
48259,12/1/19,22345,21806,539,2.4
48261,12/1/19,202,193,9,4.5
48263,12/1/19,480,467,13,2.7
48265,12/1/19,22355,21767,588,2.6
48267,12/1/19,1843,1791,52,2.8
48269,12/1/19,239,235,4,1.7
48271,12/1/19,1385,1333,52,3.8
48273,12/1/19,13571,13020,551,4.1
48275,12/1/19,1421,1380,41,2.9
48277,12/1/19,24216,23469,747,3.1
48279,12/1/19,5264,5085,179,3.4
48281,12/1/19,9305,9024,281,3
48283,12/1/19,4312,4204,108,2.5
48285,12/1/19,8455,8233,222,2.6
48287,12/1/19,10003,9749,254,2.5
48289,12/1/19,6350,6089,261,4.1
48291,12/1/19,33552,31774,1778,5.3
48293,12/1/19,8617,8298,319,3.7
48295,12/1/19,1634,1599,35,2.1
48297,12/1/19,5625,5466,159,2.8
48299,12/1/19,8678,8399,279,3.2
48301,12/1/19,681,677,4,0.6
48303,12/1/19,158392,154507,3885,2.5
48305,12/1/19,2768,2690,78,2.8
48307,12/1/19,3360,3212,148,4.4
48309,12/1/19,120036,116419,3617,3
48311,12/1/19,886,873,13,1.5
48313,12/1/19,4533,4357,176,3.9
48315,12/1/19,4238,4045,193,4.6
48317,12/1/19,2899,2816,83,2.9
48319,12/1/19,1758,1703,55,3.1
48321,12/1/19,16695,15669,1026,6.1
48323,12/1/19,24169,22243,1926,8
48325,12/1/19,22064,21416,648,2.9
48327,12/1/19,875,848,27,3.1
48329,12/1/19,107893,105706,2187,2
48331,12/1/19,9690,9276,414,4.3
48333,12/1/19,1916,1857,59,3.1
48335,12/1/19,2325,2251,74,3.2
48337,12/1/19,9360,9122,238,2.5
48339,12/1/19,286787,277538,9249,3.2
48341,12/1/19,10829,10587,242,2.2
48343,12/1/19,4800,4539,261,5.4
48345,12/1/19,474,459,15,3.2
48347,12/1/19,28125,27162,963,3.4
48349,12/1/19,24258,23570,688,2.8
48351,12/1/19,5194,4862,332,6.4
48353,12/1/19,7185,6994,191,2.7
48355,12/1/19,167633,160846,6787,4
48357,12/1/19,4305,4172,133,3.1
48359,12/1/19,919,894,25,2.7
48361,12/1/19,36434,34575,1859,5.1
48363,12/1/19,13556,13176,380,2.8
48365,12/1/19,10150,9750,400,3.9
48367,12/1/19,68211,66372,1839,2.7
48369,12/1/19,4855,4758,97,2
48371,12/1/19,6316,6099,217,3.4
48373,12/1/19,18199,17297,902,5
48375,12/1/19,55554,54161,1393,2.5
48377,12/1/19,3158,2891,267,8.5
48379,12/1/19,6080,5916,164,2.7
48381,12/1/19,72492,70933,1559,2.2
48383,12/1/19,1926,1865,61,3.2
48385,12/1/19,991,956,35,3.5
48387,12/1/19,5140,4916,224,4.4
48389,12/1/19,12031,11823,208,1.7
48391,12/1/19,3123,3017,106,3.4
48393,12/1/19,416,406,10,2.4
48395,12/1/19,7753,7500,253,3.3
48397,12/1/19,52962,51488,1474,2.8
48399,12/1/19,4618,4498,120,2.6
48401,12/1/19,23065,22247,818,3.5
48403,12/1/19,3644,3403,241,6.6
48405,12/1/19,3456,3270,186,5.4
48407,12/1/19,11858,11300,558,4.7
48409,12/1/19,29972,28314,1658,5.5
48411,12/1/19,2601,2523,78,3
48413,12/1/19,1307,1269,38,2.9
48415,12/1/19,6737,6527,210,3.1
48417,12/1/19,1890,1850,40,2.1
48419,12/1/19,11208,10766,442,3.9
48421,12/1/19,1360,1333,27,2
48423,12/1/19,107966,104609,3357,3.1
48425,12/1/19,4433,4274,159,3.6
48427,12/1/19,25960,22741,3219,12.4
48429,12/1/19,4049,3938,111,2.7
48431,12/1/19,564,548,16,2.8
48433,12/1/19,570,554,16,2.8
48435,12/1/19,1292,1239,53,4.1
48437,12/1/19,2591,2505,86,3.3
48439,12/1/19,1095859,1063687,32172,2.9
48441,12/1/19,67546,65805,1741,2.6
48443,12/1/19,367,354,13,3.5
48445,12/1/19,4918,4756,162,3.3
48447,12/1/19,646,624,22,3.4
48449,12/1/19,13083,12579,504,3.9
48451,12/1/19,54431,52897,1534,2.8
48453,12/1/19,751789,734410,17379,2.3
48455,12/1/19,5305,5039,266,5
48457,12/1/19,7159,6709,450,6.3
48459,12/1/19,17913,17248,665,3.7
48461,12/1/19,1674,1634,40,2.4
48463,12/1/19,11347,10957,390,3.4
48465,12/1/19,23166,22333,833,3.6
48467,12/1/19,26106,25298,808,3.1
48469,12/1/19,42931,41470,1461,3.4
48471,12/1/19,24155,23315,840,3.5
48473,12/1/19,23660,22830,830,3.5
48475,12/1/19,7551,7374,177,2.3
48477,12/1/19,15304,14852,452,3
48479,12/1/19,119349,115066,4283,3.6
48481,12/1/19,21809,21075,734,3.4
48483,12/1/19,2261,2195,66,2.9
48485,12/1/19,56462,54817,1645,2.9
48487,12/1/19,4960,4789,171,3.4
48489,12/1/19,6664,6181,483,7.2
48491,12/1/19,318437,310403,8034,2.5
48493,12/1/19,25162,24509,653,2.6
48495,12/1/19,4041,3915,126,3.1
48497,12/1/19,32283,31322,961,3
48499,12/1/19,17788,17126,662,3.7
48501,12/1/19,3653,3544,109,3
48503,12/1/19,8037,7814,223,2.8
48505,12/1/19,4885,4601,284,5.8
48507,12/1/19,3398,3125,273,8
49001,12/1/19,2716,2650,66,2.4
49003,12/1/19,25963,25382,581,2.2
49005,12/1/19,65771,64658,1113,1.7
49007,12/1/19,8493,8219,274,3.2
49009,12/1/19,339,326,13,3.8
49011,12/1/19,175052,171603,3449,2
49013,12/1/19,7775,7496,279,3.6
49015,12/1/19,4263,4100,163,3.8
49017,12/1/19,2314,2097,217,9.4
49019,12/1/19,5585,5257,328,5.9
49021,12/1/19,24759,24181,578,2.3
49023,12/1/19,5837,5716,121,2.1
49025,12/1/19,3551,3448,103,2.9
49027,12/1/19,5773,5647,126,2.2
49029,12/1/19,5589,5480,109,2
49031,12/1/19,475,452,23,4.8
49033,12/1/19,973,938,35,3.6
49035,12/1/19,645033,631786,13247,2.1
49037,12/1/19,5431,5136,295,5.4
49039,12/1/19,12349,12002,347,2.8
49041,12/1/19,9619,9353,266,2.8
49043,12/1/19,26909,26434,475,1.8
49045,12/1/19,34574,33758,816,2.4
49047,12/1/19,13551,12979,572,4.2
49049,12/1/19,313739,307545,6194,2
49051,12/1/19,16791,16413,378,2.3
49053,12/1/19,76389,74466,1923,2.5
49055,12/1/19,1305,1193,112,8.6
49057,12/1/19,128336,125299,3037,2.4
50001,12/1/19,20180,19752,428,2.1
50003,12/1/19,17892,17370,522,2.9
50005,12/1/19,14234,13864,370,2.6
50007,12/1/19,94900,93396,1504,1.6
50009,12/1/19,2631,2549,82,3.1
50011,12/1/19,26804,26240,564,2.1
50013,12/1/19,4013,3871,142,3.5
50015,12/1/19,13782,13398,384,2.8
50017,12/1/19,15724,15387,337,2.1
50019,12/1/19,13305,12780,525,3.9
50021,12/1/19,30231,29520,711,2.4
50023,12/1/19,34304,33623,681,2
50025,12/1/19,21896,21414,482,2.2
50027,12/1/19,28723,28210,513,1.8
51001,12/1/19,16588,15996,592,3.6
51003,12/1/19,57881,56748,1133,2
51005,12/1/19,6902,6665,237,3.4
51007,12/1/19,6403,6224,179,2.8
51009,12/1/19,15060,14623,437,2.9
51011,12/1/19,7190,6960,230,3.2
51013,12/1/19,156564,154142,2422,1.5
51015,12/1/19,38007,37254,753,2
51017,12/1/19,2515,2459,56,2.2
51019,12/1/19,38503,37530,973,2.5
51021,12/1/19,2882,2793,89,3.1
51023,12/1/19,17447,17068,379,2.2
51025,12/1/19,5996,5759,237,4
51027,12/1/19,6701,6295,406,6.1
51029,12/1/19,6563,6275,288,4.4
51031,12/1/19,25970,25277,693,2.7
51033,12/1/19,15486,15044,442,2.9
51035,12/1/19,13337,12781,556,4.2
51036,12/1/19,3729,3620,109,2.9
51037,12/1/19,5335,5146,189,3.5
51041,12/1/19,190107,185622,4485,2.4
51043,12/1/19,7747,7595,152,2
51045,12/1/19,2301,2243,58,2.5
51047,12/1/19,25029,24490,539,2.2
51049,12/1/19,4635,4514,121,2.6
51051,12/1/19,4799,4540,259,5.4
51053,12/1/19,13876,13497,379,2.7
51057,12/1/19,5513,5334,179,3.2
51059,12/1/19,644145,632136,12009,1.9
51061,12/1/19,37909,37179,730,1.9
51063,12/1/19,8455,8216,239,2.8
51065,12/1/19,14053,13794,259,1.8
51067,12/1/19,26551,25827,724,2.7
51069,12/1/19,48791,47825,966,2
51071,12/1/19,8153,7807,346,4.2
51073,12/1/19,19721,19287,434,2.2
51075,12/1/19,11382,11131,251,2.2
51077,12/1/19,8068,7821,247,3.1
51079,12/1/19,10629,10421,208,2
51081,12/1/19,4299,4171,128,3
51083,12/1/19,15494,14934,560,3.6
51085,12/1/19,60102,58892,1210,2
51087,12/1/19,184449,180049,4400,2.4
51089,12/1/19,23667,22942,725,3.1
51091,12/1/19,1264,1223,41,3.2
51093,12/1/19,19617,19117,500,2.5
51095,12/1/19,36763,35957,806,2.2
51097,12/1/19,3923,3829,94,2.4
51099,12/1/19,13579,13267,312,2.3
51101,12/1/19,9311,9091,220,2.4
51103,12/1/19,5503,5298,205,3.7
51105,12/1/19,8303,7970,333,4
51107,12/1/19,225748,221462,4286,1.9
51109,12/1/19,20087,19619,468,2.3
51111,12/1/19,5330,5182,148,2.8
51113,12/1/19,7596,7463,133,1.8
51115,12/1/19,4158,4064,94,2.3
51117,12/1/19,12439,11951,488,3.9
51119,12/1/19,5300,5179,121,2.3
51121,12/1/19,50945,49677,1268,2.5
51125,12/1/19,7567,7405,162,2.1
51127,12/1/19,12662,12415,247,2
51131,12/1/19,5525,5288,237,4.3
51133,12/1/19,5792,5584,208,3.6
51135,12/1/19,7360,7177,183,2.5
51137,12/1/19,17585,17150,435,2.5
51139,12/1/19,12043,11522,521,4.3
51141,12/1/19,7160,6952,208,2.9
51143,12/1/19,30315,29429,886,2.9
51145,12/1/19,14366,14043,323,2.2
51147,12/1/19,10245,9895,350,3.4
51149,12/1/19,15289,14845,444,2.9
51153,12/1/19,248978,243685,5293,2.1
51155,12/1/19,16803,15832,971,5.8
51157,12/1/19,3772,3700,72,1.9
51159,12/1/19,4130,4024,106,2.6
51161,12/1/19,49438,48306,1132,2.3
51163,12/1/19,10729,10483,246,2.3
51165,12/1/19,42928,42129,799,1.9
51167,12/1/19,11238,10789,449,4
51169,12/1/19,9159,8925,234,2.6
51171,12/1/19,22454,21986,468,2.1
51173,12/1/19,13846,13353,493,3.6
51175,12/1/19,9224,8992,232,2.5
51177,12/1/19,67981,66327,1654,2.4
51179,12/1/19,73004,71316,1688,2.3
51181,12/1/19,3666,3553,113,3.1
51183,12/1/19,3917,3757,160,4.1
51185,12/1/19,15644,14970,674,4.3
51187,12/1/19,20727,20247,480,2.3
51191,12/1/19,26848,26070,778,2.9
51193,12/1/19,9616,9288,328,3.4
51195,12/1/19,13409,12837,572,4.3
51197,12/1/19,14086,13379,707,5
51199,12/1/19,32891,32159,732,2.2
51510,12/1/19,102848,100983,1865,1.8
51520,12/1/19,7217,6978,239,3.3
51530,12/1/19,3506,3422,84,2.4
51540,12/1/19,26660,26170,490,1.8
51550,12/1/19,123210,120143,3067,2.5
51570,12/1/19,8921,8675,246,2.8
51580,12/1/19,2396,2288,108,4.5
51590,12/1/19,19368,18510,858,4.4
51595,12/1/19,2287,2191,96,4.2
51600,12/1/19,13641,13405,236,1.7
51610,12/1/19,8723,8576,147,1.7
51620,12/1/19,3599,3456,143,4
51630,12/1/19,14322,13916,406,2.8
51640,12/1/19,2907,2822,85,2.9
51650,12/1/19,64646,62436,2210,3.4
51660,12/1/19,25439,24804,635,2.5
51670,12/1/19,9838,9427,411,4.2
51678,12/1/19,2063,1981,82,4
51680,12/1/19,36265,35091,1174,3.2
51683,12/1/19,22339,21888,451,2
51685,12/1/19,9502,9316,186,2
51690,12/1/19,5487,5265,222,4
51700,12/1/19,89151,86393,2758,3.1
51710,12/1/19,111990,108587,3403,3
51720,12/1/19,1684,1628,56,3.3
51730,12/1/19,13190,12514,676,5.1
51735,12/1/19,6443,6306,137,2.1
51740,12/1/19,44488,42877,1611,3.6
51750,12/1/19,8784,8494,290,3.3
51760,12/1/19,119856,116483,3373,2.8
51770,12/1/19,49181,47848,1333,2.7
51775,12/1/19,12962,12655,307,2.4
51790,12/1/19,12361,12083,278,2.2
51800,12/1/19,44826,43636,1190,2.7
51810,12/1/19,234164,228643,5521,2.4
51820,12/1/19,10793,10527,266,2.5
51830,12/1/19,6687,6484,203,3
51840,12/1/19,15023,14673,350,2.3
53001,12/1/19,8916,8238,678,7.6
53003,12/1/19,10718,10305,413,3.9
53005,12/1/19,104514,99030,5484,5.2
53007,12/1/19,43733,41462,2271,5.2
53009,12/1/19,29222,27467,1755,6
53011,12/1/19,248649,238263,10386,4.2
53013,12/1/19,1872,1769,103,5.5
53015,12/1/19,48780,46121,2659,5.5
53017,12/1/19,21388,20127,1261,5.9
53019,12/1/19,2415,2143,272,11.3
53021,12/1/19,42375,39338,3037,7.2
53023,12/1/19,906,854,52,5.7
53025,12/1/19,44287,40334,3953,8.9
53027,12/1/19,29407,27344,2063,7
53029,12/1/19,37517,35849,1668,4.4
53031,12/1/19,13335,12673,662,5
53033,12/1/19,1287339,1255653,31686,2.5
53035,12/1/19,133330,128105,5225,3.9
53037,12/1/19,23687,22459,1228,5.2
53039,12/1/19,9826,9253,573,5.8
53041,12/1/19,35394,33329,2065,5.8
53043,12/1/19,5003,4755,248,5
53045,12/1/19,26437,24974,1463,5.5
53047,12/1/19,19101,17564,1537,8
53049,12/1/19,8596,8008,588,6.8
53051,12/1/19,5262,4824,438,8.3
53053,12/1/19,454337,433261,21076,4.6
53055,12/1/19,8396,8096,300,3.6
53057,12/1/19,64046,60677,3369,5.3
53059,12/1/19,5684,5404,280,4.9
53061,12/1/19,438317,426131,12186,2.8
53063,12/1/19,262855,250149,12706,4.8
53065,12/1/19,19605,18238,1367,7
53067,12/1/19,146960,140647,6313,4.3
53069,12/1/19,1387,1296,91,6.6
53071,12/1/19,30288,28840,1448,4.8
53073,12/1/19,117044,111560,5484,4.7
53075,12/1/19,24593,23662,931,3.8
53077,12/1/19,128962,118684,10278,8
54001,12/1/19,7374,6914,460,6.2
54003,12/1/19,59885,58109,1776,3
54005,12/1/19,7421,6989,432,5.8
54007,12/1/19,5262,4780,482,9.2
54009,12/1/19,9986,9453,533,5.3
54011,12/1/19,41681,40109,1572,3.8
54013,12/1/19,2660,2198,462,17.4
54015,12/1/19,3175,2848,327,10.3
54017,12/1/19,4012,3812,200,5
54019,12/1/19,16246,15228,1018,6.3
54021,12/1/19,2458,2259,199,8.1
54023,12/1/19,5835,5509,326,5.6
54025,12/1/19,15702,14968,734,4.7
54027,12/1/19,10736,10345,391,3.6
54029,12/1/19,13091,12403,688,5.3
54031,12/1/19,5757,5452,305,5.3
54033,12/1/19,34841,33243,1598,4.6
54035,12/1/19,13288,12576,712,5.4
54037,12/1/19,30087,29259,828,2.8
54039,12/1/19,81728,78124,3604,4.4
54041,12/1/19,6648,6138,510,7.7
54043,12/1/19,7265,6796,469,6.5
54045,12/1/19,11234,10517,717,6.4
54047,12/1/19,4461,4048,413,9.3
54049,12/1/19,25632,24357,1275,5
54051,12/1/19,14369,13388,981,6.8
54053,12/1/19,10183,9589,594,5.8
54055,12/1/19,21118,19963,1155,5.5
54057,12/1/19,12625,11878,747,5.9
54059,12/1/19,6919,6388,531,7.7
54061,12/1/19,55312,53466,1846,3.3
54063,12/1/19,5978,5673,305,5.1
54065,12/1/19,8105,7829,276,3.4
54067,12/1/19,9608,8854,754,7.8
54069,12/1/19,21417,20447,970,4.5
54071,12/1/19,3664,3506,158,4.3
54073,12/1/19,2974,2741,233,7.8
54075,12/1/19,4053,3844,209,5.2
54077,12/1/19,15687,14967,720,4.6
54079,12/1/19,26846,25759,1087,4
54081,12/1/19,30292,28870,1422,4.7
54083,12/1/19,12313,11506,807,6.6
54085,12/1/19,4406,4118,288,6.5
54087,12/1/19,5203,4654,549,10.6
54089,12/1/19,4281,4032,249,5.8
54091,12/1/19,7938,7556,382,4.8
54093,12/1/19,3354,3146,208,6.2
54095,12/1/19,3122,2868,254,8.1
54097,12/1/19,9454,8835,619,6.5
54099,12/1/19,15931,15071,860,5.4
54101,12/1/19,3351,3059,292,8.7
54103,12/1/19,6732,6195,537,8
54105,12/1/19,2332,2121,211,9
54107,12/1/19,37041,35194,1847,5
54109,12/1/19,6654,6206,448,6.7
55001,12/1/19,8056,7590,466,5.8
55003,12/1/19,7794,7427,367,4.7
55005,12/1/19,24352,23227,1125,4.6
55007,12/1/19,7615,7101,514,6.7
55009,12/1/19,141028,136950,4078,2.9
55011,12/1/19,6527,6203,324,5
55013,12/1/19,7048,6639,409,5.8
55015,12/1/19,27410,26694,716,2.6
55017,12/1/19,33535,32023,1512,4.5
55019,12/1/19,17952,17341,611,3.4
55021,12/1/19,31850,30902,948,3
55023,12/1/19,7716,7342,374,4.8
55025,12/1/19,323111,316196,6915,2.1
55027,12/1/19,47286,45843,1443,3.1
55029,12/1/19,14243,13601,642,4.5
55031,12/1/19,22800,21776,1024,4.5
55033,12/1/19,24581,23707,874,3.6
55035,12/1/19,58787,57080,1707,2.9
55037,12/1/19,2211,2096,115,5.2
55039,12/1/19,56847,55325,1522,2.7
55041,12/1/19,4020,3795,225,5.6
55043,12/1/19,28579,27670,909,3.2
55045,12/1/19,21282,20713,569,2.7
55047,12/1/19,9209,8821,388,4.2
55049,12/1/19,13949,13559,390,2.8
55051,12/1/19,2551,2390,161,6.3
55053,12/1/19,10159,9691,468,4.6
55055,12/1/19,45666,44340,1326,2.9
55057,12/1/19,13367,12880,487,3.6
55059,12/1/19,87938,84718,3220,3.7
55061,12/1/19,11093,10751,342,3.1
55063,12/1/19,66275,64492,1783,2.7
55065,12/1/19,10269,10005,264,2.6
55067,12/1/19,9299,8859,440,4.7
55069,12/1/19,15014,14442,572,3.8
55071,12/1/19,40589,39099,1490,3.7
55073,12/1/19,73837,71815,2022,2.7
55075,12/1/19,19429,18392,1037,5.3
55077,12/1/19,7766,7420,346,4.5
55078,12/1/19,1602,1497,105,6.6
55079,12/1/19,462660,445927,16733,3.6
55081,12/1/19,23224,22515,709,3.1
55083,12/1/19,20673,19874,799,3.9
55085,12/1/19,17381,16484,897,5.2
55087,12/1/19,102182,99313,2869,2.8
55089,12/1/19,48770,47560,1210,2.5
55091,12/1/19,4088,3925,163,4
55093,12/1/19,25345,24422,923,3.6
55095,12/1/19,24608,23422,1186,4.8
55097,12/1/19,38944,37680,1264,3.2
55099,12/1/19,6522,6217,305,4.7
55101,12/1/19,97092,93408,3684,3.8
55103,12/1/19,9223,8952,271,2.9
55105,12/1/19,84511,81527,2984,3.5
55107,12/1/19,6734,6401,333,4.9
55109,12/1/19,50308,48493,1815,3.6
55111,12/1/19,35126,34052,1074,3.1
55113,12/1/19,7785,7353,432,5.5
55115,12/1/19,21071,20394,677,3.2
55117,12/1/19,60696,59078,1618,2.7
55119,12/1/19,11041,10561,480,4.3
55121,12/1/19,15977,15353,624,3.9
55123,12/1/19,15365,14821,544,3.5
55125,12/1/19,9822,9273,549,5.6
55127,12/1/19,57596,55872,1724,3
55129,12/1/19,7757,7426,331,4.3
55131,12/1/19,76628,74666,1962,2.6
55133,12/1/19,223011,217182,5829,2.6
55135,12/1/19,25627,24778,849,3.3
55137,12/1/19,11422,10952,470,4.1
55139,12/1/19,91003,88444,2559,2.8
55141,12/1/19,35122,33812,1310,3.7
56001,12/1/19,20632,20072,560,2.7
56003,12/1/19,5262,5066,196,3.7
56005,12/1/19,23483,22744,739,3.1
56007,12/1/19,7891,7605,286,3.6
56009,12/1/19,8928,8662,266,3
56011,12/1/19,3660,3551,109,3
56013,12/1/19,18735,17841,894,4.8
56015,12/1/19,6680,6453,227,3.4
56017,12/1/19,2137,2051,86,4
56019,12/1/19,4073,3921,152,3.7
56021,12/1/19,48232,46586,1646,3.4
56023,12/1/19,8707,8400,307,3.5
56025,12/1/19,39229,37593,1636,4.2
56027,12/1/19,1217,1176,41,3.4
56029,12/1/19,14721,14074,647,4.4
56031,12/1/19,4486,4303,183,4.1
56033,12/1/19,15540,15011,529,3.4
56035,12/1/19,4098,3892,206,5
56037,12/1/19,21232,20272,960,4.5
56039,12/1/19,14971,14530,441,2.9
56041,12/1/19,8880,8528,352,4
56043,12/1/19,3953,3811,142,3.6
56045,12/1/19,3793,3696,97,2.6
72001,12/1/19,4154,3399,755,18.2
72003,12/1/19,11355,10086,1269,11.2
72005,12/1/19,13870,12317,1553,11.2
72007,12/1/19,6261,5647,614,9.8
72009,12/1/19,6238,5542,696,11.2
72011,12/1/19,8405,7607,798,9.5
72013,12/1/19,23317,20754,2563,11
72015,12/1/19,4503,3791,712,15.8
72017,12/1/19,5696,5002,694,12.2
72019,12/1/19,7136,6454,682,9.6
72021,12/1/19,62242,57905,4337,7
72023,12/1/19,13057,11842,1215,9.3
72025,12/1/19,45476,42158,3318,7.3
72027,12/1/19,9212,8323,889,9.7
72029,12/1/19,15289,14190,1099,7.2
72031,12/1/19,58554,54744,3810,6.5
72033,12/1/19,7469,6873,596,8
72035,12/1/19,15386,14181,1205,7.8
72037,12/1/19,3503,3157,346,9.9
72039,12/1/19,3597,3151,446,12.4
72041,12/1/19,14728,13684,1044,7.1
72043,12/1/19,9759,8435,1324,13.6
72045,12/1/19,4720,4247,473,10
72047,12/1/19,8577,7749,828,9.7
72049,12/1/19,878,844,34,3.9
72051,12/1/19,12591,11777,814,6.5
72053,12/1/19,10413,9289,1124,10.8
72054,12/1/19,3169,2812,357,11.3
72055,12/1/19,4011,3361,650,16.2
72057,12/1/19,10533,9155,1378,13.1
72059,12/1/19,4782,4045,737,15.4
72061,12/1/19,35754,34085,1669,4.7
72063,12/1/19,17146,16125,1021,6
72065,12/1/19,13585,11463,2122,15.6
72067,12/1/19,5139,4648,491,9.6
72069,12/1/19,16402,14671,1731,10.6
72071,12/1/19,11947,10769,1178,9.9
72073,12/1/19,4117,3492,625,15.2
72075,12/1/19,14465,12941,1524,10.5
72077,12/1/19,11752,10669,1083,9.2
72079,12/1/19,5051,4394,657,13
72081,12/1/19,7021,5845,1176,16.7
72083,12/1/19,2531,2206,325,12.8
72085,12/1/19,10807,9752,1055,9.8
72087,12/1/19,8116,7368,748,9.2
72089,12/1/19,5920,5310,610,10.3
72091,12/1/19,11122,10149,973,8.7
72093,12/1/19,1872,1592,280,15
72095,12/1/19,2830,2375,455,16.1
72097,12/1/19,20723,18467,2256,10.9
72099,12/1/19,10007,8858,1149,11.5
72101,12/1/19,7634,6881,753,9.9
72103,12/1/19,7798,7052,746,9.6
72105,12/1/19,6791,6138,653,9.6
72107,12/1/19,4791,4236,555,11.6
72109,12/1/19,4176,3437,739,17.7
72111,12/1/19,5723,4847,876,15.3
72113,12/1/19,43811,39310,4501,10.3
72115,12/1/19,5876,5130,746,12.7
72117,12/1/19,4700,3858,842,17.9
72119,12/1/19,16134,14867,1267,7.9
72121,12/1/19,5897,5124,773,13.1
72123,12/1/19,6892,5782,1110,16.1
72125,12/1/19,9305,8231,1074,11.5
72127,12/1/19,127695,119714,7981,6.3
72129,12/1/19,11193,10124,1069,9.6
72131,12/1/19,10166,8599,1567,15.4
72133,12/1/19,8670,7519,1151,13.3
72135,12/1/19,25770,24182,1588,6.2
72137,12/1/19,27811,26032,1779,6.4
72139,12/1/19,25706,24353,1353,5.3
72141,12/1/19,6447,5605,842,13.1
72143,12/1/19,9356,8462,894,9.6
72145,12/1/19,12680,11363,1317,10.4
72147,12/1/19,2494,2321,173,6.9
72149,12/1/19,7372,6048,1324,18
72151,12/1/19,8539,7284,1255,14.7
72153,12/1/19,9719,8152,1567,16.1
1001,1/1/20,25912,25125,787,3
1003,1/1/20,95316,92389,2927,3.1
1005,1/1/20,8509,8186,323,3.8
1007,1/1/20,8629,8342,287,3.3
1009,1/1/20,25098,24352,746,3
1011,1/1/20,4674,4480,194,4.2
1013,1/1/20,9155,8772,383,4.2
1015,1/1/20,46059,44315,1744,3.8
1017,1/1/20,15698,15187,511,3.3
1019,1/1/20,11373,10991,382,3.4
1021,1/1/20,19591,19032,559,2.9
1023,1/1/20,4511,4269,242,5.4
1025,1/1/20,7406,6947,459,6.2
1027,1/1/20,6065,5867,198,3.3
1029,1/1/20,5682,5490,192,3.4
1031,1/1/20,21004,20349,655,3.1
1033,1/1/20,23275,22298,977,4.2
1035,1/1/20,4440,4248,192,4.3
1037,1/1/20,4452,4297,155,3.5
1039,1/1/20,15313,14758,555,3.6
1041,1/1/20,6257,6040,217,3.5
1043,1/1/20,38433,37341,1092,2.8
1045,1/1/20,20496,19837,659,3.2
1047,1/1/20,14490,13687,803,5.5
1049,1/1/20,30600,29625,975,3.2
1051,1/1/20,37258,36157,1101,3
1053,1/1/20,14629,14071,558,3.8
1055,1/1/20,42809,41025,1784,4.2
1057,1/1/20,6517,6290,227,3.5
1059,1/1/20,14531,14077,454,3.1
1061,1/1/20,10869,10522,347,3.2
1063,1/1/20,2848,2681,167,5.9
1065,1/1/20,6055,5792,263,4.3
1067,1/1/20,6878,6619,259,3.8
1069,1/1/20,46058,44592,1466,3.2
1071,1/1/20,23006,22148,858,3.7
1073,1/1/20,317192,307572,9620,3
1075,1/1/20,5796,5603,193,3.3
1077,1/1/20,41767,40315,1452,3.5
1079,1/1/20,14238,13762,476,3.3
1081,1/1/20,76569,74372,2197,2.9
1083,1/1/20,43891,42673,1218,2.8
1085,1/1/20,3523,3325,198,5.6
1087,1/1/20,7761,7427,334,4.3
1089,1/1/20,185774,180806,4968,2.7
1091,1/1/20,7580,7278,302,4
1093,1/1/20,12661,12163,498,3.9
1095,1/1/20,43607,42436,1171,2.7
1097,1/1/20,188015,180522,7493,4
1099,1/1/20,7392,6993,399,5.4
1101,1/1/20,104878,101390,3488,3.3
1103,1/1/20,58214,56599,1615,2.8
1105,1/1/20,3329,3155,174,5.2
1107,1/1/20,7902,7616,286,3.6
1109,1/1/20,15361,14824,537,3.5
1111,1/1/20,9530,9216,314,3.3
1113,1/1/20,23690,22940,750,3.2
1115,1/1/20,40279,39119,1160,2.9
1117,1/1/20,115350,112620,2730,2.4
1119,1/1/20,4709,4504,205,4.4
1121,1/1/20,35396,34082,1314,3.7
1123,1/1/20,18248,17625,623,3.4
1125,1/1/20,105582,102633,2949,2.8
1127,1/1/20,25271,24297,974,3.9
1129,1/1/20,6737,6402,335,5
1131,1/1/20,2758,2512,246,8.9
1133,1/1/20,10008,9631,377,3.8
2013,1/1/20,1810,1734,76,4.2
2016,1/1/20,3963,3830,133,3.4
2020,1/1/20,144538,137112,7426,5.1
2050,1/1/20,6866,5990,876,12.8
2060,1/1/20,243,209,34,14
2068,1/1/20,547,439,108,19.7
2070,1/1/20,1765,1611,154,8.7
2090,1/1/20,43217,40674,2543,5.9
2100,1/1/20,889,747,142,16
2105,1/1/20,1046,878,168,16.1
2110,1/1/20,16310,15541,769,4.7
2122,1/1/20,25758,23758,2000,7.8
2130,1/1/20,6322,5826,496,7.8
2150,1/1/20,5744,5306,438,7.6
2158,1/1/20,2642,2156,486,18.4
2164,1/1/20,606,539,67,11.1
2170,1/1/20,46577,43126,3451,7.4
2180,1/1/20,4137,3717,420,10.2
2185,1/1/20,3592,3380,212,5.9
2188,1/1/20,2828,2447,381,13.5
2195,1/1/20,1615,1466,149,9.2
2198,1/1/20,3004,2722,282,9.4
2220,1/1/20,4111,3910,201,4.9
2230,1/1/20,597,477,120,20.1
2240,1/1/20,2814,2537,277,9.8
2261,1/1/20,4242,3787,455,10.7
2275,1/1/20,1036,953,83,8
2282,1/1/20,261,230,31,11.9
2290,1/1/20,2362,2037,325,13.8
4001,1/1/20,20785,18490,2295,11
4003,1/1/20,51901,48897,3004,5.8
4005,1/1/20,77687,72788,4899,6.3
4007,1/1/20,21565,20325,1240,5.8
4009,1/1/20,15417,14640,777,5
4011,1/1/20,4585,4413,172,3.8
4012,1/1/20,9751,9168,583,6
4013,1/1/20,2360096,2266177,93919,4
4015,1/1/20,89027,83775,5252,5.9
4017,1/1/20,40989,37667,3322,8.1
4019,1/1/20,504206,481622,22584,4.5
4021,1/1/20,192010,182584,9426,4.9
4023,1/1/20,20067,18466,1601,8
4025,1/1/20,107379,102552,4827,4.5
4027,1/1/20,100806,87020,13786,13.7
5001,1/1/20,9260,8924,336,3.6
5003,1/1/20,7675,7131,544,7.1
5005,1/1/20,16005,15255,750,4.7
5007,1/1/20,137257,133215,4042,2.9
5009,1/1/20,15882,15266,616,3.9
5011,1/1/20,4491,4284,207,4.6
5013,1/1/20,2436,2312,124,5.1
5015,1/1/20,12291,11744,547,4.5
5017,1/1/20,3244,2959,285,8.8
5019,1/1/20,9520,9124,396,4.2
5021,1/1/20,5581,5247,334,6
5023,1/1/20,8993,8478,515,5.7
5025,1/1/20,3179,3015,164,5.2
5027,1/1/20,9109,8658,451,5
5029,1/1/20,8256,7846,410,5
5031,1/1/20,55856,54045,1811,3.2
5033,1/1/20,26619,25597,1022,3.8
5035,1/1/20,21248,20242,1006,4.7
5037,1/1/20,7326,6968,358,4.9
5039,1/1/20,2815,2675,140,5
5041,1/1/20,5309,5028,281,5.3
5043,1/1/20,7883,7402,481,6.1
5045,1/1/20,61559,59407,2152,3.5
5047,1/1/20,7394,7108,286,3.9
5049,1/1/20,4918,4697,221,4.5
5051,1/1/20,40802,39115,1687,4.1
5053,1/1/20,8319,7996,323,3.9
5055,1/1/20,20018,19194,824,4.1
5057,1/1/20,9816,9376,440,4.5
5059,1/1/20,13840,13294,546,3.9
5061,1/1/20,5726,5493,233,4.1
5063,1/1/20,16491,15736,755,4.6
5065,1/1/20,4787,4474,313,6.5
5067,1/1/20,5813,5380,433,7.4
5069,1/1/20,27208,25509,1699,6.2
5071,1/1/20,10172,9681,491,4.8
5073,1/1/20,2452,2318,134,5.5
5075,1/1/20,6834,6510,324,4.7
5077,1/1/20,2845,2664,181,6.4
5079,1/1/20,3897,3683,214,5.5
5081,1/1/20,5528,5254,274,5
5083,1/1/20,8487,8034,453,5.3
5085,1/1/20,33986,32760,1226,3.6
5087,1/1/20,7432,7223,209,2.8
5089,1/1/20,6596,6274,322,4.9
5091,1/1/20,19707,18830,877,4.5
5093,1/1/20,17055,16062,993,5.8
5095,1/1/20,2768,2630,138,5
5097,1/1/20,2877,2701,176,6.1
5099,1/1/20,3588,3440,148,4.1
5101,1/1/20,3326,3165,161,4.8
5103,1/1/20,9739,9181,558,5.7
5105,1/1/20,4227,4024,203,4.8
5107,1/1/20,6335,5868,467,7.4
5109,1/1/20,4209,4010,199,4.7
5111,1/1/20,10379,9929,450,4.3
5113,1/1/20,8152,7667,485,5.9
5115,1/1/20,28533,27127,1406,4.9
5117,1/1/20,3537,3383,154,4.4
5119,1/1/20,187545,180280,7265,3.9
5121,1/1/20,7356,7006,350,4.8
5123,1/1/20,8076,7611,465,5.8
5125,1/1/20,58243,56352,1891,3.2
5127,1/1/20,4301,4129,172,4
5129,1/1/20,2794,2618,176,6.3
5131,1/1/20,56107,53894,2213,3.9
5133,1/1/20,5479,5174,305,5.6
5135,1/1/20,5666,5325,341,6
5137,1/1/20,4556,4284,272,6
5139,1/1/20,15801,14781,1020,6.5
5141,1/1/20,5652,5311,341,6
5143,1/1/20,124899,121521,3378,2.7
5145,1/1/20,33578,31757,1821,5.4
5147,1/1/20,2749,2584,165,6
5149,1/1/20,8320,7956,364,4.4
6001,1/1/20,841256,815549,25707,3.1
6003,1/1/20,652,622,30,4.6
6005,1/1/20,14858,14158,700,4.7
6007,1/1/20,97828,92380,5448,5.6
6009,1/1/20,21564,20634,930,4.3
6011,1/1/20,10872,8786,2086,19.2
6013,1/1/20,559573,541551,18022,3.2
6015,1/1/20,9637,9007,630,6.5
6017,1/1/20,92211,88755,3456,3.7
6019,1/1/20,452463,415814,36649,8.1
6021,1/1/20,13224,12256,968,7.3
6023,1/1/20,61835,59314,2521,4.1
6025,1/1/20,72432,59415,13017,18
6027,1/1/20,8703,8364,339,3.9
6029,1/1/20,396113,362164,33949,8.6
6031,1/1/20,58130,52666,5464,9.4
6033,1/1/20,29119,27369,1750,6
6035,1/1/20,9890,9333,557,5.6
6037,1/1/20,5189152,4956929,232223,4.5
6039,1/1/20,63353,58229,5124,8.1
6041,1/1/20,139813,136458,3355,2.4
6043,1/1/20,7037,6595,442,6.3
6045,1/1/20,38310,36465,1845,4.8
6047,1/1/20,115164,103893,11271,9.8
6049,1/1/20,3086,2786,300,9.7
6051,1/1/20,9120,8798,322,3.5
6053,1/1/20,214066,193310,20756,9.7
6055,1/1/20,72496,69957,2539,3.5
6057,1/1/20,49120,47324,1796,3.7
6059,1/1/20,1622060,1575486,46574,2.9
6061,1/1/20,188371,182162,6209,3.3
6063,1/1/20,7494,6705,789,10.5
6065,1/1/20,1106119,1059280,46839,4.2
6067,1/1/20,714155,686476,27679,3.9
6069,1/1/20,31509,29552,1957,6.2
6071,1/1/20,969995,932074,37921,3.9
6073,1/1/20,1592880,1540005,52875,3.3
6075,1/1/20,586524,573037,13487,2.3
6077,1/1/20,325129,303299,21830,6.7
6079,1/1/20,141151,136743,4408,3.1
6081,1/1/20,462412,452570,9842,2.1
6083,1/1/20,214297,204278,10019,4.7
6085,1/1/20,1055619,1027950,27669,2.6
6087,1/1/20,139625,131047,8578,6.1
6089,1/1/20,74561,70562,3999,5.4
6091,1/1/20,1316,1234,82,6.2
6093,1/1/20,17063,15645,1418,8.3
6095,1/1/20,208963,200517,8446,4
6097,1/1/20,258202,250592,7610,2.9
6099,1/1/20,243344,227272,16072,6.6
6101,1/1/20,46474,42413,4061,8.7
6103,1/1/20,25712,24083,1629,6.3
6105,1/1/20,4434,4128,306,6.9
6107,1/1/20,204455,182017,22438,11
6109,1/1/20,21457,20405,1052,4.9
6111,1/1/20,423012,406575,16437,3.9
6113,1/1/20,108995,103603,5392,4.9
6115,1/1/20,30949,28776,2173,7
8001,1/1/20,278584,270063,8521,3.1
8003,1/1/20,8428,8097,331,3.9
8005,1/1/20,372450,362251,10199,2.7
8007,1/1/20,6673,6435,238,3.6
8009,1/1/20,2086,2044,42,2
8011,1/1/20,1839,1785,54,2.9
8013,1/1/20,196326,191678,4648,2.4
8014,1/1/20,40970,39968,1002,2.4
8015,1/1/20,9533,9270,263,2.8
8017,1/1/20,1178,1159,19,1.6
8019,1/1/20,6155,6015,140,2.3
8021,1/1/20,4010,3847,163,4.1
8023,1/1/20,1846,1770,76,4.1
8025,1/1/20,1514,1442,72,4.8
8027,1/1/20,1988,1924,64,3.2
8029,1/1/20,14247,13662,585,4.1
8031,1/1/20,426054,414195,11859,2.8
8033,1/1/20,1119,1075,44,3.9
8035,1/1/20,198184,193584,4600,2.3
8037,1/1/20,39414,38614,800,2
8039,1/1/20,15418,15060,358,2.3
8041,1/1/20,343516,332208,11308,3.3
8043,1/1/20,14862,14131,731,4.9
8045,1/1/20,33557,32496,1061,3.2
8047,1/1/20,3854,3764,90,2.3
8049,1/1/20,10470,10234,236,2.3
8051,1/1/20,11766,11514,252,2.1
8053,1/1/20,352,338,14,4
8055,1/1/20,2414,2235,179,7.4
8057,1/1/20,918,894,24,2.6
8059,1/1/20,342203,333361,8842,2.6
8061,1/1/20,936,923,13,1.4
8063,1/1/20,4277,4197,80,1.9
8065,1/1/20,5363,5257,106,2
8067,1/1/20,31340,30448,892,2.8
8069,1/1/20,207424,202150,5274,2.5
8071,1/1/20,6434,6189,245,3.8
8073,1/1/20,2317,2248,69,3
8075,1/1/20,10851,10565,286,2.6
8077,1/1/20,75380,72294,3086,4.1
8079,1/1/20,566,553,13,2.3
8081,1/1/20,7401,7105,296,4
8083,1/1/20,12512,11834,678,5.4
8085,1/1/20,21684,20951,733,3.4
8087,1/1/20,16310,15879,431,2.6
8089,1/1/20,8356,8010,346,4.1
8091,1/1/20,2334,2258,76,3.3
8093,1/1/20,11350,11065,285,2.5
8095,1/1/20,2505,2462,43,1.7
8097,1/1/20,11476,11198,278,2.4
8099,1/1/20,6237,6074,163,2.6
8101,1/1/20,76303,73071,3232,4.2
8103,1/1/20,2940,2830,110,3.7
8105,1/1/20,5330,5055,275,5.2
8107,1/1/20,17397,17036,361,2.1
8109,1/1/20,3539,3374,165,4.7
8111,1/1/20,525,508,17,3.2
8113,1/1/20,6613,6497,116,1.8
8115,1/1/20,1240,1211,29,2.3
8117,1/1/20,26192,25777,415,1.6
8119,1/1/20,12831,12433,398,3.1
8121,1/1/20,2814,2752,62,2.2
8123,1/1/20,171078,166391,4687,2.7
8125,1/1/20,5700,5593,107,1.9
9001,1/1/20,482608,461524,21084,4.4
9003,1/1/20,485367,463800,21567,4.4
9005,1/1/20,105903,101206,4697,4.4
9007,1/1/20,94519,90691,3828,4
9009,1/1/20,463126,441901,21225,4.6
9011,1/1/20,137222,131116,6106,4.4
9013,1/1/20,87656,84116,3540,4
9015,1/1/20,64413,61304,3109,4.8
10001,1/1/20,80865,77207,3658,4.5
10003,1/1/20,299783,287848,11935,4
10005,1/1/20,105892,100843,5049,4.8
11001,1/1/20,414238,393157,21081,5.1
12001,1/1/20,141104,136947,4157,2.9
12003,1/1/20,11981,11597,384,3.2
12005,1/1/20,81787,78840,2947,3.6
12007,1/1/20,11232,10870,362,3.2
12009,1/1/20,286381,277148,9233,3.2
12011,1/1/20,1044194,1012687,31507,3
12013,1/1/20,4792,4607,185,3.9
12015,1/1/20,73176,70541,2635,3.6
12017,1/1/20,47294,44963,2331,4.9
12019,1/1/20,108777,105444,3333,3.1
12021,1/1/20,184804,179273,5531,3
12023,1/1/20,30163,29202,961,3.2
12027,1/1/20,15023,14503,520,3.5
12029,1/1/20,5885,5653,232,3.9
12031,1/1/20,496515,480562,15953,3.2
12033,1/1/20,146089,141184,4905,3.4
12035,1/1/20,47182,45380,1802,3.8
12037,1/1/20,4479,4341,138,3.1
12039,1/1/20,18874,18112,762,4
12041,1/1/20,7232,6983,249,3.4
12043,1/1/20,5569,5361,208,3.7
12045,1/1/20,5587,5356,231,4.1
12047,1/1/20,4208,4011,197,4.7
12049,1/1/20,8992,8596,396,4.4
12051,1/1/20,16087,15264,823,5.1
12053,1/1/20,72560,69515,3045,4.2
12055,1/1/20,36540,34884,1656,4.5
12057,1/1/20,757966,734996,22970,3
12059,1/1/20,6998,6733,265,3.8
12061,1/1/20,66238,63779,2459,3.7
12063,1/1/20,17117,16498,619,3.6
12065,1/1/20,5643,5458,185,3.3
12067,1/1/20,2885,2798,87,3
12069,1/1/20,160209,154961,5248,3.3
12071,1/1/20,354113,343111,11002,3.1
12073,1/1/20,156161,151293,4868,3.1
12075,1/1/20,16808,16192,616,3.7
12077,1/1/20,2651,2561,90,3.4
12079,1/1/20,7494,7225,269,3.6
12081,1/1/20,182288,176612,5676,3.1
12083,1/1/20,138389,133040,5349,3.9
12085,1/1/20,74972,72636,2336,3.1
12086,1/1/20,1402897,1381396,21501,1.5
12087,1/1/20,47890,46897,993,2.1
12089,1/1/20,41645,40389,1256,3
12091,1/1/20,95461,92745,2716,2.8
12093,1/1/20,18158,17592,566,3.1
12095,1/1/20,767583,745197,22386,2.9
12097,1/1/20,185467,179322,6145,3.3
12099,1/1/20,737808,714271,23537,3.2
12101,1/1/20,240208,231759,8449,3.5
12103,1/1/20,498586,483666,14920,3
12105,1/1/20,308117,296848,11269,3.7
12107,1/1/20,26578,25368,1210,4.6
12109,1/1/20,133919,130325,3594,2.7
12111,1/1/20,146507,140839,5668,3.9
12113,1/1/20,82993,80463,2530,3
12115,1/1/20,191451,185521,5930,3.1
12117,1/1/20,257223,249675,7548,2.9
12119,1/1/20,33067,31530,1537,4.6
12121,1/1/20,17961,17326,635,3.5
12123,1/1/20,8125,7839,286,3.5
12125,1/1/20,4680,4538,142,3
12127,1/1/20,255325,246362,8963,3.5
12129,1/1/20,14992,14552,440,2.9
12131,1/1/20,31164,30229,935,3
12133,1/1/20,9573,9226,347,3.6
13001,1/1/20,9933,9556,377,3.8
13003,1/1/20,5093,4954,139,2.7
13005,1/1/20,5069,4880,189,3.7
13007,1/1/20,1240,1188,52,4.2
13009,1/1/20,17600,16795,805,4.6
13011,1/1/20,9862,9577,285,2.9
13013,1/1/20,40897,39719,1178,2.9
13015,1/1/20,51285,49518,1767,3.4
13017,1/1/20,5328,5021,307,5.8
13019,1/1/20,7707,7354,353,4.6
13021,1/1/20,68066,65486,2580,3.8
13023,1/1/20,4514,4292,222,4.9
13025,1/1/20,7230,6937,293,4.1
13027,1/1/20,7163,6903,260,3.6
13029,1/1/20,18213,17646,567,3.1
13031,1/1/20,36430,35049,1381,3.8
13033,1/1/20,9315,8819,496,5.3
13035,1/1/20,10882,10518,364,3.3
13037,1/1/20,2425,2338,87,3.6
13039,1/1/20,20901,20132,769,3.7
13043,1/1/20,5713,5554,159,2.8
13045,1/1/20,55925,53953,1972,3.5
13047,1/1/20,33725,32707,1018,3
13049,1/1/20,4875,4689,186,3.8
13051,1/1/20,138885,134229,4656,3.4
13053,1/1/20,2009,1923,86,4.3
13055,1/1/20,10320,9822,498,4.8
13057,1/1/20,137076,133387,3689,2.7
13059,1/1/20,59317,57259,2058,3.5
13061,1/1/20,924,855,69,7.5
13063,1/1/20,139442,133537,5905,4.2
13065,1/1/20,2642,2536,106,4
13067,1/1/20,429391,416642,12749,3
13069,1/1/20,19155,18353,802,4.2
13071,1/1/20,22076,21410,666,3
13073,1/1/20,75359,73021,2338,3.1
13075,1/1/20,8182,7902,280,3.4
13077,1/1/20,75465,73252,2213,2.9
13079,1/1/20,5652,5471,181,3.2
13081,1/1/20,9632,9232,400,4.2
13083,1/1/20,8229,7954,275,3.3
13085,1/1/20,12452,12102,350,2.8
13087,1/1/20,11921,11468,453,3.8
13089,1/1/20,403372,389576,13796,3.4
13091,1/1/20,7043,6646,397,5.6
13093,1/1/20,5234,5035,199,3.8
13095,1/1/20,38804,36948,1856,4.8
13097,1/1/20,73950,71347,2603,3.5
13099,1/1/20,4537,4345,192,4.2
13101,1/1/20,2021,1962,59,2.9
13103,1/1/20,30772,29864,908,3
13105,1/1/20,7697,7367,330,4.3
13107,1/1/20,8484,8051,433,5.1
13109,1/1/20,4969,4797,172,3.5
13111,1/1/20,11402,11013,389,3.4
13113,1/1/20,58579,56872,1707,2.9
13115,1/1/20,44580,42857,1723,3.9
13117,1/1/20,123329,120053,3276,2.7
13119,1/1/20,10054,9675,379,3.8
13121,1/1/20,562727,543329,19398,3.4
13123,1/1/20,11802,11383,419,3.6
13125,1/1/20,1304,1252,52,4
13127,1/1/20,38821,37499,1322,3.4
13129,1/1/20,28449,27419,1030,3.6
13131,1/1/20,10594,10234,360,3.4
13133,1/1/20,6959,6684,275,4
13135,1/1/20,494212,479378,14834,3
13137,1/1/20,19171,18411,760,4
13139,1/1/20,103144,100274,2870,2.8
13141,1/1/20,2546,2398,148,5.8
13143,1/1/20,12681,12255,426,3.4
13145,1/1/20,16663,16147,516,3.1
13147,1/1/20,11149,10690,459,4.1
13149,1/1/20,5338,5146,192,3.6
13151,1/1/20,116829,112777,4052,3.5
13153,1/1/20,70799,68490,2309,3.3
13155,1/1/20,3451,3279,172,5
13157,1/1/20,36695,35700,995,2.7
13159,1/1/20,7050,6829,221,3.1
13161,1/1/20,6119,5831,288,4.7
13163,1/1/20,6774,6430,344,5.1
13165,1/1/20,3112,2967,145,4.7
13167,1/1/20,4042,3881,161,4
13169,1/1/20,13801,13362,439,3.2
13171,1/1/20,8316,7983,333,4
13173,1/1/20,3796,3641,155,4.1
13175,1/1/20,19031,18083,948,5
13177,1/1/20,14921,14449,472,3.2
13179,1/1/20,26403,25393,1010,3.8
13181,1/1/20,3649,3485,164,4.5
13183,1/1/20,8295,8004,291,3.5
13185,1/1/20,51677,49776,1901,3.7
13187,1/1/20,16713,16204,509,3
13189,1/1/20,8905,8442,463,5.2
13191,1/1/20,6169,5964,205,3.3
13193,1/1/20,4869,4650,219,4.5
13195,1/1/20,13351,12928,423,3.2
13197,1/1/20,3316,3171,145,4.4
13199,1/1/20,9009,8636,373,4.1
13201,1/1/20,2850,2752,98,3.4
13205,1/1/20,8851,8431,420,4.7
13207,1/1/20,13086,12659,427,3.3
13209,1/1/20,3838,3659,179,4.7
13211,1/1/20,9407,9116,291,3.1
13213,1/1/20,15559,14696,863,5.5
13215,1/1/20,77121,73701,3420,4.4
13217,1/1/20,52779,50804,1975,3.7
13219,1/1/20,19571,19088,483,2.5
13221,1/1/20,7038,6809,229,3.3
13223,1/1/20,87006,84398,2608,3
13225,1/1/20,11986,11520,466,3.9
13227,1/1/20,15440,14975,465,3
13229,1/1/20,8835,8541,294,3.3
13231,1/1/20,9024,8737,287,3.2
13233,1/1/20,18602,17895,707,3.8
13235,1/1/20,4120,3965,155,3.8
13237,1/1/20,8253,7896,357,4.3
13239,1/1/20,793,757,36,4.5
13241,1/1/20,6893,6641,252,3.7
13243,1/1/20,2612,2496,116,4.4
13245,1/1/20,85540,81508,4032,4.7
13247,1/1/20,45219,43508,1711,3.8
13249,1/1/20,2243,2161,82,3.7
13251,1/1/20,5090,4868,222,4.4
13253,1/1/20,3092,2960,132,4.3
13255,1/1/20,29018,27859,1159,4
13257,1/1/20,10622,10199,423,4
13259,1/1/20,2468,2369,99,4
13261,1/1/20,13068,12401,667,5.1
13263,1/1/20,2800,2691,109,3.9
13265,1/1/20,571,537,34,6
13267,1/1/20,9851,9461,390,4
13269,1/1/20,3209,3099,110,3.4
13271,1/1/20,4149,3746,403,9.7
13273,1/1/20,3555,3390,165,4.6
13275,1/1/20,16406,15748,658,4
13277,1/1/20,20236,19563,673,3.3
13279,1/1/20,11799,11215,584,4.9
13281,1/1/20,3801,3609,192,5.1
13283,1/1/20,2649,2501,148,5.6
13285,1/1/20,37502,36360,1142,3
13287,1/1/20,3242,3090,152,4.7
13289,1/1/20,2925,2749,176,6
13291,1/1/20,10360,10011,349,3.4
13293,1/1/20,11501,11071,430,3.7
13295,1/1/20,31544,30488,1056,3.3
13297,1/1/20,46568,45135,1433,3.1
13299,1/1/20,15816,15216,600,3.8
13301,1/1/20,2890,2768,122,4.2
13303,1/1/20,7052,6732,320,4.5
13305,1/1/20,11311,10848,463,4.1
13307,1/1/20,1047,998,49,4.7
13309,1/1/20,1666,1541,125,7.5
13311,1/1/20,16271,15842,429,2.6
13313,1/1/20,43889,41408,2481,5.7
13315,1/1/20,2782,2664,118,4.2
13317,1/1/20,3871,3673,198,5.1
13319,1/1/20,4022,3871,151,3.8
13321,1/1/20,9089,8753,336,3.7
15001,1/1/20,91811,88567,3244,3.5
15003,1/1/20,457022,444395,12627,2.8
15007,1/1/20,36927,35833,1094,3
15009,1/1/20,87694,85215,2479,2.8
16001,1/1/20,258097,250900,7197,2.8
16003,1/1/20,1667,1542,125,7.5
16005,1/1/20,42944,41477,1467,3.4
16007,1/1/20,2901,2780,121,4.2
16009,1/1/20,4132,3898,234,5.7
16011,1/1/20,23329,22536,793,3.4
16013,1/1/20,12656,12279,377,3
16015,1/1/20,3600,3414,186,5.2
16017,1/1/20,20433,19377,1056,5.2
16019,1/1/20,58116,56412,1704,2.9
16021,1/1/20,5245,4952,293,5.6
16023,1/1/20,1396,1345,51,3.7
16025,1/1/20,685,663,22,3.2
16027,1/1/20,105469,101366,4103,3.9
16029,1/1/20,4046,3897,149,3.7
16031,1/1/20,12051,11707,344,2.9
16033,1/1/20,357,338,19,5.3
16035,1/1/20,2804,2621,183,6.5
16037,1/1/20,1997,1884,113,5.7
16039,1/1/20,11431,10995,436,3.8
16041,1/1/20,6999,6815,184,2.6
16043,1/1/20,7742,7453,289,3.7
16045,1/1/20,8369,8033,336,4
16047,1/1/20,8118,7837,281,3.5
16049,1/1/20,6401,6046,355,5.5
16051,1/1/20,14101,13676,425,3
16053,1/1/20,12105,11708,397,3.3
16055,1/1/20,80656,76901,3755,4.7
16057,1/1/20,20908,20308,600,2.9
16059,1/1/20,3459,3233,226,6.5
16061,1/1/20,1570,1461,109,6.9
16063,1/1/20,2718,2591,127,4.7
16065,1/1/20,21741,21291,450,2.1
16067,1/1/20,11236,10874,362,3.2
16069,1/1/20,21446,20670,776,3.6
16071,1/1/20,2286,2219,67,2.9
16073,1/1/20,5196,4953,243,4.7
16075,1/1/20,11497,11016,481,4.2
16077,1/1/20,3802,3623,179,4.7
16079,1/1/20,5153,4787,366,7.1
16081,1/1/20,6318,6174,144,2.3
16083,1/1/20,41560,40090,1470,3.5
16085,1/1/20,5624,5371,253,4.5
16087,1/1/20,4578,4368,210,4.6
17001,1/1/20,31648,30590,1058,3.3
17003,1/1/20,2036,1922,114,5.6
17005,1/1/20,7666,7378,288,3.8
17007,1/1/20,26142,23607,2535,9.7
17009,1/1/20,2944,2878,66,2.2
17011,1/1/20,16793,15862,931,5.5
17013,1/1/20,2289,2182,107,4.7
17015,1/1/20,7125,6788,337,4.7
17017,1/1/20,6002,5751,251,4.2
17019,1/1/20,105273,101731,3542,3.4
17021,1/1/20,13963,13256,707,5.1
17023,1/1/20,7441,7095,346,4.6
17025,1/1/20,6309,5998,311,4.9
17027,1/1/20,20280,19626,654,3.2
17029,1/1/20,23909,23084,825,3.5
17031,1/1/20,2537056,2444539,92517,3.6
17033,1/1/20,8498,8136,362,4.3
17035,1/1/20,6081,5872,209,3.4
17037,1/1/20,54922,52458,2464,4.5
17039,1/1/20,7250,6949,301,4.2
17041,1/1/20,9936,9612,324,3.3
17043,1/1/20,496735,482721,14014,2.8
17045,1/1/20,8525,8179,346,4.1
17047,1/1/20,2619,2503,116,4.4
17049,1/1/20,19217,18595,622,3.2
17051,1/1/20,9626,9175,451,4.7
17053,1/1/20,6127,5847,280,4.6
17055,1/1/20,15998,15167,831,5.2
17057,1/1/20,14852,13962,890,6
17059,1/1/20,2309,2193,116,5
17061,1/1/20,5827,5581,246,4.2
17063,1/1/20,24982,23719,1263,5.1
17065,1/1/20,4335,4187,148,3.4
17067,1/1/20,8063,7679,384,4.8
17069,1/1/20,1287,1201,86,6.7
17071,1/1/20,3465,3293,172,5
17073,1/1/20,24574,23333,1241,5.1
17075,1/1/20,13822,13132,690,5
17077,1/1/20,27376,26425,951,3.5
17079,1/1/20,4661,4460,201,4.3
17081,1/1/20,17240,16521,719,4.2
17083,1/1/20,10934,10457,477,4.4
17085,1/1/20,10356,9790,566,5.5
17087,1/1/20,4170,3927,243,5.8
17089,1/1/20,272714,259845,12869,4.7
17091,1/1/20,55939,52918,3021,5.4
17093,1/1/20,67283,64940,2343,3.5
17095,1/1/20,21038,20025,1013,4.8
17097,1/1/20,371213,354917,16296,4.4
17099,1/1/20,54389,51196,3193,5.9
17101,1/1/20,5811,5520,291,5
17103,1/1/20,17604,16886,718,4.1
17105,1/1/20,16040,15342,698,4.4
17107,1/1/20,12293,11792,501,4.1
17109,1/1/20,12999,12492,507,3.9
17111,1/1/20,162258,156451,5807,3.6
17113,1/1/20,86598,83713,2885,3.3
17115,1/1/20,47733,45306,2427,5.1
17117,1/1/20,22780,21825,955,4.2
17119,1/1/20,134051,129205,4846,3.6
17121,1/1/20,17205,16473,732,4.3
17123,1/1/20,5169,4893,276,5.3
17125,1/1/20,6166,5811,355,5.8
17127,1/1/20,5629,5328,301,5.3
17129,1/1/20,6395,6124,271,4.2
17131,1/1/20,7973,7486,487,6.1
17133,1/1/20,18735,18205,530,2.8
17135,1/1/20,11484,10792,692,6
17137,1/1/20,16091,15416,675,4.2
17139,1/1/20,7468,7240,228,3.1
17141,1/1/20,24225,22772,1453,6
17143,1/1/20,83643,79142,4501,5.4
17145,1/1/20,8225,7854,371,4.5
17147,1/1/20,8240,7947,293,3.6
17149,1/1/20,6667,6343,324,4.9
17151,1/1/20,1657,1570,87,5.3
17153,1/1/20,1923,1803,120,6.2
17155,1/1/20,3095,2901,194,6.3
17157,1/1/20,14146,13629,517,3.7
17159,1/1/20,7111,6836,275,3.9
17161,1/1/20,70708,67171,3537,5
17163,1/1/20,126396,121306,5090,4
17165,1/1/20,9525,9004,521,5.5
17167,1/1/20,99493,95679,3814,3.8
17169,1/1/20,3105,2959,146,4.7
17171,1/1/20,2462,2327,135,5.5
17173,1/1/20,10371,9947,424,4.1
17175,1/1/20,2421,2280,141,5.8
17177,1/1/20,21225,20181,1044,4.9
17179,1/1/20,62654,59675,2979,4.8
17181,1/1/20,7371,6929,442,6
17183,1/1/20,32407,30821,1586,4.9
17185,1/1/20,5865,5681,184,3.1
17187,1/1/20,8168,7850,318,3.9
17189,1/1/20,9680,9447,233,2.4
17191,1/1/20,6775,6480,295,4.4
17193,1/1/20,6454,6219,235,3.6
17195,1/1/20,28191,26936,1255,4.5
17197,1/1/20,350497,336465,14032,4
17199,1/1/20,31505,30172,1333,4.2
17201,1/1/20,136441,125915,10526,7.7
17203,1/1/20,18285,17601,684,3.7
18001,1/1/20,16917,16413,504,3
18003,1/1/20,186225,179876,6349,3.4
18005,1/1/20,45195,43941,1254,2.8
18007,1/1/20,4556,4408,148,3.2
18009,1/1/20,4824,4600,224,4.6
18011,1/1/20,36390,35421,969,2.7
18013,1/1/20,7785,7509,276,3.5
18015,1/1/20,10366,10013,353,3.4
18017,1/1/20,17707,16983,724,4.1
18019,1/1/20,62053,59922,2131,3.4
18021,1/1/20,12010,11537,473,3.9
18023,1/1/20,17016,16514,502,3
18025,1/1/20,4901,4601,300,6.1
18027,1/1/20,16749,16245,504,3
18029,1/1/20,25884,24853,1031,4
18031,1/1/20,14805,14319,486,3.3
18033,1/1/20,22750,22054,696,3.1
18035,1/1/20,54379,52115,2264,4.2
18037,1/1/20,22959,22345,614,2.7
18039,1/1/20,111926,108538,3388,3
18041,1/1/20,8546,8115,431,5
18043,1/1/20,41909,40511,1398,3.3
18045,1/1/20,7905,7601,304,3.8
18047,1/1/20,11161,10730,431,3.9
18049,1/1/20,9555,9153,402,4.2
18051,1/1/20,19652,19091,561,2.9
18053,1/1/20,30661,29410,1251,4.1
18055,1/1/20,13699,13061,638,4.7
18057,1/1/20,184725,179840,4885,2.6
18059,1/1/20,40457,39212,1245,3.1
18061,1/1/20,20448,19729,719,3.5
18063,1/1/20,90451,87898,2553,2.8
18065,1/1/20,22040,21229,811,3.7
18067,1/1/20,37113,35559,1554,4.2
18069,1/1/20,18088,17447,641,3.5
18071,1/1/20,22973,22323,650,2.8
18073,1/1/20,16285,15495,790,4.9
18075,1/1/20,9329,9003,326,3.5
18077,1/1/20,14997,14427,570,3.8
18079,1/1/20,13601,13075,526,3.9
18081,1/1/20,83411,80968,2443,2.9
18083,1/1/20,18274,17651,623,3.4
18085,1/1/20,41858,40566,1292,3.1
18087,1/1/20,19642,19104,538,2.7
18089,1/1/20,230994,218654,12340,5.3
18091,1/1/20,47539,45262,2277,4.8
18093,1/1/20,21292,20397,895,4.2
18095,1/1/20,59676,57103,2573,4.3
18097,1/1/20,493512,476853,16659,3.4
18099,1/1/20,22762,21956,806,3.5
18101,1/1/20,5380,5223,157,2.9
18103,1/1/20,15051,14401,650,4.3
18105,1/1/20,71425,68947,2478,3.5
18107,1/1/20,18662,18046,616,3.3
18109,1/1/20,36615,35326,1289,3.5
18111,1/1/20,6930,6596,334,4.8
18113,1/1/20,23218,22415,803,3.5
18115,1/1/20,3208,3078,130,4.1
18117,1/1/20,8814,8476,338,3.8
18119,1/1/20,9526,9113,413,4.3
18121,1/1/20,6851,6556,295,4.3
18123,1/1/20,9195,8861,334,3.6
18125,1/1/20,6177,5927,250,4
18127,1/1/20,87134,83349,3785,4.3
18129,1/1/20,13546,13134,412,3
18131,1/1/20,6410,6150,260,4.1
18133,1/1/20,16834,16206,628,3.7
18135,1/1/20,10917,10427,490,4.5
18137,1/1/20,14163,13636,527,3.7
18139,1/1/20,8763,8497,266,3
18141,1/1/20,135921,130498,5423,4
18143,1/1/20,10604,10224,380,3.6
18145,1/1/20,23272,22523,749,3.2
18147,1/1/20,10169,9772,397,3.9
18149,1/1/20,9662,9169,493,5.1
18151,1/1/20,20826,20221,605,2.9
18153,1/1/20,8333,7934,399,4.8
18155,1/1/20,4931,4748,183,3.7
18157,1/1/20,101370,98217,3153,3.1
18159,1/1/20,9069,8802,267,2.9
18161,1/1/20,3540,3413,127,3.6
18163,1/1/20,94529,91401,3128,3.3
18165,1/1/20,6964,6561,403,5.8
18167,1/1/20,48161,45958,2203,4.6
18169,1/1/20,14820,14296,524,3.5
18171,1/1/20,4164,4028,136,3.3
18173,1/1/20,33074,32015,1059,3.2
18175,1/1/20,13693,13175,518,3.8
18177,1/1/20,30578,29403,1175,3.8
18179,1/1/20,14393,13935,458,3.2
18181,1/1/20,13298,12896,402,3
18183,1/1/20,17750,17193,557,3.1
19001,1/1/20,4253,4128,125,2.9
19003,1/1/20,2190,2138,52,2.4
19005,1/1/20,7600,7168,432,5.7
19007,1/1/20,6047,5780,267,4.4
19009,1/1/20,3153,3045,108,3.4
19011,1/1/20,13785,13243,542,3.9
19013,1/1/20,69649,66532,3117,4.5
19015,1/1/20,15083,14604,479,3.2
19017,1/1/20,13982,13523,459,3.3
19019,1/1/20,11424,10956,468,4.1
19021,1/1/20,12117,11807,310,2.6
19023,1/1/20,8069,7697,372,4.6
19025,1/1/20,4309,4166,143,3.3
19027,1/1/20,11131,10875,256,2.3
19029,1/1/20,6986,6720,266,3.8
19031,1/1/20,11038,10631,407,3.7
19033,1/1/20,23943,23114,829,3.5
19035,1/1/20,6320,6088,232,3.7
19037,1/1/20,6679,6373,306,4.6
19039,1/1/20,5016,4799,217,4.3
19041,1/1/20,8693,8352,341,3.9
19043,1/1/20,10242,9535,707,6.9
19045,1/1/20,23145,22006,1139,4.9
19047,1/1/20,8430,7946,484,5.7
19049,1/1/20,50286,49049,1237,2.5
19051,1/1/20,4302,4151,151,3.5
19053,1/1/20,4528,4393,135,3
19055,1/1/20,10791,10419,372,3.4
19057,1/1/20,19268,18235,1033,5.4
19059,1/1/20,9788,9300,488,5
19061,1/1/20,57536,55181,2355,4.1
19063,1/1/20,5294,5115,179,3.4
19065,1/1/20,10991,10410,581,5.3
19067,1/1/20,8832,8367,465,5.3
19069,1/1/20,5752,5542,210,3.7
19071,1/1/20,3745,3652,93,2.5
19073,1/1/20,5555,5414,141,2.5
19075,1/1/20,6587,6353,234,3.6
19077,1/1/20,5767,5531,236,4.1
19079,1/1/20,6965,6725,240,3.4
19081,1/1/20,6032,5840,192,3.2
19083,1/1/20,8124,7772,352,4.3
19085,1/1/20,7600,7361,239,3.1
19087,1/1/20,9838,9463,375,3.8
19089,1/1/20,5345,5122,223,4.2
19091,1/1/20,5198,4997,201,3.9
19093,1/1/20,4284,4146,138,3.2
19095,1/1/20,10691,10325,366,3.4
19097,1/1/20,11197,10635,562,5
19099,1/1/20,20134,19348,786,3.9
19101,1/1/20,10389,10089,300,2.9
19103,1/1/20,86454,84375,2079,2.4
19105,1/1/20,11049,10475,574,5.2
19107,1/1/20,5302,5066,236,4.5
19109,1/1/20,8532,8274,258,3
19111,1/1/20,16341,15542,799,4.9
19113,1/1/20,123949,119392,4557,3.7
19115,1/1/20,6156,5884,272,4.4
19117,1/1/20,4739,4617,122,2.6
19119,1/1/20,7177,6984,193,2.7
19121,1/1/20,8812,8363,449,5.1
19123,1/1/20,11996,11603,393,3.3
19125,1/1/20,18489,17931,558,3
19127,1/1/20,18439,17032,1407,7.6
19129,1/1/20,7602,7388,214,2.8
19131,1/1/20,7231,7065,166,2.3
19133,1/1/20,4523,4334,189,4.2
19135,1/1/20,4157,3984,173,4.2
19137,1/1/20,5105,4936,169,3.3
19139,1/1/20,22208,21409,799,3.6
19141,1/1/20,8457,8213,244,2.9
19143,1/1/20,3592,3497,95,2.6
19145,1/1/20,6477,6264,213,3.3
19147,1/1/20,4839,4701,138,2.9
19149,1/1/20,15095,14669,426,2.8
19151,1/1/20,4601,4482,119,2.6
19153,1/1/20,273739,263889,9850,3.6
19155,1/1/20,49931,48375,1556,3.1
19157,1/1/20,9769,9347,422,4.3
19159,1/1/20,2501,2424,77,3.1
19161,1/1/20,5323,5139,184,3.5
19163,1/1/20,89821,85932,3889,4.3
19165,1/1/20,6810,6606,204,3
19167,1/1/20,21663,21035,628,2.9
19169,1/1/20,59036,57712,1324,2.2
19171,1/1/20,9641,9147,494,5.1
19173,1/1/20,3266,3188,78,2.4
19175,1/1/20,6429,6157,272,4.2
19177,1/1/20,3713,3570,143,3.9
19179,1/1/20,18044,17252,792,4.4
19181,1/1/20,28853,27854,999,3.5
19183,1/1/20,12231,11757,474,3.9
19185,1/1/20,2878,2791,87,3
19187,1/1/20,19753,19013,740,3.7
19189,1/1/20,5258,5088,170,3.2
19191,1/1/20,11888,11279,609,5.1
19193,1/1/20,56694,54650,2044,3.6
19195,1/1/20,4331,4147,184,4.2
19197,1/1/20,7142,6924,218,3.1
20001,1/1/20,6282,6045,237,3.8
20003,1/1/20,4159,4003,156,3.8
20005,1/1/20,6951,6583,368,5.3
20007,1/1/20,2294,2225,69,3
20009,1/1/20,13134,12633,501,3.8
20011,1/1/20,6585,6282,303,4.6
20013,1/1/20,5352,5176,176,3.3
20015,1/1/20,32722,31559,1163,3.6
20017,1/1/20,1536,1491,45,2.9
20019,1/1/20,1425,1373,52,3.6
20021,1/1/20,10107,9784,323,3.2
20023,1/1/20,1301,1269,32,2.5
20025,1/1/20,1080,1053,27,2.5
20027,1/1/20,3747,3621,126,3.4
20029,1/1/20,3735,3609,126,3.4
20031,1/1/20,4161,3944,217,5.2
20033,1/1/20,832,807,25,3
20035,1/1/20,16109,15536,573,3.6
20037,1/1/20,18582,17800,782,4.2
20039,1/1/20,1178,1139,39,3.3
20041,1/1/20,8759,8367,392,4.5
20043,1/1/20,4118,3963,155,3.8
20045,1/1/20,65869,63756,2113,3.2
20047,1/1/20,1362,1327,35,2.6
20049,1/1/20,1154,1117,37,3.2
20051,1/1/20,16918,16530,388,2.3
20053,1/1/20,2696,2622,74,2.7
20055,1/1/20,20753,20292,461,2.2
20057,1/1/20,16858,16431,427,2.5
20059,1/1/20,14167,13644,523,3.7
20061,1/1/20,11275,10741,534,4.7
20063,1/1/20,1470,1435,35,2.4
20065,1/1/20,1080,1046,34,3.1
20067,1/1/20,3099,3020,79,2.5
20069,1/1/20,3121,3049,72,2.3
20071,1/1/20,767,752,15,2
20073,1/1/20,3285,3162,123,3.7
20075,1/1/20,1608,1578,30,1.9
20077,1/1/20,2987,2905,82,2.7
20079,1/1/20,17082,16541,541,3.2
20081,1/1/20,2146,2101,45,2.1
20083,1/1/20,974,942,32,3.3
20085,1/1/20,7201,6937,264,3.7
20087,1/1/20,10126,9746,380,3.8
20089,1/1/20,1247,1213,34,2.7
20091,1/1/20,341859,332373,9486,2.8
20093,1/1/20,1994,1949,45,2.3
20095,1/1/20,3424,3305,119,3.5
20097,1/1/20,1268,1238,30,2.4
20099,1/1/20,9861,9461,400,4.1
20101,1/1/20,733,715,18,2.5
20103,1/1/20,36973,35543,1430,3.9
20105,1/1/20,1726,1677,49,2.8
20107,1/1/20,4491,4190,301,6.7
20109,1/1/20,1596,1562,34,2.1
20111,1/1/20,16610,15997,613,3.7
20113,1/1/20,17054,16642,412,2.4
20115,1/1/20,5871,5705,166,2.8
20117,1/1/20,5434,5274,160,2.9
20119,1/1/20,2049,2000,49,2.4
20121,1/1/20,17755,17042,713,4
20123,1/1/20,3252,3178,74,2.3
20125,1/1/20,14537,13814,723,5
20127,1/1/20,3020,2917,103,3.4
20129,1/1/20,1103,1071,32,2.9
20131,1/1/20,5254,5103,151,2.9
20133,1/1/20,6153,5864,289,4.7
20135,1/1/20,1312,1277,35,2.7
20137,1/1/20,2641,2587,54,2
20139,1/1/20,7984,7646,338,4.2
20141,1/1/20,2051,2009,42,2
20143,1/1/20,2975,2888,87,2.9
20145,1/1/20,2820,2721,99,3.5
20147,1/1/20,2593,2524,69,2.7
20149,1/1/20,12306,11913,393,3.2
20151,1/1/20,4878,4738,140,2.9
20153,1/1/20,1462,1428,34,2.3
20155,1/1/20,29380,28383,997,3.4
20157,1/1/20,2169,2110,59,2.7
20159,1/1/20,5160,5017,143,2.8
20161,1/1/20,34731,33723,1008,2.9
20163,1/1/20,2464,2382,82,3.3
20165,1/1/20,1604,1554,50,3.1
20167,1/1/20,3214,3115,99,3.1
20169,1/1/20,30169,29122,1047,3.5
20171,1/1/20,2783,2728,55,2
20173,1/1/20,253382,243656,9726,3.8
20175,1/1/20,9184,8887,297,3.2
20177,1/1/20,90603,87289,3314,3.7
20179,1/1/20,1374,1337,37,2.7
20181,1/1/20,2731,2654,77,2.8
20183,1/1/20,1939,1887,52,2.7
20185,1/1/20,2012,1948,64,3.2
20187,1/1/20,959,929,30,3.1
20189,1/1/20,2451,2379,72,2.9
20191,1/1/20,10923,10552,371,3.4
20193,1/1/20,4225,4128,97,2.3
20195,1/1/20,1411,1364,47,3.3
20197,1/1/20,3646,3501,145,4
20199,1/1/20,775,753,22,2.8
20201,1/1/20,2876,2797,79,2.7
20203,1/1/20,1173,1144,29,2.5
20205,1/1/20,3945,3770,175,4.4
20207,1/1/20,1545,1479,66,4.3
20209,1/1/20,78141,74623,3518,4.5
21001,1/1/20,7060,6608,452,6.4
21003,1/1/20,9011,8608,403,4.5
21005,1/1/20,12152,11628,524,4.3
21007,1/1/20,3530,3304,226,6.4
21009,1/1/20,18811,17835,976,5.2
21011,1/1/20,4702,4302,400,8.5
21013,1/1/20,8522,7859,663,7.8
21015,1/1/20,71203,68510,2693,3.8
21017,1/1/20,9766,9338,428,4.4
21019,1/1/20,17913,16699,1214,6.8
21021,1/1/20,12409,11796,613,4.9
21023,1/1/20,3892,3642,250,6.4
21025,1/1/20,3524,3142,382,10.8
21027,1/1/20,7979,7472,507,6.4
21029,1/1/20,43132,41265,1867,4.3
21031,1/1/20,5160,4863,297,5.8
21033,1/1/20,5525,5221,304,5.5
21035,1/1/20,18450,17632,818,4.4
21037,1/1/20,50985,49018,1967,3.9
21039,1/1/20,2324,2215,109,4.7
21041,1/1/20,5261,5011,250,4.8
21043,1/1/20,9909,8920,989,10
21045,1/1/20,6760,6444,316,4.7
21047,1/1/20,25328,23850,1478,5.8
21049,1/1/20,17190,16393,797,4.6
21051,1/1/20,5225,4828,397,7.6
21053,1/1/20,4040,3796,244,6
21055,1/1/20,3867,3663,204,5.3
21057,1/1/20,3192,3031,161,5
21059,1/1/20,47731,45639,2092,4.4
21061,1/1/20,4829,4559,270,5.6
21063,1/1/20,2129,1888,241,11.3
21065,1/1/20,5442,5111,331,6.1
21067,1/1/20,174100,167944,6156,3.5
21069,1/1/20,6169,5779,390,6.3
21071,1/1/20,11000,10136,864,7.9
21073,1/1/20,25410,24373,1037,4.1
21075,1/1/20,2045,1936,109,5.3
21077,1/1/20,4105,3923,182,4.4
21079,1/1/20,7640,7229,411,5.4
21081,1/1/20,11831,11246,585,4.9
21083,1/1/20,15954,15145,809,5.1
21085,1/1/20,11113,10484,629,5.7
21087,1/1/20,5064,4840,224,4.4
21089,1/1/20,13539,12430,1109,8.2
21091,1/1/20,3985,3831,154,3.9
21093,1/1/20,49156,46920,2236,4.5
21095,1/1/20,6711,5883,828,12.3
21097,1/1/20,8853,8445,408,4.6
21099,1/1/20,8060,7515,545,6.8
21101,1/1/20,22023,21116,907,4.1
21103,1/1/20,8310,7972,338,4.1
21105,1/1/20,1767,1674,93,5.3
21107,1/1/20,18514,17564,950,5.1
21109,1/1/20,4087,3790,297,7.3
21111,1/1/20,402833,386328,16505,4.1
21113,1/1/20,26453,25418,1035,3.9
21115,1/1/20,6732,6218,514,7.6
21117,1/1/20,88149,84652,3497,4
21119,1/1/20,4482,4123,359,8
21121,1/1/20,9887,9267,620,6.3
21123,1/1/20,6017,5719,298,5
21125,1/1/20,24547,23273,1274,5.2
21127,1/1/20,5301,4846,455,8.6
21129,1/1/20,2107,1968,139,6.6
21131,1/1/20,2780,2445,335,12.1
21133,1/1/20,6439,5834,605,9.4
21135,1/1/20,4761,4249,512,10.8
21137,1/1/20,9231,8722,509,5.5
21139,1/1/20,3671,3433,238,6.5
21141,1/1/20,12659,12092,567,4.5
21143,1/1/20,3037,2872,165,5.4
21145,1/1/20,29263,27646,1617,5.5
21147,1/1/20,4714,4370,344,7.3
21149,1/1/20,4248,4038,210,4.9
21151,1/1/20,47255,45321,1934,4.1
21153,1/1/20,3360,2864,496,14.8
21155,1/1/20,9718,9336,382,3.9
21157,1/1/20,15022,14214,808,5.4
21159,1/1/20,2791,2540,251,9
21161,1/1/20,7102,6637,465,6.5
21163,1/1/20,12324,11682,642,5.2
21165,1/1/20,2352,2136,216,9.2
21167,1/1/20,9931,9410,521,5.2
21169,1/1/20,4136,3885,251,6.1
21171,1/1/20,4748,4535,213,4.5
21173,1/1/20,11677,10949,728,6.2
21175,1/1/20,4656,4316,340,7.3
21177,1/1/20,10419,9651,768,7.4
21179,1/1/20,23346,22253,1093,4.7
21181,1/1/20,3332,3152,180,5.4
21183,1/1/20,9906,9293,613,6.2
21185,1/1/20,33539,32406,1133,3.4
21187,1/1/20,5120,4870,250,4.9
21189,1/1/20,1147,1066,81,7.1
21191,1/1/20,7065,6728,337,4.8
21193,1/1/20,8367,7674,693,8.3
21195,1/1/20,19892,18404,1488,7.5
21197,1/1/20,5059,4715,344,6.8
21199,1/1/20,26813,25418,1395,5.2
21201,1/1/20,831,782,49,5.9
21203,1/1/20,6702,6340,362,5.4
21205,1/1/20,10525,9893,632,6
21207,1/1/20,6247,5845,402,6.4
21209,1/1/20,29015,27907,1108,3.8
21211,1/1/20,25662,24779,883,3.4
21213,1/1/20,8982,8548,434,4.8
21215,1/1/20,10295,9907,388,3.8
21217,1/1/20,12538,11971,567,4.5
21219,1/1/20,5501,5248,253,4.6
21221,1/1/20,6108,5774,334,5.5
21223,1/1/20,3917,3731,186,4.7
21225,1/1/20,6214,5911,303,4.9
21227,1/1/20,64948,62173,2775,4.3
21229,1/1/20,6314,6050,264,4.2
21231,1/1/20,7509,7038,471,6.3
21233,1/1/20,5608,5336,272,4.9
21235,1/1/20,13640,12891,749,5.5
21237,1/1/20,2013,1827,186,9.2
21239,1/1/20,14862,14336,526,3.5
22001,1/1/20,23619,22161,1458,6.2
22003,1/1/20,8968,8322,646,7.2
22005,1/1/20,64241,61136,3105,4.8
22007,1/1/20,8921,8251,670,7.5
22009,1/1/20,14984,13897,1087,7.3
22011,1/1/20,14567,13630,937,6.4
22013,1/1/20,5493,5112,381,6.9
22015,1/1/20,57460,54562,2898,5
22017,1/1/20,103314,96887,6427,6.2
22019,1/1/20,103482,98016,5466,5.3
22021,1/1/20,3781,3462,319,8.4
22023,1/1/20,3832,3643,189,4.9
22025,1/1/20,3355,3110,245,7.3
22027,1/1/20,5863,5447,416,7.1
22029,1/1/20,7099,6546,553,7.8
22031,1/1/20,10880,10081,799,7.3
22033,1/1/20,231590,219712,11878,5.1
22035,1/1/20,1862,1627,235,12.6
22037,1/1/20,7976,7563,413,5.2
22039,1/1/20,11712,10890,822,7
22041,1/1/20,7319,6675,644,8.8
22043,1/1/20,8181,7602,579,7.1
22045,1/1/20,27913,26100,1813,6.5
22047,1/1/20,14119,13131,988,7
22049,1/1/20,6782,6403,379,5.6
22051,1/1/20,215328,205031,10297,4.8
22053,1/1/20,13064,12310,754,5.8
22055,1/1/20,113183,107282,5901,5.2
22057,1/1/20,41763,39552,2211,5.3
22059,1/1/20,6808,6468,340,5
22061,1/1/20,21986,20617,1369,6.2
22063,1/1/20,68910,65622,3288,4.8
22065,1/1/20,3453,3121,332,9.6
22067,1/1/20,10109,9028,1081,10.7
22069,1/1/20,16000,14874,1126,7
22071,1/1/20,180237,170249,9988,5.5
22073,1/1/20,70168,65733,4435,6.3
22075,1/1/20,10078,9564,514,5.1
22077,1/1/20,9836,9233,603,6.1
22079,1/1/20,55019,51708,3311,6
22081,1/1/20,3722,3479,243,6.5
22083,1/1/20,8142,7457,685,8.4
22085,1/1/20,9067,8525,542,6
22087,1/1/20,19997,18843,1154,5.8
22089,1/1/20,25369,24079,1290,5.1
22091,1/1/20,4285,3988,297,6.9
22093,1/1/20,9363,8681,682,7.3
22095,1/1/20,19928,18589,1339,6.7
22097,1/1/20,31903,29464,2439,7.6
22099,1/1/20,22096,20761,1335,6
22101,1/1/20,19761,18426,1335,6.8
22103,1/1/20,120112,114340,5772,4.8
22105,1/1/20,54687,51077,3610,6.6
22107,1/1/20,1327,1185,142,10.7
22109,1/1/20,46005,43469,2536,5.5
22111,1/1/20,9077,8429,648,7.1
22113,1/1/20,23921,22472,1449,6.1
22115,1/1/20,16167,15015,1152,7.1
22117,1/1/20,16749,15629,1120,6.7
22119,1/1/20,14518,13467,1051,7.2
22121,1/1/20,13712,12999,713,5.2
22123,1/1/20,3654,3090,564,15.4
22125,1/1/20,5392,5121,271,5
22127,1/1/20,4834,4468,366,7.6
23001,1/1/20,55499,53497,2002,3.6
23003,1/1/20,30171,28451,1720,5.7
23005,1/1/20,162842,158060,4782,2.9
23007,1/1/20,14359,13674,685,4.8
23009,1/1/20,26972,25298,1674,6.2
23011,1/1/20,61847,59451,2396,3.9
23013,1/1/20,19449,18596,853,4.4
23015,1/1/20,16030,15331,699,4.4
23017,1/1/20,26841,25630,1211,4.5
23019,1/1/20,76732,73411,3321,4.3
23021,1/1/20,7259,6888,371,5.1
23023,1/1/20,19174,18592,582,3
23025,1/1/20,22186,20793,1393,6.3
23027,1/1/20,20302,19362,940,4.6
23029,1/1/20,13475,12470,1005,7.5
23031,1/1/20,112147,107687,4460,4
24001,1/1/20,32137,30343,1794,5.6
24003,1/1/20,319375,309895,9480,3
24005,1/1/20,459764,443134,16630,3.6
24009,1/1/20,50608,49090,1518,3
24011,1/1/20,18196,17508,688,3.8
24013,1/1/20,97531,94656,2875,2.9
24015,1/1/20,53675,51532,2143,4
24017,1/1/20,88369,85264,3105,3.5
24019,1/1/20,15310,14526,784,5.1
24021,1/1/20,136187,131847,4340,3.2
24023,1/1/20,15590,14757,833,5.3
24025,1/1/20,143039,138293,4746,3.3
24027,1/1/20,189856,184937,4919,2.6
24029,1/1/20,10286,9756,530,5.2
24031,1/1/20,564746,548671,16075,2.8
24033,1/1/20,515346,496719,18627,3.6
24035,1/1/20,28636,27693,943,3.3
24037,1/1/20,57957,56104,1853,3.2
24039,1/1/20,9301,8671,630,6.8
24041,1/1/20,18927,18199,728,3.8
24043,1/1/20,75898,72844,3054,4
24045,1/1/20,50671,48052,2619,5.2
24047,1/1/20,26225,23377,2848,10.9
24510,1/1/20,291738,277376,14362,4.9
25001,1/1/20,109469,102821,6648,6.1
25003,1/1/20,64661,61830,2831,4.4
25005,1/1/20,305670,291691,13979,4.6
25007,1/1/20,8507,7891,616,7.2
25009,1/1/20,428998,414612,14386,3.4
25011,1/1/20,41258,39910,1348,3.3
25013,1/1/20,229917,219537,10380,4.5
25015,1/1/20,90770,87975,2795,3.1
25017,1/1/20,928861,905023,23838,2.6
25019,1/1/20,6217,5529,688,11.1
25021,1/1/20,395637,384555,11082,2.8
25023,1/1/20,286436,275988,10448,3.6
25025,1/1/20,461085,448069,13016,2.8
25027,1/1/20,451331,435049,16282,3.6
26001,1/1/20,3826,3493,333,8.7
26003,1/1/20,3080,2808,272,8.8
26005,1/1/20,61851,59751,2100,3.4
26007,1/1/20,13312,12602,710,5.3
26009,1/1/20,10079,9442,637,6.3
26011,1/1/20,5994,5477,517,8.6
26013,1/1/20,3274,3036,238,7.3
26015,1/1/20,31632,30494,1138,3.6
26017,1/1/20,49693,46979,2714,5.5
26019,1/1/20,8776,8173,603,6.9
26021,1/1/20,73025,69728,3297,4.5
26023,1/1/20,19104,18337,767,4
26025,1/1/20,61929,59396,2533,4.1
26027,1/1/20,24433,23297,1136,4.6
26029,1/1/20,12510,11759,751,6
26031,1/1/20,10201,8556,1645,16.1
26033,1/1/20,16164,14922,1242,7.7
26035,1/1/20,11714,10803,911,7.8
26037,1/1/20,41046,39826,1220,3
26039,1/1/20,5661,5261,400,7.1
26041,1/1/20,17141,16064,1077,6.3
26043,1/1/20,12349,11745,604,4.9
26045,1/1/20,57338,55453,1885,3.3
26047,1/1/20,17374,16122,1252,7.2
26049,1/1/20,183289,174176,9113,5
26051,1/1/20,9792,9108,684,7
26053,1/1/20,6133,5733,400,6.5
26055,1/1/20,48687,46722,1965,4
26057,1/1/20,18104,17216,888,4.9
26059,1/1/20,20245,19346,899,4.4
26061,1/1/20,15530,14703,827,5.3
26063,1/1/20,15140,14294,846,5.6
26065,1/1/20,151209,146421,4788,3.2
26067,1/1/20,30211,29098,1113,3.7
26069,1/1/20,10199,9331,868,8.5
26071,1/1/20,5177,4818,359,6.9
26073,1/1/20,34862,33418,1444,4.1
26075,1/1/20,74238,71341,2897,3.9
26077,1/1/20,133818,129586,4232,3.2
26079,1/1/20,7860,7275,585,7.4
26081,1/1/20,359770,349608,10162,2.8
26083,1/1/20,841,783,58,6.9
26085,1/1/20,3850,3576,274,7.1
26087,1/1/20,41673,38951,2722,6.5
26089,1/1/20,10227,9778,449,4.4
26091,1/1/20,46087,44121,1966,4.3
26093,1/1/20,103408,100134,3274,3.2
26095,1/1/20,2285,2126,159,7
26097,1/1/20,4351,3469,882,20.3
26099,1/1/20,451659,430494,21165,4.7
26101,1/1/20,10259,9582,677,6.6
26103,1/1/20,31983,30266,1717,5.4
26105,1/1/20,13137,12321,816,6.2
26107,1/1/20,18186,17184,1002,5.5
26109,1/1/20,11017,10515,502,4.6
26111,1/1/20,39919,38204,1715,4.3
26113,1/1/20,6900,6471,429,6.2
26115,1/1/20,75402,72192,3210,4.3
26117,1/1/20,28325,27073,1252,4.4
26119,1/1/20,3014,2652,362,12
26121,1/1/20,77162,73795,3367,4.4
26123,1/1/20,23410,22321,1089,4.7
26125,1/1/20,675945,653907,22038,3.3
26127,1/1/20,11574,10690,884,7.6
26129,1/1/20,7867,7150,717,9.1
26131,1/1/20,2096,1943,153,7.3
26133,1/1/20,11379,10849,530,4.7
26135,1/1/20,2936,2700,236,8
26137,1/1/20,11627,10931,696,6
26139,1/1/20,160556,156291,4265,2.7
26141,1/1/20,4886,4328,558,11.4
26143,1/1/20,7473,6741,732,9.8
26145,1/1/20,86377,82014,4363,5.1
26147,1/1/20,76163,72079,4084,5.4
26149,1/1/20,27601,26409,1192,4.3
26151,1/1/20,19426,18253,1173,6
26153,1/1/20,3323,3013,310,9.3
26155,1/1/20,33519,32030,1489,4.4
26157,1/1/20,23985,22545,1440,6
26159,1/1/20,35131,33258,1873,5.3
26161,1/1/20,198766,193808,4958,2.5
26163,1/1/20,810007,768869,41138,5.1
26165,1/1/20,14914,14107,807,5.4
27001,1/1/20,7280,6621,659,9.1
27003,1/1/20,199485,192916,6569,3.3
27005,1/1/20,18564,17506,1058,5.7
27007,1/1/20,24503,23186,1317,5.4
27009,1/1/20,22323,21131,1192,5.3
27011,1/1/20,2409,2234,175,7.3
27013,1/1/20,41307,40122,1185,2.9
27015,1/1/20,14157,13444,713,5
27017,1/1/20,17924,16911,1013,5.7
27019,1/1/20,58814,57164,1650,2.8
27021,1/1/20,14004,12846,1158,8.3
27023,1/1/20,6916,6568,348,5
27025,1/1/20,30552,28977,1575,5.2
27027,1/1/20,36247,34927,1320,3.6
27029,1/1/20,4682,4045,637,13.6
27031,1/1/20,2908,2731,177,6.1
27033,1/1/20,5873,5630,243,4.1
27035,1/1/20,31920,29951,1969,6.2
27037,1/1/20,243412,236340,7072,2.9
27039,1/1/20,11877,11359,518,4.4
27041,1/1/20,20895,20059,836,4
27043,1/1/20,6867,6470,397,5.8
27045,1/1/20,11480,10933,547,4.8
27047,1/1/20,16130,15475,655,4.1
27049,1/1/20,27162,26087,1075,4
27051,1/1/20,3225,3014,211,6.5
27053,1/1/20,709425,691948,17477,2.5
27055,1/1/20,10282,9833,449,4.4
27057,1/1/20,9789,9020,769,7.9
27059,1/1/20,21783,20546,1237,5.7
27061,1/1/20,22242,20595,1647,7.4
27063,1/1/20,5636,5412,224,4
27065,1/1/20,9407,8443,964,10.2
27067,1/1/20,24028,22892,1136,4.7
27069,1/1/20,2299,2197,102,4.4
27071,1/1/20,5757,5359,398,6.9
27073,1/1/20,3479,3289,190,5.5
27075,1/1/20,5352,5096,256,4.8
27077,1/1/20,2596,2494,102,3.9
27079,1/1/20,16538,15395,1143,6.9
27081,1/1/20,3165,2962,203,6.4
27083,1/1/20,14160,13555,605,4.3
27085,1/1/20,19237,18282,955,5
27087,1/1/20,2295,2122,173,7.5
27089,1/1/20,5383,4846,537,10
27091,1/1/20,9708,9319,389,4
27093,1/1/20,13403,12628,775,5.8
27095,1/1/20,13366,12267,1099,8.2
27097,1/1/20,17536,16081,1455,8.3
27099,1/1/20,20200,19505,695,3.4
27101,1/1/20,4652,4333,319,6.9
27103,1/1/20,21240,20688,552,2.6
27105,1/1/20,11068,10698,370,3.3
27107,1/1/20,3129,2915,214,6.8
27109,1/1/20,88745,86480,2265,2.6
27111,1/1/20,31110,29230,1880,6
27113,1/1/20,8863,8159,704,7.9
27115,1/1/20,15281,14007,1274,8.3
27117,1/1/20,4782,4541,241,5
27119,1/1/20,16582,15831,751,4.5
27121,1/1/20,6456,6201,255,3.9
27123,1/1/20,291202,282944,8258,2.8
27125,1/1/20,2230,2035,195,8.7
27127,1/1/20,7402,7076,326,4.4
27129,1/1/20,8253,7740,513,6.2
27131,1/1/20,37319,35919,1400,3.8
27133,1/1/20,5514,5367,147,2.7
27135,1/1/20,7837,7469,368,4.7
27137,1/1/20,101786,97240,4546,4.5
27139,1/1/20,84197,81790,2407,2.9
27141,1/1/20,53292,50888,2404,4.5
27143,1/1/20,8475,8047,428,5.1
27145,1/1/20,91052,87438,3614,4
27147,1/1/20,21589,20813,776,3.6
27149,1/1/20,5137,4958,179,3.5
27151,1/1/20,4790,4493,297,6.2
27153,1/1/20,13504,12724,780,5.8
27155,1/1/20,1702,1607,95,5.6
27157,1/1/20,12235,11691,544,4.4
27159,1/1/20,6048,5512,536,8.9
27161,1/1/20,8906,8401,505,5.7
27163,1/1/20,144425,140187,4238,2.9
27165,1/1/20,6309,5995,314,5
27167,1/1/20,3329,3206,123,3.7
27169,1/1/20,28475,27580,895,3.1
27171,1/1/20,76692,73542,3150,4.1
27173,1/1/20,5250,5025,225,4.3
28001,1/1/20,11192,10420,772,6.9
28003,1/1/20,16116,15365,751,4.7
28005,1/1/20,4340,4019,321,7.4
28007,1/1/20,6972,6509,463,6.6
28009,1/1/20,3024,2841,183,6.1
28011,1/1/20,11876,10949,927,7.8
28013,1/1/20,5487,5166,321,5.9
28015,1/1/20,3422,3202,220,6.4
28017,1/1/20,6727,6376,351,5.2
28019,1/1/20,3593,3393,200,5.6
28021,1/1/20,2958,2649,309,10.4
28023,1/1/20,5908,5522,386,6.5
28025,1/1/20,7612,7031,581,7.6
28027,1/1/20,8212,7505,707,8.6
28029,1/1/20,11005,10303,702,6.4
28031,1/1/20,8010,7610,400,5
28033,1/1/20,90445,86625,3820,4.2
28035,1/1/20,33196,31599,1597,4.8
28037,1/1/20,2727,2529,198,7.3
28039,1/1/20,8723,8003,720,8.3
28041,1/1/20,4362,3951,411,9.4
28043,1/1/20,9312,8845,467,5
28045,1/1/20,18546,17532,1014,5.5
28047,1/1/20,85452,81145,4307,5
28049,1/1/20,105298,100102,5196,4.9
28051,1/1/20,5639,5065,574,10.2
28053,1/1/20,2207,1928,279,12.6
28055,1/1/20,371,329,42,11.3
28057,1/1/20,10423,9956,467,4.5
28059,1/1/20,57905,54471,3434,5.9
28061,1/1/20,6158,5646,512,8.3
28063,1/1/20,2025,1674,351,17.3
28065,1/1/20,4078,3806,272,6.7
28067,1/1/20,25798,24403,1395,5.4
28069,1/1/20,3496,3232,264,7.6
28071,1/1/20,27426,26279,1147,4.2
28073,1/1/20,30757,29481,1276,4.1
28075,1/1/20,30329,28794,1535,5.1
28077,1/1/20,4515,4214,301,6.7
28079,1/1/20,7771,7341,430,5.5
28081,1/1/20,40942,39221,1721,4.2
28083,1/1/20,9918,9134,784,7.9
28085,1/1/20,14403,13568,835,5.8
28087,1/1/20,24925,23622,1303,5.2
28089,1/1/20,52484,50286,2198,4.2
28091,1/1/20,9905,9342,563,5.7
28093,1/1/20,14334,13540,794,5.5
28095,1/1/20,15511,14688,823,5.3
28097,1/1/20,3873,3636,237,6.1
28099,1/1/20,9997,9376,621,6.2
28101,1/1/20,8803,8313,490,5.6
28103,1/1/20,3707,3432,275,7.4
28105,1/1/20,21544,20424,1120,5.2
28107,1/1/20,12329,11536,793,6.4
28109,1/1/20,23652,22492,1160,4.9
28111,1/1/20,4307,3998,309,7.2
28113,1/1/20,14265,13357,908,6.4
28115,1/1/20,14659,14044,615,4.2
28117,1/1/20,11144,10612,532,4.8
28119,1/1/20,2298,2102,196,8.5
28121,1/1/20,75102,72193,2909,3.9
28123,1/1/20,12430,11874,556,4.5
28125,1/1/20,1577,1426,151,9.6
28127,1/1/20,10592,10033,559,5.3
28129,1/1/20,6779,6403,376,5.5
28131,1/1/20,6743,6316,427,6.3
28133,1/1/20,7549,6775,774,10.3
28135,1/1/20,5210,4844,366,7
28137,1/1/20,12197,11554,643,5.3
28139,1/1/20,9359,8917,442,4.7
28141,1/1/20,8485,8011,474,5.6
28143,1/1/20,4401,4112,289,6.6
28145,1/1/20,14273,13680,593,4.2
28147,1/1/20,4772,4436,336,7
28149,1/1/20,19851,18754,1097,5.5
28151,1/1/20,16706,15393,1313,7.9
28153,1/1/20,7333,6853,480,6.5
28155,1/1/20,3896,3666,230,5.9
28157,1/1/20,2809,2503,306,10.9
28159,1/1/20,7338,6900,438,6
28161,1/1/20,4852,4597,255,5.3
28163,1/1/20,9225,8636,589,6.4
29001,1/1/20,10240,9794,446,4.4
29003,1/1/20,9798,9452,346,3.5
29005,1/1/20,2710,2610,100,3.7
29007,1/1/20,10759,10308,451,4.2
29009,1/1/20,15864,15056,808,5.1
29011,1/1/20,5335,5126,209,3.9
29013,1/1/20,7990,7605,385,4.8
29015,1/1/20,7253,6818,435,6
29017,1/1/20,5592,5318,274,4.9
29019,1/1/20,97338,94248,3090,3.2
29021,1/1/20,44618,42874,1744,3.9
29023,1/1/20,18095,17170,925,5.1
29025,1/1/20,4416,4243,173,3.9
29027,1/1/20,21452,20634,818,3.8
29029,1/1/20,17850,16492,1358,7.6
29031,1/1/20,41213,39747,1466,3.6
29033,1/1/20,4872,4684,188,3.9
29035,1/1/20,2569,2411,158,6.2
29037,1/1/20,55160,52948,2212,4
29039,1/1/20,5875,5615,260,4.4
29041,1/1/20,3802,3644,158,4.2
29043,1/1/20,45496,43784,1712,3.8
29045,1/1/20,3264,3103,161,4.9
29047,1/1/20,136418,131679,4739,3.5
29049,1/1/20,10783,10366,417,3.9
29051,1/1/20,39126,37783,1343,3.4
29053,1/1/20,7490,7173,317,4.2
29055,1/1/20,11035,10501,534,4.8
29057,1/1/20,3595,3447,148,4.1
29059,1/1/20,7170,6787,383,5.3
29061,1/1/20,4175,4002,173,4.1
29063,1/1/20,4881,4671,210,4.3
29065,1/1/20,6377,6067,310,4.9
29067,1/1/20,5475,4859,616,11.3
29069,1/1/20,11736,10959,777,6.6
29071,1/1/20,53547,51246,2301,4.3
29073,1/1/20,7699,7393,306,4
29075,1/1/20,3548,3433,115,3.2
29077,1/1/20,152665,147141,5524,3.6
29079,1/1/20,4448,4258,190,4.3
29081,1/1/20,3892,3700,192,4.9
29083,1/1/20,9791,9306,485,5
29085,1/1/20,3827,3610,217,5.7
29087,1/1/20,2601,2505,96,3.7
29089,1/1/20,4908,4709,199,4.1
29091,1/1/20,16978,16021,957,5.6
29093,1/1/20,3565,3348,217,6.1
29095,1/1/20,363222,347539,15683,4.3
29097,1/1/20,58193,56049,2144,3.7
29099,1/1/20,118858,113892,4966,4.2
29101,1/1/20,23487,22385,1102,4.7
29103,1/1/20,1803,1734,69,3.8
29105,1/1/20,17442,16174,1268,7.3
29107,1/1/20,16961,16256,705,4.2
29109,1/1/20,18343,17445,898,4.9
29111,1/1/20,5011,4808,203,4.1
29113,1/1/20,28983,27361,1622,5.6
29115,1/1/20,5188,4877,311,6
29117,1/1/20,7431,7161,270,3.6
29119,1/1/20,10931,10500,431,3.9
29121,1/1/20,7688,7352,336,4.4
29123,1/1/20,5543,5288,255,4.6
29125,1/1/20,3942,3774,168,4.3
29127,1/1/20,14539,13982,557,3.8
29129,1/1/20,1944,1858,86,4.4
29131,1/1/20,12318,11595,723,5.9
29133,1/1/20,5867,5587,280,4.8
29135,1/1/20,7375,7083,292,4
29137,1/1/20,3898,3693,205,5.3
29139,1/1/20,5842,5575,267,4.6
29141,1/1/20,8196,7670,526,6.4
29143,1/1/20,8440,8005,435,5.2
29145,1/1/20,27860,26753,1107,4
29147,1/1/20,10999,10586,413,3.8
29149,1/1/20,4129,3895,234,5.7
29151,1/1/20,7155,6932,223,3.1
29153,1/1/20,3439,3136,303,8.8
29155,1/1/20,6455,6059,396,6.1
29157,1/1/20,10077,9746,331,3.3
29159,1/1/20,21245,20356,889,4.2
29161,1/1/20,19922,19033,889,4.5
29163,1/1/20,7428,7068,360,4.8
29165,1/1/20,58694,56795,1899,3.2
29167,1/1/20,14782,14191,591,4
29169,1/1/20,14787,14056,731,4.9
29171,1/1/20,2306,2195,111,4.8
29173,1/1/20,5677,5451,226,4
29175,1/1/20,10442,9939,503,4.8
29177,1/1/20,11050,10572,478,4.3
29179,1/1/20,3031,2883,148,4.9
29181,1/1/20,5046,4768,278,5.5
29183,1/1/20,228350,219683,8667,3.8
29185,1/1/20,3831,3611,220,5.7
29186,1/1/20,9200,8850,350,3.8
29187,1/1/20,26833,25429,1404,5.2
29189,1/1/20,534164,513607,20557,3.8
29195,1/1/20,10731,10270,461,4.3
29197,1/1/20,1965,1860,105,5.3
29199,1/1/20,2451,2357,94,3.8
29201,1/1/20,20122,19258,864,4.3
29203,1/1/20,3251,3032,219,6.7
29205,1/1/20,3173,3029,144,4.5
29207,1/1/20,13263,12482,781,5.9
29209,1/1/20,13335,11923,1412,10.6
29211,1/1/20,2754,2616,138,5
29213,1/1/20,26278,23059,3219,12.2
29215,1/1/20,9218,8713,505,5.5
29217,1/1/20,9610,9215,395,4.1
29219,1/1/20,18251,17366,885,4.8
29221,1/1/20,10348,9715,633,6.1
29223,1/1/20,5296,5016,280,5.3
29225,1/1/20,17530,16744,786,4.5
29227,1/1/20,1188,1151,37,3.1
29229,1/1/20,7800,7205,595,7.6
29510,1/1/20,153083,146125,6958,4.5
30001,1/1/20,4981,4798,183,3.7
30003,1/1/20,4657,4318,339,7.3
30005,1/1/20,2495,2376,119,4.8
30007,1/1/20,2582,2442,140,5.4
30009,1/1/20,5519,5245,274,5
30011,1/1/20,614,599,15,2.4
30013,1/1/20,38343,36720,1623,4.2
30015,1/1/20,2401,2314,87,3.6
30017,1/1/20,6094,5839,255,4.2
30019,1/1/20,888,862,26,2.9
30021,1/1/20,4548,4398,150,3.3
30023,1/1/20,4989,4797,192,3.8
30025,1/1/20,1672,1634,38,2.3
30027,1/1/20,6040,5753,287,4.8
30029,1/1/20,47869,44736,3133,6.5
30031,1/1/20,69025,67266,1759,2.5
30033,1/1/20,720,693,27,3.8
30035,1/1/20,5445,4981,464,8.5
30037,1/1/20,365,347,18,4.9
30039,1/1/20,1747,1600,147,8.4
30041,1/1/20,7584,7275,309,4.1
30043,1/1/20,5700,5453,247,4.3
30045,1/1/20,964,918,46,4.8
30047,1/1/20,13195,12432,763,5.8
30049,1/1/20,35798,34450,1348,3.8
30051,1/1/20,933,902,31,3.3
30053,1/1/20,8098,7260,838,10.3
30055,1/1/20,930,908,22,2.4
30057,1/1/20,5524,5324,200,3.6
30059,1/1/20,995,955,40,4
30061,1/1/20,1770,1577,193,10.9
30063,1/1/20,64234,61591,2643,4.1
30065,1/1/20,2296,2151,145,6.3
30067,1/1/20,8618,8234,384,4.5
30069,1/1/20,273,263,10,3.7
30071,1/1/20,1866,1767,99,5.3
30073,1/1/20,2602,2503,99,3.8
30075,1/1/20,939,911,28,3
30077,1/1/20,2891,2762,129,4.5
30079,1/1/20,473,449,24,5.1
30081,1/1/20,20261,19217,1044,5.2
30083,1/1/20,5900,5712,188,3.2
30085,1/1/20,4461,4245,216,4.8
30087,1/1/20,3732,3546,186,5
30089,1/1/20,4811,4405,406,8.4
30091,1/1/20,1722,1666,56,3.3
30093,1/1/20,17201,16390,811,4.7
30095,1/1/20,5315,5114,201,3.8
30097,1/1/20,1794,1729,65,3.6
30099,1/1/20,2723,2586,137,5
30101,1/1/20,2079,2011,68,3.3
30103,1/1/20,331,323,8,2.4
30105,1/1/20,4022,3852,170,4.2
30107,1/1/20,775,728,47,6.1
30109,1/1/20,451,437,14,3.1
30111,1/1/20,81833,78700,3133,3.8
31001,1/1/20,16719,16119,600,3.6
31003,1/1/20,3611,3513,98,2.7
31005,1/1/20,234,222,12,5.1
31007,1/1/20,386,376,10,2.6
31009,1/1/20,275,259,16,5.8
31011,1/1/20,3019,2921,98,3.2
31013,1/1/20,5326,5152,174,3.3
31015,1/1/20,1108,1071,37,3.3
31017,1/1/20,1411,1370,41,2.9
31019,1/1/20,27716,26997,719,2.6
31021,1/1/20,3481,3338,143,4.1
31023,1/1/20,4495,4370,125,2.8
31025,1/1/20,13670,13168,502,3.7
31027,1/1/20,4507,4392,115,2.6
31029,1/1/20,2309,2264,45,1.9
31031,1/1/20,3407,3319,88,2.6
31033,1/1/20,4305,4153,152,3.5
31035,1/1/20,3310,3199,111,3.4
31037,1/1/20,5569,5413,156,2.8
31039,1/1/20,4730,4595,135,2.9
31041,1/1/20,6473,6326,147,2.3
31043,1/1/20,10799,10268,531,4.9
31045,1/1/20,4888,4769,119,2.4
31047,1/1/20,13131,12717,414,3.2
31049,1/1/20,965,934,31,3.2
31051,1/1/20,3058,2962,96,3.1
31053,1/1/20,19411,18805,606,3.1
31055,1/1/20,300008,289847,10161,3.4
31057,1/1/20,1195,1168,27,2.3
31059,1/1/20,3147,3067,80,2.5
31061,1/1/20,1469,1424,45,3.1
31063,1/1/20,1657,1594,63,3.8
31065,1/1/20,2546,2478,68,2.7
31067,1/1/20,10993,10591,402,3.7
31069,1/1/20,1098,1057,41,3.7
31071,1/1/20,1163,1134,29,2.5
31073,1/1/20,1105,1082,23,2.1
31075,1/1/20,440,430,10,2.3
31077,1/1/20,1244,1205,39,3.1
31079,1/1/20,32184,30500,1684,5.2
31081,1/1/20,4825,4632,193,4
31083,1/1/20,1770,1719,51,2.9
31085,1/1/20,643,623,20,3.1
31087,1/1/20,1268,1219,49,3.9
31089,1/1/20,5848,5700,148,2.5
31091,1/1/20,383,367,16,4.2
31093,1/1/20,3440,3247,193,5.6
31095,1/1/20,4172,4067,105,2.5
31097,1/1/20,2070,2000,70,3.4
31099,1/1/20,3814,3732,82,2.1
31101,1/1/20,4491,4339,152,3.4
31103,1/1/20,627,613,14,2.2
31105,1/1/20,2021,1962,59,2.9
31107,1/1/20,4671,4503,168,3.6
31109,1/1/20,177911,173050,4861,2.7
31111,1/1/20,18089,17446,643,3.6
31113,1/1/20,482,470,12,2.5
31115,1/1/20,420,400,20,4.8
31117,1/1/20,446,430,16,3.6
31119,1/1/20,19572,18976,596,3
31121,1/1/20,4061,3889,172,4.2
31123,1/1/20,2646,2552,94,3.6
31125,1/1/20,1999,1938,61,3.1
31127,1/1/20,3571,3440,131,3.7
31129,1/1/20,2464,2378,86,3.5
31131,1/1/20,8473,8209,264,3.1
31133,1/1/20,1497,1458,39,2.6
31135,1/1/20,1841,1802,39,2.1
31137,1/1/20,5020,4899,121,2.4
31139,1/1/20,4056,3945,111,2.7
31141,1/1/20,17630,17116,514,2.9
31143,1/1/20,2982,2894,88,3
31145,1/1/20,5835,5677,158,2.7
31147,1/1/20,4208,4061,147,3.5
31149,1/1/20,898,875,23,2.6
31151,1/1/20,7379,7125,254,3.4
31153,1/1/20,96611,93772,2839,2.9
31155,1/1/20,11272,10944,328,2.9
31157,1/1/20,17919,17270,649,3.6
31159,1/1/20,9064,8792,272,3
31161,1/1/20,2705,2633,72,2.7
31163,1/1/20,1701,1646,55,3.2
31165,1/1/20,757,737,20,2.6
31167,1/1/20,3512,3408,104,3
31169,1/1/20,2777,2709,68,2.4
31171,1/1/20,439,419,20,4.6
31173,1/1/20,3088,2965,123,4
31175,1/1/20,2138,2072,66,3.1
31177,1/1/20,11339,10993,346,3.1
31179,1/1/20,5810,5663,147,2.5
31181,1/1/20,1704,1645,59,3.5
31183,1/1/20,589,575,14,2.4
31185,1/1/20,7201,7019,182,2.5
32001,1/1/20,11385,10962,423,3.7
32003,1/1/20,1145940,1101158,44782,3.9
32005,1/1/20,23345,22409,936,4
32007,1/1/20,27050,26160,890,3.3
32009,1/1/20,473,455,18,3.8
32011,1/1/20,1153,1128,25,2.2
32013,1/1/20,8397,8130,267,3.2
32015,1/1/20,3271,3144,127,3.9
32017,1/1/20,2187,2105,82,3.7
32019,1/1/20,23491,22320,1171,5
32021,1/1/20,2010,1927,83,4.1
32023,1/1/20,17843,16953,890,5
32027,1/1/20,2630,2525,105,4
32029,1/1/20,2053,1974,79,3.8
32031,1/1/20,258405,249635,8770,3.4
32033,1/1/20,4687,4547,140,3
32510,1/1/20,26581,25490,1091,4.1
33001,1/1/20,31233,30241,992,3.2
33003,1/1/20,23990,23234,756,3.2
33005,1/1/20,41022,39721,1301,3.2
33007,1/1/20,14859,14245,614,4.1
33009,1/1/20,50136,48854,1282,2.6
33011,1/1/20,246879,239107,7772,3.1
33013,1/1/20,84928,82668,2260,2.7
33015,1/1/20,190571,184322,6249,3.3
33017,1/1/20,74161,72140,2021,2.7
33019,1/1/20,23212,22551,661,2.8
34001,1/1/20,120234,112050,8184,6.8
34003,1/1/20,490131,472964,17167,3.5
34005,1/1/20,233388,224376,9012,3.9
34007,1/1/20,257095,244660,12435,4.8
34009,1/1/20,41701,36016,5685,13.6
34011,1/1/20,65969,61178,4791,7.3
34013,1/1/20,375637,355821,19816,5.3
34015,1/1/20,152227,145250,6977,4.6
34017,1/1/20,367370,353318,14052,3.8
34019,1/1/20,65304,63030,2274,3.5
34021,1/1/20,206303,198355,7948,3.9
34023,1/1/20,444908,428529,16379,3.7
34025,1/1/20,333155,320031,13124,3.9
34027,1/1/20,260660,251812,8848,3.4
34029,1/1/20,280055,266544,13511,4.8
34031,1/1/20,247563,234262,13301,5.4
34033,1/1/20,29369,27543,1826,6.2
34035,1/1/20,174069,167772,6297,3.6
34037,1/1/20,75368,71895,3473,4.6
34039,1/1/20,281661,268896,12765,4.5
34041,1/1/20,56768,54297,2471,4.4
35001,1/1/20,335089,320161,14928,4.5
35003,1/1/20,1151,1059,92,8
35005,1/1/20,27445,26072,1373,5
35006,1/1/20,9035,8449,586,6.5
35007,1/1/20,5385,5141,244,4.5
35009,1/1/20,21654,20757,897,4.1
35011,1/1/20,708,676,32,4.5
35013,1/1/20,97381,91429,5952,6.1
35015,1/1/20,36339,35235,1104,3
35017,1/1/20,12125,11513,612,5
35019,1/1/20,1459,1385,74,5.1
35021,1/1/20,284,272,12,4.2
35023,1/1/20,2004,1912,92,4.6
35025,1/1/20,32611,31270,1341,4.1
35027,1/1/20,8739,8304,435,5
35028,1/1/20,9471,9159,312,3.3
35029,1/1/20,9691,8137,1554,16
35031,1/1/20,24431,22704,1727,7.1
35033,1/1/20,2094,1943,151,7.2
35035,1/1/20,25124,23867,1257,5
35037,1/1/20,3128,2965,163,5.2
35039,1/1/20,16596,15665,931,5.6
35041,1/1/20,7832,7479,353,4.5
35043,1/1/20,66332,63159,3173,4.8
35045,1/1/20,51455,48262,3193,6.2
35047,1/1/20,10873,10228,645,5.9
35049,1/1/20,76265,73235,3030,4
35051,1/1/20,3783,3496,287,7.6
35053,1/1/20,6309,5942,367,5.8
35055,1/1/20,15748,14836,912,5.8
35057,1/1/20,5427,5042,385,7.1
35059,1/1/20,1666,1595,71,4.3
35061,1/1/20,30658,29043,1615,5.3
36001,1/1/20,159663,153480,6183,3.9
36003,1/1/20,19797,18462,1335,6.7
36005,1/1/20,591286,562402,28884,4.9
36007,1/1/20,84055,79265,4790,5.7
36009,1/1/20,35247,32951,2296,6.5
36011,1/1/20,36114,34199,1915,5.3
36013,1/1/20,54780,51554,3226,5.9
36015,1/1/20,35748,33977,1771,5
36017,1/1/20,22448,21206,1242,5.5
36019,1/1/20,36754,34694,2060,5.6
36021,1/1/20,31222,30031,1191,3.8
36023,1/1/20,23144,21624,1520,6.6
36025,1/1/20,19148,18079,1069,5.6
36027,1/1/20,145436,139650,5786,4
36029,1/1/20,445150,423222,21928,4.9
36031,1/1/20,17719,16654,1065,6
36033,1/1/20,19923,18746,1177,5.9
36035,1/1/20,23037,21690,1347,5.8
36037,1/1/20,29995,28475,1520,5.1
36039,1/1/20,21318,20231,1087,5.1
36041,1/1/20,2155,1965,190,8.8
36043,1/1/20,28285,26547,1738,6.1
36045,1/1/20,44224,40903,3321,7.5
36047,1/1/20,1185568,1142694,42874,3.6
36049,1/1/20,12160,11242,918,7.5
36051,1/1/20,31246,29616,1630,5.2
36053,1/1/20,33351,31513,1838,5.5
36055,1/1/20,364121,347586,16535,4.5
36057,1/1/20,22764,21343,1421,6.2
36059,1/1/20,714487,688512,25975,3.6
36061,1/1/20,902956,874458,28498,3.2
36063,1/1/20,100143,94092,6051,6
36065,1/1/20,101635,96682,4953,4.9
36067,1/1/20,222687,212912,9775,4.4
36069,1/1/20,56116,53489,2627,4.7
36071,1/1/20,185860,178171,7689,4.1
36073,1/1/20,17906,16869,1037,5.8
36075,1/1/20,53988,50355,3633,6.7
36077,1/1/20,27920,26376,1544,5.5
36079,1/1/20,51691,49600,2091,4
36081,1/1/20,1128582,1093585,34997,3.1
36083,1/1/20,82456,78958,3498,4.2
36085,1/1/20,220077,212504,7573,3.4
36087,1/1/20,155635,149813,5822,3.7
36089,1/1/20,43687,40810,2877,6.6
36091,1/1/20,120821,116284,4537,3.8
36093,1/1/20,77164,73967,3197,4.1
36095,1/1/20,15076,14151,925,6.1
36097,1/1/20,8073,7539,534,6.6
36099,1/1/20,16313,15501,812,5
36101,1/1/20,43375,40955,2420,5.6
36103,1/1/20,787677,754715,32962,4.2
36105,1/1/20,37082,35346,1736,4.7
36107,1/1/20,22878,21698,1180,5.2
36109,1/1/20,48698,46835,1863,3.8
36111,1/1/20,88437,84706,3731,4.2
36113,1/1/20,31369,29531,1838,5.9
36115,1/1/20,27902,26483,1419,5.1
36117,1/1/20,44597,42342,2255,5.1
36119,1/1/20,485998,466524,19474,4
36121,1/1/20,18455,17292,1163,6.3
36123,1/1/20,12125,11529,596,4.9
37001,1/1/20,82489,79307,3182,3.9
37003,1/1/20,18185,17588,597,3.3
37005,1/1/20,4351,4109,242,5.6
37007,1/1/20,11061,10528,533,4.8
37009,1/1/20,12889,12347,542,4.2
37011,1/1/20,7242,6932,310,4.3
37013,1/1/20,19445,18500,945,4.9
37015,1/1/20,7888,7449,439,5.6
37017,1/1/20,14806,14011,795,5.4
37019,1/1/20,53137,49899,3238,6.1
37021,1/1/20,141488,136976,4512,3.2
37023,1/1/20,41396,39796,1600,3.9
37025,1/1/20,110655,106548,4107,3.7
37027,1/1/20,36828,35363,1465,4
37029,1/1/20,4649,4449,200,4.3
37031,1/1/20,31300,29835,1465,4.7
37033,1/1/20,9979,9507,472,4.7
37035,1/1/20,79609,76630,2979,3.7
37037,1/1/20,36241,34980,1261,3.5
37039,1/1/20,11028,10482,546,5
37041,1/1/20,5563,5304,259,4.7
37043,1/1/20,4117,3912,205,5
37045,1/1/20,49145,46976,2169,4.4
37047,1/1/20,23129,21851,1278,5.5
37049,1/1/20,41953,40209,1744,4.2
37051,1/1/20,128035,121164,6871,5.4
37053,1/1/20,14038,13456,582,4.1
37055,1/1/20,17690,16193,1497,8.5
37057,1/1/20,81777,78545,3232,4
37059,1/1/20,20888,20131,757,3.6
37061,1/1/20,26004,24897,1107,4.3
37063,1/1/20,173514,167530,5984,3.4
37065,1/1/20,21472,20222,1250,5.8
37067,1/1/20,189471,182136,7335,3.9
37069,1/1/20,31784,30483,1301,4.1
37071,1/1/20,112853,108128,4725,4.2
37073,1/1/20,5332,5104,228,4.3
37075,1/1/20,3116,2878,238,7.6
37077,1/1/20,30368,29288,1080,3.6
37079,1/1/20,9668,9299,369,3.8
37081,1/1/20,264044,252825,11219,4.2
37083,1/1/20,20563,19245,1318,6.4
37085,1/1/20,53710,51269,2441,4.5
37087,1/1/20,30249,29108,1141,3.8
37089,1/1/20,55583,53643,1940,3.5
37091,1/1/20,9187,8687,500,5.4
37093,1/1/20,20230,19157,1073,5.3
37095,1/1/20,1826,1563,263,14.4
37097,1/1/20,90901,87420,3481,3.8
37099,1/1/20,19219,18352,867,4.5
37101,1/1/20,100749,97002,3747,3.7
37103,1/1/20,4456,4287,169,3.8
37105,1/1/20,26011,24839,1172,4.5
37107,1/1/20,28040,26899,1141,4.1
37109,1/1/20,44174,42510,1664,3.8
37111,1/1/20,20489,19616,873,4.3
37113,1/1/20,15181,14496,685,4.5
37115,1/1/20,10253,9865,388,3.8
37117,1/1/20,9099,8631,468,5.1
37119,1/1/20,630139,606620,23519,3.7
37121,1/1/20,5946,5625,321,5.4
37123,1/1/20,11612,11127,485,4.2
37125,1/1/20,42602,40907,1695,4
37127,1/1/20,43687,41541,2146,4.9
37129,1/1/20,124946,120316,4630,3.7
37131,1/1/20,7867,7376,491,6.2
37133,1/1/20,66118,63010,3108,4.7
37135,1/1/20,79865,77276,2589,3.2
37137,1/1/20,5399,5175,224,4.1
37139,1/1/20,16691,15845,846,5.1
37141,1/1/20,29248,28004,1244,4.3
37143,1/1/20,4990,4722,268,5.4
37145,1/1/20,18761,17937,824,4.4
37147,1/1/20,90280,86417,3863,4.3
37149,1/1/20,8975,8619,356,4
37151,1/1/20,66775,64133,2642,4
37153,1/1/20,16794,15845,949,5.7
37155,1/1/20,50981,48109,2872,5.6
37157,1/1/20,40509,38586,1923,4.7
37159,1/1/20,67358,64425,2933,4.4
37161,1/1/20,25439,24035,1404,5.5
37163,1/1/20,30122,28884,1238,4.1
37165,1/1/20,11764,10912,852,7.2
37167,1/1/20,30524,29293,1231,4
37169,1/1/20,21979,21104,875,4
37171,1/1/20,34023,32650,1373,4
37173,1/1/20,6649,6288,361,5.4
37175,1/1/20,14456,13891,565,3.9
37177,1/1/20,1342,1226,116,8.6
37179,1/1/20,125629,121206,4423,3.5
37181,1/1/20,17469,16394,1075,6.2
37183,1/1/20,604293,583593,20700,3.4
37185,1/1/20,6680,6267,413,6.2
37187,1/1/20,4427,4115,312,7
37189,1/1/20,29219,28226,993,3.4
37191,1/1/20,52599,50326,2273,4.3
37193,1/1/20,29280,27985,1295,4.4
37195,1/1/20,35014,32954,2060,5.9
37197,1/1/20,17989,17312,677,3.8
37199,1/1/20,8431,8062,369,4.4
38001,1/1/20,1046,1018,28,2.7
38003,1/1/20,5095,4952,143,2.8
38005,1/1/20,2301,2194,107,4.7
38007,1/1/20,352,340,12,3.4
38009,1/1/20,2828,2722,106,3.7
38011,1/1/20,1675,1642,33,2
38013,1/1/20,1039,1005,34,3.3
38015,1/1/20,49079,47676,1403,2.9
38017,1/1/20,102111,99549,2562,2.5
38019,1/1/20,1837,1780,57,3.1
38021,1/1/20,2230,2185,45,2
38023,1/1/20,1344,1323,21,1.6
38025,1/1/20,3123,3075,48,1.5
38027,1/1/20,1179,1121,58,4.9
38029,1/1/20,1417,1332,85,6
38031,1/1/20,1448,1400,48,3.3
38033,1/1/20,804,790,14,1.7
38035,1/1/20,37330,36498,832,2.2
38037,1/1/20,1181,1149,32,2.7
38039,1/1/20,986,963,23,2.3
38041,1/1/20,1333,1289,44,3.3
38043,1/1/20,1240,1167,73,5.9
38045,1/1/20,1973,1930,43,2.2
38047,1/1/20,870,842,28,3.2
38049,1/1/20,2988,2842,146,4.9
38051,1/1/20,1083,1048,35,3.2
38053,1/1/20,10274,10065,209,2
38055,1/1/20,4530,4333,197,4.3
38057,1/1/20,3330,3151,179,5.4
38059,1/1/20,16216,15581,635,3.9
38061,1/1/20,7343,7225,118,1.6
38063,1/1/20,1342,1292,50,3.7
38065,1/1/20,858,817,41,4.8
38067,1/1/20,3213,3074,139,4.3
38069,1/1/20,1658,1597,61,3.7
38071,1/1/20,5401,5217,184,3.4
38073,1/1/20,2787,2715,72,2.6
38075,1/1/20,1203,1161,42,3.5
38077,1/1/20,8333,8121,212,2.5
38079,1/1/20,4530,4138,392,8.7
38081,1/1/20,2623,2576,47,1.8
38083,1/1/20,656,606,50,7.6
38085,1/1/20,1201,1170,31,2.6
38087,1/1/20,389,380,9,2.3
38089,1/1/20,18103,17651,452,2.5
38091,1/1/20,942,925,17,1.8
38093,1/1/20,10049,9776,273,2.7
38095,1/1/20,1030,1001,29,2.8
38097,1/1/20,4304,4184,120,2.8
38099,1/1/20,4940,4766,174,3.5
38101,1/1/20,30849,29918,931,3
38103,1/1/20,1837,1745,92,5
38105,1/1/20,23747,23259,488,2.1
39001,1/1/20,10707,9664,1043,9.7
39003,1/1/20,47775,45264,2511,5.3
39005,1/1/20,26690,25280,1410,5.3
39007,1/1/20,44205,41303,2902,6.6
39009,1/1/20,27326,25515,1811,6.6
39011,1/1/20,24870,23945,925,3.7
39013,1/1/20,29934,27393,2541,8.5
39015,1/1/20,19814,18481,1333,6.7
39017,1/1/20,195694,186889,8805,4.5
39019,1/1/20,13012,12107,905,7
39021,1/1/20,20002,19034,968,4.8
39023,1/1/20,63519,59921,3598,5.7
39025,1/1/20,107187,102288,4899,4.6
39027,1/1/20,17940,16882,1058,5.9
39029,1/1/20,47218,44229,2989,6.3
39031,1/1/20,14189,13135,1054,7.4
39033,1/1/20,18087,17030,1057,5.8
39035,1/1/20,605754,577341,28413,4.7
39037,1/1/20,25659,24405,1254,4.9
39039,1/1/20,17934,17050,884,4.9
39041,1/1/20,110856,106821,4035,3.6
39043,1/1/20,35359,32914,2445,6.9
39045,1/1/20,78719,75109,3610,4.6
39047,1/1/20,13873,13199,674,4.9
39049,1/1/20,701548,673237,28311,4
39051,1/1/20,22470,21149,1321,5.9
39053,1/1/20,12299,11362,937,7.6
39055,1/1/20,48585,46517,2068,4.3
39057,1/1/20,83528,79850,3678,4.4
39059,1/1/20,18522,17040,1482,8
39061,1/1/20,416541,398335,18206,4.4
39063,1/1/20,41614,40027,1587,3.8
39065,1/1/20,13555,12832,723,5.3
39067,1/1/20,6642,6114,528,7.9
39069,1/1/20,13129,12276,853,6.5
39071,1/1/20,17037,15869,1168,6.9
39073,1/1/20,13302,12472,830,6.2
39075,1/1/20,20488,19699,789,3.9
39077,1/1/20,27614,25215,2399,8.7
39079,1/1/20,12741,11637,1104,8.7
39081,1/1/20,27445,25359,2086,7.6
39083,1/1/20,31228,29665,1563,5
39085,1/1/20,125299,119656,5643,4.5
39087,1/1/20,23842,22296,1546,6.5
39089,1/1/20,91259,87071,4188,4.6
39091,1/1/20,22883,21813,1070,4.7
39093,1/1/20,152588,144713,7875,5.2
39095,1/1/20,208653,197004,11649,5.6
39097,1/1/20,20970,20082,888,4.2
39099,1/1/20,101692,94675,7017,6.9
39101,1/1/20,28179,26791,1388,4.9
39103,1/1/20,96538,92638,3900,4
39105,1/1/20,9000,8125,875,9.7
39107,1/1/20,23036,22276,760,3.3
39109,1/1/20,54479,51977,2502,4.6
39111,1/1/20,5385,4724,661,12.3
39113,1/1/20,253462,241186,12276,4.8
39115,1/1/20,6763,6098,665,9.8
39117,1/1/20,17071,16098,973,5.7
39119,1/1/20,39501,36791,2710,6.9
39121,1/1/20,4692,4247,445,9.5
39123,1/1/20,20078,18271,1807,9
39125,1/1/20,8492,8085,407,4.8
39127,1/1/20,16261,15087,1174,7.2
39129,1/1/20,26758,25386,1372,5.1
39131,1/1/20,10796,9898,898,8.3
39133,1/1/20,86648,81940,4708,5.4
39135,1/1/20,21005,19976,1029,4.9
39137,1/1/20,18546,17755,791,4.3
39139,1/1/20,51680,48703,2977,5.8
39141,1/1/20,35452,33406,2046,5.8
39143,1/1/20,30158,28401,1757,5.8
39145,1/1/20,28876,26506,2370,8.2
39147,1/1/20,27080,25649,1431,5.3
39149,1/1/20,23787,22727,1060,4.5
39151,1/1/20,185229,174499,10730,5.8
39153,1/1/20,269755,255532,14223,5.3
39155,1/1/20,85736,79314,6422,7.5
39157,1/1/20,44563,41931,2632,5.9
39159,1/1/20,29107,27982,1125,3.9
39161,1/1/20,15066,14421,645,4.3
39163,1/1/20,5611,5134,477,8.5
39165,1/1/20,119369,114422,4947,4.1
39167,1/1/20,27425,25411,2014,7.3
39169,1/1/20,62401,59855,2546,4.1
39171,1/1/20,18803,18005,798,4.2
39173,1/1/20,70591,67386,3205,4.5
39175,1/1/20,12969,12441,528,4.1
40001,1/1/20,8027,7680,347,4.3
40003,1/1/20,2848,2786,62,2.2
40005,1/1/20,4964,4714,250,5
40007,1/1/20,2886,2833,53,1.8
40009,1/1/20,9848,9403,445,4.5
40011,1/1/20,4690,4579,111,2.4
40013,1/1/20,21313,20679,634,3
40015,1/1/20,11776,11337,439,3.7
40017,1/1/20,73926,71743,2183,3
40019,1/1/20,21260,20503,757,3.6
40021,1/1/20,18692,17967,725,3.9
40023,1/1/20,5478,5191,287,5.2
40025,1/1/20,1342,1320,22,1.6
40027,1/1/20,141807,138001,3806,2.7
40029,1/1/20,2506,2400,106,4.2
40031,1/1/20,48164,46595,1569,3.3
40033,1/1/20,2727,2651,76,2.8
40035,1/1/20,5851,5621,230,3.9
40037,1/1/20,31378,30211,1167,3.7
40039,1/1/20,15826,15363,463,2.9
40041,1/1/20,17955,17282,673,3.7
40043,1/1/20,2902,2839,63,2.2
40045,1/1/20,2143,2083,60,2.8
40047,1/1/20,26628,25778,850,3.2
40049,1/1/20,12505,12038,467,3.7
40051,1/1/20,26483,25567,916,3.5
40053,1/1/20,2619,2557,62,2.4
40055,1/1/20,1814,1740,74,4.1
40057,1/1/20,1166,1135,31,2.7
40059,1/1/20,1751,1702,49,2.8
40061,1/1/20,4260,4013,247,5.8
40063,1/1/20,5333,5046,287,5.4
40065,1/1/20,10717,10404,313,2.9
40067,1/1/20,2540,2448,92,3.6
40069,1/1/20,3297,3120,177,5.4
40071,1/1/20,17963,17245,718,4
40073,1/1/20,9180,8985,195,2.1
40075,1/1/20,3479,3365,114,3.3
40077,1/1/20,3097,2872,225,7.3
40079,1/1/20,18946,18075,871,4.6
40081,1/1/20,15737,15177,560,3.6
40083,1/1/20,21996,21353,643,2.9
40085,1/1/20,6169,6023,146,2.4
40087,1/1/20,19597,19042,555,2.8
40089,1/1/20,14787,13926,861,5.8
40091,1/1/20,7182,6701,481,6.7
40093,1/1/20,3866,3781,85,2.2
40095,1/1/20,6893,6652,241,3.5
40097,1/1/20,19298,18701,597,3.1
40099,1/1/20,6298,6092,206,3.3
40101,1/1/20,29630,28520,1110,3.7
40103,1/1/20,5604,5458,146,2.6
40105,1/1/20,4577,4429,148,3.2
40107,1/1/20,4609,4375,234,5.1
40109,1/1/20,381970,370694,11276,3
40111,1/1/20,15565,14823,742,4.8
40113,1/1/20,20498,19747,751,3.7
40115,1/1/20,13925,13491,434,3.1
40117,1/1/20,7313,7028,285,3.9
40119,1/1/20,37160,36103,1057,2.8
40121,1/1/20,16970,16209,761,4.5
40123,1/1/20,19305,18737,568,2.9
40125,1/1/20,32241,31100,1141,3.5
40127,1/1/20,4317,4079,238,5.5
40129,1/1/20,1842,1782,60,3.3
40131,1/1/20,44693,43322,1371,3.1
40133,1/1/20,9481,9010,471,5
40135,1/1/20,16148,15456,692,4.3
40137,1/1/20,18458,17595,863,4.7
40139,1/1/20,11618,11386,232,2
40141,1/1/20,2961,2861,100,3.4
40143,1/1/20,320546,310610,9936,3.1
40145,1/1/20,37677,36473,1204,3.2
40147,1/1/20,21969,21258,711,3.2
40149,1/1/20,5176,4966,210,4.1
40151,1/1/20,4575,4486,89,1.9
40153,1/1/20,8816,8496,320,3.6
41001,1/1/20,7010,6601,409,5.8
41003,1/1/20,48517,47268,1249,2.6
41005,1/1/20,218686,211458,7228,3.3
41007,1/1/20,18656,17888,768,4.1
41009,1/1/20,24516,23353,1163,4.7
41011,1/1/20,25770,24517,1253,4.9
41013,1/1/20,9516,8909,607,6.4
41015,1/1/20,8617,8108,509,5.9
41017,1/1/20,95424,91416,4008,4.2
41019,1/1/20,46206,43840,2366,5.1
41021,1/1/20,886,840,46,5.2
41023,1/1/20,3062,2773,289,9.4
41025,1/1/20,3453,3221,232,6.7
41027,1/1/20,13683,13215,468,3.4
41029,1/1/20,101275,96756,4519,4.5
41031,1/1/20,9973,9373,600,6
41033,1/1/20,35505,33639,1866,5.3
41035,1/1/20,28671,26319,2352,8.2
41037,1/1/20,3474,3282,192,5.5
41039,1/1/20,181113,174094,7019,3.9
41041,1/1/20,20081,19150,931,4.6
41043,1/1/20,58702,56167,2535,4.3
41045,1/1/20,12013,11461,552,4.6
41047,1/1/20,159628,153121,6507,4.1
41049,1/1/20,5518,5255,263,4.8
41051,1/1/20,454571,440011,14560,3.2
41053,1/1/20,39448,37867,1581,4
41055,1/1/20,937,888,49,5.2
41057,1/1/20,11572,11083,489,4.2
41059,1/1/20,35585,33625,1960,5.5
41061,1/1/20,11744,11053,691,5.9
41063,1/1/20,3233,3011,222,6.9
41065,1/1/20,12230,11634,596,4.9
41067,1/1/20,324407,314939,9468,2.9
41069,1/1/20,729,698,31,4.3
41071,1/1/20,54483,52706,1777,3.3
42001,1/1/20,54601,52465,2136,3.9
42003,1/1/20,650897,620001,30896,4.7
42005,1/1/20,32816,30423,2393,7.3
42007,1/1/20,84680,79921,4759,5.6
42009,1/1/20,23787,22234,1553,6.5
42011,1/1/20,216819,205959,10860,5
42013,1/1/20,59597,56394,3203,5.4
42015,1/1/20,28876,27251,1625,5.6
42017,1/1/20,346279,330948,15331,4.4
42019,1/1/20,100402,95457,4945,4.9
42021,1/1/20,58186,54389,3797,6.5
42023,1/1/20,2032,1866,166,8.2
42025,1/1/20,32470,30484,1986,6.1
42027,1/1/20,81792,78700,3092,3.8
42029,1/1/20,284708,274602,10106,3.5
42031,1/1/20,17037,15865,1172,6.9
42033,1/1/20,36694,34068,2626,7.2
42035,1/1/20,18282,17012,1270,6.9
42037,1/1/20,33490,31425,2065,6.2
42039,1/1/20,38371,36064,2307,6
42041,1/1/20,133181,128139,5042,3.8
42043,1/1/20,145725,139224,6501,4.5
42045,1/1/20,300975,287606,13369,4.4
42047,1/1/20,15579,14507,1072,6.9
42049,1/1/20,128958,121453,7505,5.8
42051,1/1/20,58177,53511,4666,8
42053,1/1/20,1805,1632,173,9.6
42055,1/1/20,78824,75317,3507,4.4
42057,1/1/20,8153,7631,522,6.4
42059,1/1/20,16758,15653,1105,6.6
42061,1/1/20,19859,18196,1663,8.4
42063,1/1/20,38754,36162,2592,6.7
42065,1/1/20,20703,19365,1338,6.5
42067,1/1/20,12718,12022,696,5.5
42069,1/1/20,105566,99496,6070,5.7
42071,1/1/20,284386,273058,11328,4
42073,1/1/20,40909,37869,3040,7.4
42075,1/1/20,72389,69122,3267,4.5
42077,1/1/20,194208,184652,9556,4.9
42079,1/1/20,158558,147873,10685,6.7
42081,1/1/20,57621,54151,3470,6
42083,1/1/20,17424,16190,1234,7.1
42085,1/1/20,48628,45707,2921,6
42087,1/1/20,21184,19970,1214,5.7
42089,1/1/20,84648,79346,5302,6.3
42091,1/1/20,456960,439150,17810,3.9
42093,1/1/20,9031,8647,384,4.3
42095,1/1/20,162920,154629,8291,5.1
42097,1/1/20,42319,39347,2972,7
42099,1/1/20,24659,23530,1129,4.6
42101,1/1/20,733945,690051,43894,6
42103,1/1/20,25538,23820,1718,6.7
42105,1/1/20,7257,6589,668,9.2
42107,1/1/20,66954,62868,4086,6.1
42109,1/1/20,19877,18661,1216,6.1
42111,1/1/20,34382,31933,2449,7.1
42113,1/1/20,2644,2442,202,7.6
42115,1/1/20,20556,19338,1218,5.9
42117,1/1/20,19092,17784,1308,6.9
42119,1/1/20,19401,18498,903,4.7
42121,1/1/20,22356,20940,1416,6.3
42123,1/1/20,18898,17830,1068,5.7
42125,1/1/20,107865,101857,6008,5.6
42127,1/1/20,22222,20704,1518,6.8
42129,1/1/20,182443,172285,10158,5.6
42131,1/1/20,13686,12806,880,6.4
42133,1/1/20,237799,227405,10394,4.4
44001,1/1/20,26011,25123,888,3.4
44003,1/1/20,90878,87458,3420,3.8
44005,1/1/20,44548,42729,1819,4.1
44007,1/1/20,325518,311654,13864,4.3
44009,1/1/20,68922,66359,2563,3.7
45001,1/1/20,10086,9721,365,3.6
45003,1/1/20,75364,73133,2231,3
45005,1/1/20,2698,2516,182,6.7
45007,1/1/20,91579,89048,2531,2.8
45009,1/1/20,4990,4711,279,5.6
45011,1/1/20,8264,7887,377,4.6
45013,1/1/20,78253,76187,2066,2.6
45015,1/1/20,105018,102326,2692,2.6
45017,1/1/20,6649,6419,230,3.5
45019,1/1/20,213947,209054,4893,2.3
45021,1/1/20,25115,24275,840,3.3
45023,1/1/20,13575,12990,585,4.3
45025,1/1/20,22192,21507,685,3.1
45027,1/1/20,12759,12240,519,4.1
45029,1/1/20,16847,16303,544,3.2
45031,1/1/20,30322,29287,1035,3.4
45033,1/1/20,13310,12757,553,4.2
45035,1/1/20,78892,76922,1970,2.5
45037,1/1/20,10821,10501,320,3
45039,1/1/20,9710,9257,453,4.7
45041,1/1/20,66852,64848,2004,3
45043,1/1/20,25539,24456,1083,4.2
45045,1/1/20,255817,249477,6340,2.5
45047,1/1/20,31397,30366,1031,3.3
45049,1/1/20,8426,8195,231,2.7
45051,1/1/20,145671,139268,6403,4.4
45053,1/1/20,12831,12518,313,2.4
45055,1/1/20,29582,28625,957,3.2
45057,1/1/20,41771,40323,1448,3.5
45059,1/1/20,30354,29419,935,3.1
45061,1/1/20,6701,6365,336,5
45063,1/1/20,151226,147730,3496,2.3
45065,1/1/20,3422,3287,135,3.9
45067,1/1/20,12890,12333,557,4.3
45069,1/1/20,9282,8869,413,4.4
45071,1/1/20,19187,18654,533,2.8
45073,1/1/20,35186,34203,983,2.8
45075,1/1/20,35411,33662,1749,4.9
45077,1/1/20,57714,56074,1640,2.8
45079,1/1/20,200109,194552,5557,2.8
45081,1/1/20,8998,8757,241,2.7
45083,1/1/20,154278,150163,4115,2.7
45085,1/1/20,44265,42694,1571,3.5
45087,1/1/20,11742,11327,415,3.5
45089,1/1/20,12081,11479,602,5
45091,1/1/20,141827,137886,3941,2.8
46003,1/1/20,1477,1431,46,3.1
46005,1/1/20,9483,9151,332,3.5
46007,1/1/20,1083,1020,63,5.8
46009,1/1/20,2836,2728,108,3.8
46011,1/1/20,19069,18351,718,3.8
46013,1/1/20,20616,19886,730,3.5
46015,1/1/20,2373,2287,86,3.6
46017,1/1/20,665,624,41,6.2
46019,1/1/20,4978,4776,202,4.1
46021,1/1/20,763,731,32,4.2
46023,1/1/20,3661,3517,144,3.9
46025,1/1/20,1902,1807,95,5
46027,1/1/20,7614,7355,259,3.4
46029,1/1/20,15505,14963,542,3.5
46031,1/1/20,1352,1281,71,5.3
46033,1/1/20,3984,3764,220,5.5
46035,1/1/20,10984,10608,376,3.4
46037,1/1/20,2746,2570,176,6.4
46039,1/1/20,2121,1950,171,8.1
46041,1/1/20,2177,2026,151,6.9
46043,1/1/20,1574,1518,56,3.6
46045,1/1/20,2013,1944,69,3.4
46047,1/1/20,2868,2721,147,5.1
46049,1/1/20,1028,989,39,3.8
46051,1/1/20,4428,4196,232,5.2
46053,1/1/20,1984,1899,85,4.3
46055,1/1/20,1036,1002,34,3.3
46057,1/1/20,3285,3160,125,3.8
46059,1/1/20,1756,1703,53,3
46061,1/1/20,1745,1635,110,6.3
46063,1/1/20,717,697,20,2.8
46065,1/1/20,9984,9664,320,3.2
46067,1/1/20,3622,3475,147,4.1
46069,1/1/20,687,660,27,3.9
46071,1/1/20,1134,1059,75,6.6
46073,1/1/20,1084,1059,25,2.3
46075,1/1/20,506,487,19,3.8
46077,1/1/20,2598,2503,95,3.7
46079,1/1/20,6585,6336,249,3.8
46081,1/1/20,13270,12835,435,3.3
46083,1/1/20,34643,33635,1008,2.9
46085,1/1/20,1618,1532,86,5.3
46087,1/1/20,3073,2966,107,3.5
46089,1/1/20,1008,955,53,5.3
46091,1/1/20,2322,2205,117,5
46093,1/1/20,14010,13458,552,3.9
46095,1/1/20,739,688,51,6.9
46097,1/1/20,1168,1131,37,3.2
46099,1/1/20,113605,109661,3944,3.5
46101,1/1/20,3955,3806,149,3.8
46102,1/1/20,3550,3225,325,9.2
46103,1/1/20,56372,54234,2138,3.8
46105,1/1/20,1393,1351,42,3
46107,1/1/20,986,950,36,3.7
46109,1/1/20,4873,4570,303,6.2
46111,1/1/20,1144,1102,42,3.7
46115,1/1/20,3137,2993,144,4.6
46117,1/1/20,1847,1771,76,4.1
46119,1/1/20,786,762,24,3.1
46121,1/1/20,3149,2929,220,7
46123,1/1/20,3005,2908,97,3.2
46125,1/1/20,4708,4511,197,4.2
46127,1/1/20,8541,8217,324,3.8
46129,1/1/20,2109,1958,151,7.2
46135,1/1/20,11875,11497,378,3.2
46137,1/1/20,908,871,37,4.1
47001,1/1/20,34642,33332,1310,3.8
47003,1/1/20,21029,20197,832,4
47005,1/1/20,6951,6566,385,5.5
47007,1/1/20,4394,4135,259,5.9
47009,1/1/20,63860,61444,2416,3.8
47011,1/1/20,53419,51425,1994,3.7
47013,1/1/20,14926,14144,782,5.2
47015,1/1/20,6699,6486,213,3.2
47017,1/1/20,12087,11390,697,5.8
47019,1/1/20,23926,22840,1086,4.5
47021,1/1/20,22195,21556,639,2.9
47023,1/1/20,8547,8243,304,3.6
47025,1/1/20,13041,12387,654,5
47027,1/1/20,2763,2562,201,7.3
47029,1/1/20,15111,14106,1005,6.7
47031,1/1/20,25794,24789,1005,3.9
47033,1/1/20,7106,6785,321,4.5
47035,1/1/20,23906,22344,1562,6.5
47037,1/1/20,409615,398635,10980,2.7
47039,1/1/20,4646,4329,317,6.8
47041,1/1/20,7758,7388,370,4.8
47043,1/1/20,27450,26569,881,3.2
47045,1/1/20,16506,15602,904,5.5
47047,1/1/20,19240,18493,747,3.9
47049,1/1/20,7604,7236,368,4.8
47051,1/1/20,20276,19459,817,4
47053,1/1/20,22294,21210,1084,4.9
47055,1/1/20,15261,14469,792,5.2
47057,1/1/20,9619,9147,472,4.9
47059,1/1/20,29489,27960,1529,5.2
47061,1/1/20,5069,4823,246,4.9
47063,1/1/20,28456,27186,1270,4.5
47065,1/1/20,184470,177711,6759,3.7
47067,1/1/20,2144,2001,143,6.7
47069,1/1/20,9603,9042,561,5.8
47071,1/1/20,10546,10000,546,5.2
47073,1/1/20,23856,22671,1185,5
47075,1/1/20,7808,7394,414,5.3
47077,1/1/20,12379,11742,637,5.1
47079,1/1/20,14271,13518,753,5.3
47081,1/1/20,11623,11232,391,3.4
47083,1/1/20,3330,3131,199,6
47085,1/1/20,9044,8591,453,5
47087,1/1/20,4734,4469,265,5.6
47089,1/1/20,24995,23787,1208,4.8
47091,1/1/20,7780,7434,346,4.4
47093,1/1/20,244003,236503,7500,3.1
47095,1/1/20,1782,1656,126,7.1
47097,1/1/20,9832,9263,569,5.8
47099,1/1/20,19503,18653,850,4.4
47101,1/1/20,5215,4998,217,4.2
47103,1/1/20,16404,15175,1229,7.5
47105,1/1/20,23647,22741,906,3.8
47107,1/1/20,24053,23039,1014,4.2
47109,1/1/20,8652,8120,532,6.1
47111,1/1/20,11538,11157,381,3.3
47113,1/1/20,48828,46974,1854,3.8
47115,1/1/20,12582,11943,639,5.1
47117,1/1/20,15772,15141,631,4
47119,1/1/20,50146,48528,1618,3.2
47121,1/1/20,5246,4960,286,5.5
47123,1/1/20,20255,19388,867,4.3
47125,1/1/20,85871,82329,3542,4.1
47127,1/1/20,3560,3438,122,3.4
47129,1/1/20,7957,7574,383,4.8
47131,1/1/20,12576,11939,637,5.1
47133,1/1/20,10194,9708,486,4.8
47135,1/1/20,3100,2872,228,7.4
47137,1/1/20,2381,2244,137,5.8
47139,1/1/20,7749,7389,360,4.6
47141,1/1/20,35178,33846,1332,3.8
47143,1/1/20,13485,12688,797,5.9
47145,1/1/20,23556,22447,1109,4.7
47147,1/1/20,38702,37502,1200,3.1
47149,1/1/20,186687,181653,5034,2.7
47151,1/1/20,8280,7893,387,4.7
47153,1/1/20,6208,5933,275,4.4
47155,1/1/20,54369,50920,3449,6.3
47157,1/1/20,445108,425617,19491,4.4
47159,1/1/20,9627,9308,319,3.3
47161,1/1/20,5551,5268,283,5.1
47163,1/1/20,70246,67312,2934,4.2
47165,1/1/20,103850,100827,3023,2.9
47167,1/1/20,28280,27020,1260,4.5
47169,1/1/20,5520,5338,182,3.3
47171,1/1/20,7223,6741,482,6.7
47173,1/1/20,7630,7305,325,4.3
47175,1/1/20,2045,1950,95,4.6
47177,1/1/20,16600,15839,761,4.6
47179,1/1/20,60166,57834,2332,3.9
47181,1/1/20,6276,5895,381,6.1
47183,1/1/20,16128,15474,654,4.1
47185,1/1/20,12294,11775,519,4.2
47187,1/1/20,129991,126795,3196,2.5
47189,1/1/20,77813,75589,2224,2.9
48001,1/1/20,24080,23340,740,3.1
48003,1/1/20,9956,9705,251,2.5
48005,1/1/20,36033,34429,1604,4.5
48007,1/1/20,9393,8961,432,4.6
48009,1/1/20,4141,4016,125,3
48011,1/1/20,931,902,29,3.1
48013,1/1/20,21972,21135,837,3.8
48015,1/1/20,14199,13670,529,3.7
48017,1/1/20,2415,2319,96,4
48019,1/1/20,10182,9837,345,3.4
48021,1/1/20,43422,42083,1339,3.1
48023,1/1/20,1781,1737,44,2.5
48025,1/1/20,9777,9293,484,5
48027,1/1/20,145694,140081,5613,3.9
48029,1/1/20,962162,930924,31238,3.2
48031,1/1/20,6591,6429,162,2.5
48033,1/1/20,418,408,10,2.4
48035,1/1/20,8366,8042,324,3.9
48037,1/1/20,40092,38395,1697,4.2
48039,1/1/20,181632,173088,8544,4.7
48041,1/1/20,119724,116358,3366,2.8
48043,1/1/20,4189,4071,118,2.8
48045,1/1/20,563,539,24,4.3
48047,1/1/20,2697,2550,147,5.5
48049,1/1/20,15570,14930,640,4.1
48051,1/1/20,8434,8127,307,3.6
48053,1/1/20,23617,22949,668,2.8
48055,1/1/20,19898,19232,666,3.3
48057,1/1/20,12251,11803,448,3.7
48059,1/1/20,6181,5970,211,3.4
48061,1/1/20,169038,158331,10707,6.3
48063,1/1/20,5001,4774,227,4.5
48065,1/1/20,3015,2927,88,2.9
48067,1/1/20,12439,11863,576,4.6
48069,1/1/20,3366,3272,94,2.8
48071,1/1/20,19722,18724,998,5.1
48073,1/1/20,20910,20006,904,4.3
48075,1/1/20,2919,2825,94,3.2
48077,1/1/20,4925,4769,156,3.2
48079,1/1/20,1104,1061,43,3.9
48081,1/1/20,1459,1418,41,2.8
48083,1/1/20,2859,2722,137,4.8
48085,1/1/20,571454,553700,17754,3.1
48087,1/1/20,1124,1081,43,3.8
48089,1/1/20,9841,9502,339,3.4
48091,1/1/20,74269,71976,2293,3.1
48093,1/1/20,5582,5370,212,3.8
48095,1/1/20,1329,1291,38,2.9
48097,1/1/20,19723,19108,615,3.1
48099,1/1/20,24422,23453,969,4
48101,1/1/20,544,516,28,5.1
48103,1/1/20,1547,1467,80,5.2
48105,1/1/20,1621,1550,71,4.4
48107,1/1/20,2466,2369,97,3.9
48109,1/1/20,1056,1013,43,4.1
48111,1/1/20,3845,3757,88,2.3
48113,1/1/20,1383174,1335283,47891,3.5
48115,1/1/20,4751,4540,211,4.4
48117,1/1/20,8409,8173,236,2.8
48119,1/1/20,2440,2352,88,3.6
48121,1/1/20,501409,486523,14886,3
48123,1/1/20,9922,9657,265,2.7
48125,1/1/20,671,639,32,4.8
48127,1/1/20,7345,7140,205,2.8
48129,1/1/20,1381,1329,52,3.8
48131,1/1/20,4929,4664,265,5.4
48133,1/1/20,8120,7796,324,4
48135,1/1/20,87996,85003,2993,3.4
48137,1/1/20,1138,1114,24,2.1
48139,1/1/20,93966,91001,2965,3.2
48141,1/1/20,366807,352086,14721,4
48143,1/1/20,20642,19886,756,3.7
48145,1/1/20,6577,6344,233,3.5
48147,1/1/20,17562,17075,487,2.8
48149,1/1/20,12082,11746,336,2.8
48151,1/1/20,1619,1570,49,3
48153,1/1/20,2545,2406,139,5.5
48155,1/1/20,580,564,16,2.8
48157,1/1/20,395479,381076,14403,3.6
48159,1/1/20,4619,4451,168,3.6
48161,1/1/20,6402,6048,354,5.5
48163,1/1/20,10452,10132,320,3.1
48165,1/1/20,9879,9614,265,2.7
48167,1/1/20,167082,159785,7297,4.4
48169,1/1/20,2182,2107,75,3.4
48171,1/1/20,13486,13134,352,2.6
48173,1/1/20,773,757,16,2.1
48175,1/1/20,3265,3135,130,4
48177,1/1/20,9640,9341,299,3.1
48179,1/1/20,8065,7724,341,4.2
48181,1/1/20,63889,61756,2133,3.3
48183,1/1/20,58144,55702,2442,4.2
48185,1/1/20,11216,10706,510,4.5
48187,1/1/20,82501,80029,2472,3
48189,1/1/20,11932,11369,563,4.7
48191,1/1/20,1042,996,46,4.4
48193,1/1/20,3658,3543,115,3.1
48195,1/1/20,2710,2642,68,2.5
48197,1/1/20,1726,1673,53,3.1
48199,1/1/20,25445,24190,1255,4.9
48201,1/1/20,2339258,2242908,96350,4.1
48203,1/1/20,29425,28125,1300,4.4
48205,1/1/20,2765,2713,52,1.9
48207,1/1/20,2265,2184,81,3.6
48209,1/1/20,121491,118010,3481,2.9
48211,1/1/20,1891,1823,68,3.6
48213,1/1/20,36711,35307,1404,3.8
48215,1/1/20,363350,335764,27586,7.6
48217,1/1/20,16332,15742,590,3.6
48219,1/1/20,11216,10839,377,3.4
48221,1/1/20,27908,26885,1023,3.7
48223,1/1/20,17543,16975,568,3.2
48225,1/1/20,10279,9915,364,3.5
48227,1/1/20,14202,13721,481,3.4
48229,1/1/20,1828,1747,81,4.4
48231,1/1/20,44014,42405,1609,3.7
48233,1/1/20,8719,8287,432,5
48235,1/1/20,756,737,19,2.5
48237,1/1/20,3407,3264,143,4.2
48239,1/1/20,7678,7414,264,3.4
48241,1/1/20,12840,11910,930,7.2
48243,1/1/20,982,950,32,3.3
48245,1/1/20,107782,100867,6915,6.4
48247,1/1/20,1859,1766,93,5
48249,1/1/20,16834,15899,935,5.6
48251,1/1/20,83206,80399,2807,3.4
48253,1/1/20,5767,5519,248,4.3
48255,1/1/20,7404,7217,187,2.5
48257,1/1/20,65566,63326,2240,3.4
48259,1/1/20,22363,21732,631,2.8
48261,1/1/20,202,193,9,4.5
48263,1/1/20,485,467,18,3.7
48265,1/1/20,22166,21411,755,3.4
48267,1/1/20,1811,1749,62,3.4
48269,1/1/20,232,228,4,1.7
48271,1/1/20,1407,1336,71,5
48273,1/1/20,13331,12700,631,4.7
48275,1/1/20,1415,1360,55,3.9
48277,1/1/20,24252,23412,840,3.5
48279,1/1/20,5338,5121,217,4.1
48281,1/1/20,9322,9002,320,3.4
48283,1/1/20,4384,4263,121,2.8
48285,1/1/20,8413,8159,254,3
48287,1/1/20,10004,9721,283,2.8
48289,1/1/20,6320,6007,313,5
48291,1/1/20,33604,31605,1999,5.9
48293,1/1/20,8668,8304,364,4.2
48295,1/1/20,1645,1598,47,2.9
48297,1/1/20,5699,5504,195,3.4
48299,1/1/20,8685,8375,310,3.6
48301,1/1/20,663,659,4,0.6
48303,1/1/20,157875,153285,4590,2.9
48305,1/1/20,2756,2660,96,3.5
48307,1/1/20,3320,3159,161,4.8
48309,1/1/20,119993,115860,4133,3.4
48311,1/1/20,896,883,13,1.5
48313,1/1/20,4457,4262,195,4.4
48315,1/1/20,4234,4013,221,5.2
48317,1/1/20,2887,2801,86,3
48319,1/1/20,1753,1690,63,3.6
48321,1/1/20,16683,15558,1125,6.7
48323,1/1/20,24614,22212,2402,9.8
48325,1/1/20,22080,21347,733,3.3
48327,1/1/20,858,829,29,3.4
48329,1/1/20,107926,105377,2549,2.4
48331,1/1/20,9670,9197,473,4.9
48333,1/1/20,1900,1838,62,3.3
48335,1/1/20,2318,2240,78,3.4
48337,1/1/20,9355,9059,296,3.2
48339,1/1/20,286578,276119,10459,3.6
48341,1/1/20,10793,10520,273,2.5
48343,1/1/20,4849,4569,280,5.8
48345,1/1/20,468,450,18,3.8
48347,1/1/20,28012,26915,1097,3.9
48349,1/1/20,24195,23243,952,3.9
48351,1/1/20,5246,4858,388,7.4
48353,1/1/20,7354,7123,231,3.1
48355,1/1/20,167148,159551,7597,4.5
48357,1/1/20,4311,4171,140,3.2
48359,1/1/20,916,887,29,3.2
48361,1/1/20,36605,34573,2032,5.6
48363,1/1/20,13498,13054,444,3.3
48365,1/1/20,10050,9575,475,4.7
48367,1/1/20,68197,66050,2147,3.1
48369,1/1/20,4828,4712,116,2.4
48371,1/1/20,6382,6130,252,3.9
48373,1/1/20,18269,17274,995,5.4
48375,1/1/20,55439,53866,1573,2.8
48377,1/1/20,3193,2895,298,9.3
48379,1/1/20,6166,5977,189,3.1
48381,1/1/20,72383,70536,1847,2.6
48383,1/1/20,1944,1881,63,3.2
48385,1/1/20,1009,965,44,4.4
48387,1/1/20,5142,4888,254,4.9
48389,1/1/20,12406,12152,254,2
48391,1/1/20,3137,3009,128,4.1
48393,1/1/20,414,402,12,2.9
48395,1/1/20,7691,7396,295,3.8
48397,1/1/20,52817,51155,1662,3.1
48399,1/1/20,4598,4455,143,3.1
48401,1/1/20,23036,22051,985,4.3
48403,1/1/20,3715,3423,292,7.9
48405,1/1/20,3521,3326,195,5.5
48407,1/1/20,11865,11259,606,5.1
48409,1/1/20,29929,28079,1850,6.2
48411,1/1/20,2570,2477,93,3.6
48413,1/1/20,1308,1268,40,3.1
48415,1/1/20,6735,6478,257,3.8
48417,1/1/20,1896,1844,52,2.7
48419,1/1/20,11141,10632,509,4.6
48421,1/1/20,1367,1330,37,2.7
48423,1/1/20,106713,102843,3870,3.6
48425,1/1/20,4428,4253,175,4
48427,1/1/20,26543,22882,3661,13.8
48429,1/1/20,4063,3923,140,3.4
48431,1/1/20,563,542,21,3.7
48433,1/1/20,566,548,18,3.2
48435,1/1/20,1346,1286,60,4.5
48437,1/1/20,2577,2477,100,3.9
48439,1/1/20,1095298,1058827,36471,3.3
48441,1/1/20,67604,65569,2035,3
48443,1/1/20,360,347,13,3.6
48445,1/1/20,4876,4686,190,3.9
48447,1/1/20,632,608,24,3.8
48449,1/1/20,13096,12505,591,4.5
48451,1/1/20,54544,52785,1759,3.2
48453,1/1/20,750910,731017,19893,2.6
48455,1/1/20,5329,5025,304,5.7
48457,1/1/20,7191,6702,489,6.8
48459,1/1/20,17883,17097,786,4.4
48461,1/1/20,1698,1643,55,3.2
48463,1/1/20,11367,10922,445,3.9
48465,1/1/20,23292,22322,970,4.2
48467,1/1/20,26143,25205,938,3.6
48469,1/1/20,42759,41074,1685,3.9
48471,1/1/20,24284,23315,969,4
48473,1/1/20,23665,22705,960,4.1
48475,1/1/20,7843,7634,209,2.7
48477,1/1/20,15332,14810,522,3.4
48479,1/1/20,119635,114720,4915,4.1
48481,1/1/20,21620,20774,846,3.9
48483,1/1/20,2276,2199,77,3.4
48485,1/1/20,56473,54596,1877,3.3
48487,1/1/20,4977,4779,198,4
48489,1/1/20,6768,6205,563,8.3
48491,1/1/20,318094,308981,9113,2.9
48493,1/1/20,25200,24439,761,3
48495,1/1/20,4054,3905,149,3.7
48497,1/1/20,32280,31165,1115,3.5
48499,1/1/20,17810,17052,758,4.3
48501,1/1/20,3759,3626,133,3.5
48503,1/1/20,7916,7664,252,3.2
48505,1/1/20,4906,4585,321,6.5
48507,1/1/20,3412,3099,313,9.2
49001,1/1/20,2722,2634,88,3.2
49003,1/1/20,25946,25196,750,2.9
49005,1/1/20,64926,63468,1458,2.2
49007,1/1/20,8487,8148,339,4
49009,1/1/20,321,300,21,6.5
49011,1/1/20,175148,170823,4325,2.5
49013,1/1/20,7831,7453,378,4.8
49015,1/1/20,4238,4025,213,5
49017,1/1/20,2238,1934,304,13.6
49019,1/1/20,5405,4849,556,10.3
49021,1/1/20,24726,23985,741,3
49023,1/1/20,5827,5654,173,3
49025,1/1/20,3492,3354,138,4
49027,1/1/20,5696,5526,170,3
49029,1/1/20,5590,5451,139,2.5
49031,1/1/20,472,446,26,5.5
49033,1/1/20,927,880,47,5.1
49035,1/1/20,644743,627767,16976,2.6
49037,1/1/20,5472,5033,439,8
49039,1/1/20,12438,11988,450,3.6
49041,1/1/20,9614,9245,369,3.8
49043,1/1/20,27724,27137,587,2.1
49045,1/1/20,34539,33523,1016,2.9
49047,1/1/20,13632,12896,736,5.4
49049,1/1/20,312288,304402,7886,2.5
49051,1/1/20,17052,16609,443,2.6
49053,1/1/20,76741,74114,2627,3.4
49055,1/1/20,1263,1115,148,11.7
49057,1/1/20,128559,124643,3916,3
50001,1/1/20,20207,19605,602,3
50003,1/1/20,17952,17304,648,3.6
50005,1/1/20,14264,13662,602,4.2
50007,1/1/20,94012,92082,1930,2.1
50009,1/1/20,2671,2540,131,4.9
50011,1/1/20,26667,25892,775,2.9
50013,1/1/20,3981,3817,164,4.1
50015,1/1/20,13937,13354,583,4.2
50017,1/1/20,15834,15229,605,3.8
50019,1/1/20,13510,12669,841,6.2
50021,1/1/20,30411,29433,978,3.2
50023,1/1/20,34391,33294,1097,3.2
50025,1/1/20,21966,21381,585,2.7
50027,1/1/20,29017,28376,641,2.2
51001,1/1/20,16471,15683,788,4.8
51003,1/1/20,58100,56585,1515,2.6
51005,1/1/20,7015,6685,330,4.7
51007,1/1/20,6417,6187,230,3.6
51009,1/1/20,15124,14587,537,3.6
51011,1/1/20,7227,6929,298,4.1
51013,1/1/20,157319,154118,3201,2
51015,1/1/20,38242,37251,991,2.6
51017,1/1/20,2562,2476,86,3.4
51019,1/1/20,38664,37428,1236,3.2
51021,1/1/20,2853,2774,79,2.8
51023,1/1/20,17571,17070,501,2.9
51025,1/1/20,6034,5720,314,5.2
51027,1/1/20,6808,6272,536,7.9
51029,1/1/20,6577,6243,334,5.1
51031,1/1/20,26137,25234,903,3.5
51033,1/1/20,15597,15041,556,3.6
51035,1/1/20,13291,12763,528,4
51036,1/1/20,3747,3606,141,3.8
51037,1/1/20,5310,5093,217,4.1
51041,1/1/20,191338,185840,5498,2.9
51043,1/1/20,7735,7537,198,2.6
51045,1/1/20,2318,2240,78,3.4
51047,1/1/20,25102,24360,742,3
51049,1/1/20,4687,4513,174,3.7
51051,1/1/20,4828,4522,306,6.3
51053,1/1/20,13945,13454,491,3.5
51057,1/1/20,5544,5313,231,4.2
51059,1/1/20,647069,631589,15480,2.4
51061,1/1/20,37933,36960,973,2.6
51063,1/1/20,8105,7839,266,3.3
51065,1/1/20,14134,13779,355,2.5
51067,1/1/20,26679,25768,911,3.4
51069,1/1/20,48968,47700,1268,2.6
51071,1/1/20,7767,7485,282,3.6
51073,1/1/20,19711,19140,571,2.9
51075,1/1/20,11434,11101,333,2.9
51077,1/1/20,8201,7922,279,3.4
51079,1/1/20,10658,10389,269,2.5
51081,1/1/20,4290,4141,149,3.5
51083,1/1/20,15641,14914,727,4.6
51085,1/1/20,60459,58904,1555,2.6
51087,1/1/20,185734,180352,5382,2.9
51089,1/1/20,24023,23091,932,3.9
51091,1/1/20,1227,1181,46,3.7
51093,1/1/20,19556,18960,596,3
51095,1/1/20,36895,35744,1151,3.1
51097,1/1/20,3896,3783,113,2.9
51099,1/1/20,13756,13358,398,2.9
51101,1/1/20,9341,9065,276,3
51103,1/1/20,5539,5168,371,6.7
51105,1/1/20,8343,7942,401,4.8
51107,1/1/20,226778,221331,5447,2.4
51109,1/1/20,20173,19528,645,3.2
51111,1/1/20,5359,5188,171,3.2
51113,1/1/20,7516,7335,181,2.4
51115,1/1/20,4170,4035,135,3.2
51117,1/1/20,12378,11806,572,4.6
51119,1/1/20,5296,5130,166,3.1
51121,1/1/20,49186,47723,1463,3
51125,1/1/20,7541,7333,208,2.8
51127,1/1/20,12727,12408,319,2.5
51131,1/1/20,5398,5103,295,5.5
51133,1/1/20,5686,5301,385,6.8
51135,1/1/20,7396,7179,217,2.9
51137,1/1/20,17648,17089,559,3.2
51139,1/1/20,12081,11376,705,5.8
51141,1/1/20,7127,6839,288,4
51143,1/1/20,30278,29096,1182,3.9
51145,1/1/20,14462,14036,426,2.9
51147,1/1/20,10379,9954,425,4.1
51149,1/1/20,15419,14860,559,3.6
51153,1/1/20,250393,243661,6732,2.7
51155,1/1/20,15782,15208,574,3.6
51157,1/1/20,3760,3657,103,2.7
51159,1/1/20,4119,3973,146,3.5
51161,1/1/20,49816,48398,1418,2.8
51163,1/1/20,10789,10447,342,3.2
51165,1/1/20,43037,41947,1090,2.5
51167,1/1/20,11425,10829,596,5.2
51169,1/1/20,9243,8904,339,3.7
51171,1/1/20,22731,22110,621,2.7
51173,1/1/20,13925,13321,604,4.3
51175,1/1/20,9108,8831,277,3
51177,1/1/20,68354,66262,2092,3.1
51179,1/1/20,73480,71348,2132,2.9
51181,1/1/20,3659,3518,141,3.9
51183,1/1/20,3903,3702,201,5.1
51185,1/1/20,15757,14912,845,5.4
51187,1/1/20,20850,20194,656,3.1
51191,1/1/20,27048,26040,1008,3.7
51193,1/1/20,9547,9135,412,4.3
51195,1/1/20,13411,12707,704,5.2
51197,1/1/20,13659,13131,528,3.9
51199,1/1/20,32980,32012,968,2.9
51510,1/1/20,103294,100950,2344,2.3
51520,1/1/20,7273,6972,301,4.1
51530,1/1/20,3690,3587,103,2.8
51540,1/1/20,26844,26175,669,2.5
51550,1/1/20,123365,119606,3759,3
51570,1/1/20,8983,8687,296,3.3
51580,1/1/20,2436,2293,143,5.9
51590,1/1/20,19303,18244,1059,5.5
51595,1/1/20,2281,2168,113,5
51600,1/1/20,13704,13392,312,2.3
51610,1/1/20,8751,8569,182,2.1
51620,1/1/20,3581,3426,155,4.3
51630,1/1/20,14420,13926,494,3.4
51640,1/1/20,2919,2819,100,3.4
51650,1/1/20,64823,62170,2653,4.1
51660,1/1/20,25641,24841,800,3.1
51670,1/1/20,9909,9449,460,4.6
51678,1/1/20,2107,2006,101,4.8
51680,1/1/20,36495,35081,1414,3.9
51683,1/1/20,22510,21879,631,2.8
51685,1/1/20,9566,9303,263,2.7
51690,1/1/20,5542,5268,274,4.9
51700,1/1/20,89554,86056,3498,3.9
51710,1/1/20,112273,108168,4105,3.7
51720,1/1/20,1694,1613,81,4.8
51730,1/1/20,13312,12535,777,5.8
51735,1/1/20,6424,6253,171,2.7
51740,1/1/20,44482,42702,1780,4
51750,1/1/20,8492,8166,326,3.8
51760,1/1/20,120799,116615,4184,3.5
51770,1/1/20,49622,47947,1675,3.4
51775,1/1/20,13088,12692,396,3
51790,1/1/20,12497,12134,363,2.9
51800,1/1/20,44885,43440,1445,3.2
51810,1/1/20,234357,227555,6802,2.9
51820,1/1/20,10904,10581,323,3
51830,1/1/20,6736,6454,282,4.2
51840,1/1/20,15069,14605,464,3.1
53001,1/1/20,8521,7860,661,7.8
53003,1/1/20,10636,10187,449,4.2
53005,1/1/20,104938,98912,6026,5.7
53007,1/1/20,43223,40638,2585,6
53009,1/1/20,29854,27637,2217,7.4
53011,1/1/20,247962,236675,11287,4.6
53013,1/1/20,1757,1643,114,6.5
53015,1/1/20,48962,46069,2893,5.9
53017,1/1/20,20982,19514,1468,7
53019,1/1/20,2472,2173,299,12.1
53021,1/1/20,42102,38934,3168,7.5
53023,1/1/20,838,775,63,7.5
53025,1/1/20,44885,40834,4051,9
53027,1/1/20,29736,27483,2253,7.6
53029,1/1/20,37251,35364,1887,5.1
53031,1/1/20,13500,12725,775,5.7
53033,1/1/20,1302826,1267790,35036,2.7
53035,1/1/20,132386,126528,5858,4.4
53037,1/1/20,24354,22924,1430,5.9
53039,1/1/20,9774,9125,649,6.6
53041,1/1/20,35516,33159,2357,6.6
53043,1/1/20,4729,4447,282,6
53045,1/1/20,26592,24905,1687,6.3
53047,1/1/20,18778,17048,1730,9.2
53049,1/1/20,8587,8009,578,6.7
53051,1/1/20,5178,4702,476,9.2
53053,1/1/20,454960,431793,23167,5.1
53055,1/1/20,8886,8480,406,4.6
53057,1/1/20,63887,59954,3933,6.2
53059,1/1/20,5668,5335,333,5.9
53061,1/1/20,443958,430141,13817,3.1
53063,1/1/20,261965,247355,14610,5.6
53065,1/1/20,19266,17678,1588,8.2
53067,1/1/20,147321,140249,7072,4.8
53069,1/1/20,1383,1287,96,6.9
53071,1/1/20,29704,28130,1574,5.3
53073,1/1/20,118389,111841,6548,5.5
53075,1/1/20,24258,23303,955,3.9
53077,1/1/20,128105,117324,10781,8.4
54001,1/1/20,7392,6918,474,6.4
54003,1/1/20,59096,57159,1937,3.3
54005,1/1/20,7516,7015,501,6.7
54007,1/1/20,5321,4803,518,9.7
54009,1/1/20,9916,9349,567,5.7
54011,1/1/20,41726,40016,1710,4.1
54013,1/1/20,2730,2201,529,19.4
54015,1/1/20,3231,2860,371,11.5
54017,1/1/20,3990,3786,204,5.1
54019,1/1/20,16422,15276,1146,7
54021,1/1/20,2401,2186,215,9
54023,1/1/20,5936,5600,336,5.7
54025,1/1/20,15835,14943,892,5.6
54027,1/1/20,10891,10448,443,4.1
54029,1/1/20,12995,12262,733,5.6
54031,1/1/20,5850,5527,323,5.5
54033,1/1/20,34921,33163,1758,5
54035,1/1/20,13482,12669,813,6
54037,1/1/20,30234,29333,901,3
54039,1/1/20,82395,78398,3997,4.9
54041,1/1/20,6609,6107,502,7.6
54043,1/1/20,7322,6771,551,7.5
54045,1/1/20,11520,10654,866,7.5
54047,1/1/20,4651,4126,525,11.3
54049,1/1/20,25793,24455,1338,5.2
54051,1/1/20,14128,13035,1093,7.7
54053,1/1/20,10303,9619,684,6.6
54055,1/1/20,21010,19824,1186,5.6
54057,1/1/20,12630,11898,732,5.8
54059,1/1/20,7156,6478,678,9.5
54061,1/1/20,54171,52236,1935,3.6
54063,1/1/20,5971,5665,306,5.1
54065,1/1/20,8173,7846,327,4
54067,1/1/20,9740,8927,813,8.3
54069,1/1/20,20943,19908,1035,4.9
54071,1/1/20,3734,3572,162,4.3
54073,1/1/20,2990,2732,258,8.6
54075,1/1/20,4234,3999,235,5.6
54077,1/1/20,15435,14642,793,5.1
54079,1/1/20,26983,25744,1239,4.6
54081,1/1/20,30595,28994,1601,5.2
54083,1/1/20,12358,11505,853,6.9
54085,1/1/20,4507,4186,321,7.1
54087,1/1/20,5273,4674,599,11.4
54089,1/1/20,4354,4066,288,6.6
54091,1/1/20,7936,7521,415,5.2
54093,1/1/20,3418,3203,215,6.3
54095,1/1/20,3152,2875,277,8.8
54097,1/1/20,9649,9017,632,6.5
54099,1/1/20,16009,15048,961,6
54101,1/1/20,3356,3099,257,7.7
54103,1/1/20,6745,6150,595,8.8
54105,1/1/20,2392,2140,252,10.5
54107,1/1/20,37455,35327,2128,5.7
54109,1/1/20,6778,6204,574,8.5
55001,1/1/20,8018,7434,584,7.3
55003,1/1/20,7654,7218,436,5.7
55005,1/1/20,24250,22840,1410,5.8
55007,1/1/20,7480,6891,589,7.9
55009,1/1/20,141269,135978,5291,3.7
55011,1/1/20,6416,6012,404,6.3
55013,1/1/20,7007,6475,532,7.6
55015,1/1/20,27491,26562,929,3.4
55017,1/1/20,33231,31278,1953,5.9
55019,1/1/20,17713,16847,866,4.9
55021,1/1/20,31527,30220,1307,4.1
55023,1/1/20,7627,7102,525,6.9
55025,1/1/20,319001,309890,9111,2.9
55027,1/1/20,47273,45334,1939,4.1
55029,1/1/20,14035,13195,840,6
55031,1/1/20,22972,21630,1342,5.8
55033,1/1/20,23680,22496,1184,5
55035,1/1/20,58156,55887,2269,3.9
55037,1/1/20,2199,2069,130,5.9
55039,1/1/20,56772,54650,2122,3.7
55041,1/1/20,4017,3743,274,6.8
55043,1/1/20,27154,25893,1261,4.6
55045,1/1/20,21042,20202,840,4
55047,1/1/20,9161,8608,553,6
55049,1/1/20,13786,13192,594,4.3
55051,1/1/20,2562,2375,187,7.3
55053,1/1/20,10182,9544,638,6.3
55055,1/1/20,45695,43806,1889,4.1
55057,1/1/20,13360,12708,652,4.9
55059,1/1/20,87602,83416,4186,4.8
55061,1/1/20,11028,10581,447,4.1
55063,1/1/20,65414,62967,2447,3.7
55065,1/1/20,10101,9726,375,3.7
55067,1/1/20,9288,8749,539,5.8
55069,1/1/20,15167,14322,845,5.6
55071,1/1/20,40626,38766,1860,4.6
55073,1/1/20,74049,71390,2659,3.6
55075,1/1/20,19337,18160,1177,6.1
55077,1/1/20,7752,7302,450,5.8
55078,1/1/20,1572,1461,111,7.1
55079,1/1/20,465286,444357,20929,4.5
55081,1/1/20,23248,22297,951,4.1
55083,1/1/20,20828,19647,1181,5.7
55085,1/1/20,17136,16084,1052,6.1
55087,1/1/20,102918,99158,3760,3.7
55089,1/1/20,48832,47294,1538,3.1
55091,1/1/20,4068,3828,240,5.9
55093,1/1/20,25465,24214,1251,4.9
55095,1/1/20,24724,23117,1607,6.5
55097,1/1/20,37861,36258,1603,4.2
55099,1/1/20,6445,6077,368,5.7
55101,1/1/20,98051,93085,4966,5.1
55103,1/1/20,9131,8722,409,4.5
55105,1/1/20,85466,81042,4424,5.2
55107,1/1/20,6919,6440,479,6.9
55109,1/1/20,50606,48179,2427,4.8
55111,1/1/20,35168,33712,1456,4.1
55113,1/1/20,7720,7217,503,6.5
55115,1/1/20,20918,19915,1003,4.8
55117,1/1/20,61175,59074,2101,3.4
55119,1/1/20,11070,10416,654,5.9
55121,1/1/20,15897,15084,813,5.1
55123,1/1/20,15246,14481,765,5
55125,1/1/20,9798,9201,597,6.1
55127,1/1/20,56645,54152,2493,4.4
55129,1/1/20,7786,7298,488,6.3
55131,1/1/20,77001,74309,2692,3.5
55133,1/1/20,224165,216361,7804,3.5
55135,1/1/20,25726,24614,1112,4.3
55137,1/1/20,11423,10745,678,5.9
55139,1/1/20,91141,87953,3188,3.5
55141,1/1/20,35111,33371,1740,5
56001,1/1/20,20326,19665,661,3.3
56003,1/1/20,5311,5024,287,5.4
56005,1/1/20,23757,22841,916,3.9
56007,1/1/20,7966,7628,338,4.2
56009,1/1/20,9040,8767,273,3
56011,1/1/20,3673,3558,115,3.1
56013,1/1/20,18848,17800,1048,5.6
56015,1/1/20,6639,6396,243,3.7
56017,1/1/20,2145,2053,92,4.3
56019,1/1/20,4090,3905,185,4.5
56021,1/1/20,48858,46912,1946,4
56023,1/1/20,8872,8501,371,4.2
56025,1/1/20,39440,37589,1851,4.7
56027,1/1/20,1223,1181,42,3.4
56029,1/1/20,14780,14008,772,5.2
56031,1/1/20,4533,4325,208,4.6
56033,1/1/20,15647,14976,671,4.3
56035,1/1/20,4234,3985,249,5.9
56037,1/1/20,21362,20198,1164,5.4
56039,1/1/20,15473,15056,417,2.7
56041,1/1/20,8829,8416,413,4.7
56043,1/1/20,3943,3761,182,4.6
56045,1/1/20,3832,3712,120,3.1
72001,1/1/20,4143,3353,790,19.1
72003,1/1/20,11249,9939,1310,11.6
72005,1/1/20,13706,12164,1542,11.3
72007,1/1/20,6180,5526,654,10.6
72009,1/1/20,6169,5402,767,12.4
72011,1/1/20,8345,7499,846,10.1
72013,1/1/20,23014,20360,2654,11.5
72015,1/1/20,4438,3734,704,15.9
72017,1/1/20,5590,4875,715,12.8
72019,1/1/20,6965,6225,740,10.6
72021,1/1/20,60984,56784,4200,6.9
72023,1/1/20,12910,11500,1410,10.9
72025,1/1/20,44739,41335,3404,7.6
72027,1/1/20,9105,8144,961,10.6
72029,1/1/20,14993,13909,1084,7.2
72031,1/1/20,57337,53672,3665,6.4
72033,1/1/20,7322,6745,577,7.9
72035,1/1/20,15184,13912,1272,8.4
72037,1/1/20,3456,3097,359,10.4
72039,1/1/20,3551,3066,485,13.7
72041,1/1/20,14473,13414,1059,7.3
72043,1/1/20,9593,8235,1358,14.2
72045,1/1/20,4665,4143,522,11.2
72047,1/1/20,8388,7523,865,10.3
72049,1/1/20,852,823,29,3.4
72051,1/1/20,12354,11539,815,6.6
72053,1/1/20,10201,9108,1093,10.7
72054,1/1/20,3142,2751,391,12.4
72055,1/1/20,4220,3328,892,21.1
72057,1/1/20,10336,8982,1354,13.1
72059,1/1/20,4687,3893,794,16.9
72061,1/1/20,35087,33482,1605,4.6
72063,1/1/20,16924,15802,1122,6.6
72065,1/1/20,13241,11214,2027,15.3
72067,1/1/20,5043,4529,514,10.2
72069,1/1/20,16252,14384,1868,11.5
72071,1/1/20,11093,9885,1208,10.9
72073,1/1/20,4103,3491,612,14.9
72075,1/1/20,14703,13159,1544,10.5
72077,1/1/20,11539,10444,1095,9.5
72079,1/1/20,5067,4240,827,16.3
72081,1/1/20,6921,5688,1233,17.8
72083,1/1/20,2581,2192,389,15.1
72085,1/1/20,10636,9554,1082,10.2
72087,1/1/20,7949,7218,731,9.2
72089,1/1/20,5765,5209,556,9.6
72091,1/1/20,10879,9901,978,9
72093,1/1/20,1888,1579,309,16.4
72095,1/1/20,2832,2326,506,17.9
72097,1/1/20,20526,18017,2509,12.2
72099,1/1/20,9937,8713,1224,12.3
72101,1/1/20,7555,6728,827,10.9
72103,1/1/20,7701,6909,792,10.3
72105,1/1/20,6664,5989,675,10.1
72107,1/1/20,4795,4097,698,14.6
72109,1/1/20,4088,3363,725,17.7
72111,1/1/20,5586,4708,878,15.7
72113,1/1/20,42821,38279,4542,10.6
72115,1/1/20,5854,5039,815,13.9
72117,1/1/20,4654,3814,840,18
72119,1/1/20,15825,14565,1260,8
72121,1/1/20,5976,5017,959,16
72123,1/1/20,6658,5630,1028,15.4
72125,1/1/20,9294,7988,1306,14.1
72127,1/1/20,125278,117602,7676,6.1
72129,1/1/20,11011,9910,1101,10
72131,1/1/20,9860,8274,1586,16.1
72133,1/1/20,9573,8614,959,10
72135,1/1/20,25318,23699,1619,6.4
72137,1/1/20,27244,25510,1734,6.4
72139,1/1/20,25296,23875,1421,5.6
72141,1/1/20,6441,5515,926,14.4
72143,1/1/20,9216,8284,932,10.1
72145,1/1/20,12452,11123,1329,10.7
72147,1/1/20,2452,2274,178,7.3
72149,1/1/20,7311,5859,1452,19.9
72151,1/1/20,8383,7142,1241,14.8
72153,1/1/20,9918,7925,1993,20.1
1001,2/1/20,25952,25239,713,2.7
1003,2/1/20,95898,93381,2517,2.6
1005,2/1/20,8533,8233,300,3.5
1007,2/1/20,8620,8362,258,3
1009,2/1/20,25152,24510,642,2.6
1011,2/1/20,4785,4630,155,3.2
1013,2/1/20,9255,8872,383,4.1
1015,2/1/20,46185,44603,1582,3.4
1017,2/1/20,15711,15271,440,2.8
1019,2/1/20,11389,11071,318,2.8
1021,2/1/20,19669,19184,485,2.5
1023,2/1/20,4527,4307,220,4.9
1025,2/1/20,7390,6974,416,5.6
1027,2/1/20,6088,5924,164,2.7
1029,2/1/20,5724,5554,170,3
1031,2/1/20,21194,20628,566,2.7
1033,2/1/20,23542,22662,880,3.7
1035,2/1/20,4471,4299,172,3.8
1037,2/1/20,4471,4339,132,3
1039,2/1/20,15490,14992,498,3.2
1041,2/1/20,6413,6228,185,2.9
1043,2/1/20,38596,37613,983,2.5
1045,2/1/20,20563,19996,567,2.8
1047,2/1/20,14602,13851,751,5.1
1049,2/1/20,30953,30131,822,2.7
1051,2/1/20,37221,36245,976,2.6
1053,2/1/20,14672,14174,498,3.4
1055,2/1/20,42854,41157,1697,4
1057,2/1/20,6537,6344,193,3
1059,2/1/20,14745,14225,520,3.5
1061,2/1/20,11008,10710,298,2.7
1063,2/1/20,2867,2709,158,5.5
1065,2/1/20,6211,5960,251,4
1067,2/1/20,6889,6664,225,3.3
1069,2/1/20,45826,44547,1279,2.8
1071,2/1/20,23170,22417,753,3.2
1073,2/1/20,315803,307229,8574,2.7
1075,2/1/20,5842,5661,181,3.1
1077,2/1/20,42243,40964,1279,3
1079,2/1/20,14268,13850,418,2.9
1081,2/1/20,77108,75240,1868,2.4
1083,2/1/20,44157,43098,1059,2.4
1085,2/1/20,3543,3363,180,5.1
1087,2/1/20,7792,7486,306,3.9
1089,2/1/20,186335,182050,4285,2.3
1091,2/1/20,7652,7374,278,3.6
1093,2/1/20,12855,12338,517,4
1095,2/1/20,43847,42804,1043,2.4
1097,2/1/20,188361,181220,7141,3.8
1099,2/1/20,7459,7077,382,5.1
1101,2/1/20,104742,101572,3170,3
1103,2/1/20,58072,56665,1407,2.4
1105,2/1/20,3402,3238,164,4.8
1107,2/1/20,7989,7721,268,3.4
1109,2/1/20,15444,14997,447,2.9
1111,2/1/20,9617,9358,259,2.7
1113,2/1/20,23623,23002,621,2.6
1115,2/1/20,40163,39145,1018,2.5
1117,2/1/20,114878,112521,2357,2.1
1119,2/1/20,4757,4574,183,3.8
1121,2/1/20,35380,34192,1188,3.4
1123,2/1/20,18289,17762,527,2.9
1125,2/1/20,105354,102808,2546,2.4
1127,2/1/20,25163,24332,831,3.3
1129,2/1/20,6799,6477,322,4.7
1131,2/1/20,2801,2564,237,8.5
1133,2/1/20,10071,9742,329,3.3
2013,2/1/20,3107,3044,63,2
2016,2/1/20,4629,4536,93,2
2020,2/1/20,144607,138141,6466,4.5
2050,2/1/20,6838,5978,860,12.6
2060,2/1/20,238,201,37,15.5
2068,2/1/20,562,459,103,18.3
2070,2/1/20,1807,1678,129,7.1
2090,2/1/20,43195,41039,2156,5
2100,2/1/20,895,752,143,16
2105,2/1/20,957,790,167,17.5
2110,2/1/20,16097,15446,651,4
2122,2/1/20,24728,22933,1795,7.3
2130,2/1/20,6157,5703,454,7.4
2150,2/1/20,5973,5710,263,4.4
2158,2/1/20,2680,2164,516,19.3
2164,2/1/20,586,520,66,11.3
2170,2/1/20,46346,43239,3107,6.7
2180,2/1/20,4105,3680,425,10.4
2185,2/1/20,3730,3554,176,4.7
2188,2/1/20,2932,2531,401,13.7
2195,2/1/20,1243,1122,121,9.7
2198,2/1/20,2677,2407,270,10.1
2220,2/1/20,3934,3764,170,4.3
2230,2/1/20,584,465,119,20.4
2240,2/1/20,2695,2436,259,9.6
2261,2/1/20,4120,3663,457,11.1
2275,2/1/20,937,862,75,8
2282,2/1/20,216,189,27,12.5
2290,2/1/20,2396,2056,340,14.2
4001,2/1/20,20719,18596,2123,10.2
4003,2/1/20,52131,49300,2831,5.4
4005,2/1/20,77424,72922,4502,5.8
4007,2/1/20,21577,20415,1162,5.4
4009,2/1/20,15910,15150,760,4.8
4011,2/1/20,4627,4457,170,3.7
4012,2/1/20,9765,9220,545,5.6
4013,2/1/20,2373395,2283363,90032,3.8
4015,2/1/20,89429,84527,4902,5.5
4017,2/1/20,40941,37830,3111,7.6
4019,2/1/20,508289,486746,21543,4.2
4021,2/1/20,192743,183752,8991,4.7
4023,2/1/20,19872,18436,1436,7.2
4025,2/1/20,107790,103198,4592,4.3
4027,2/1/20,98792,86923,11869,12
5001,2/1/20,9331,9018,313,3.4
5003,2/1/20,7746,7198,548,7.1
5005,2/1/20,16073,15372,701,4.4
5007,2/1/20,138773,134888,3885,2.8
5009,2/1/20,16016,15441,575,3.6
5011,2/1/20,4527,4331,196,4.3
5013,2/1/20,2466,2339,127,5.2
5015,2/1/20,12420,11918,502,4
5017,2/1/20,3279,2992,287,8.8
5019,2/1/20,9711,9347,364,3.7
5021,2/1/20,5650,5316,334,5.9
5023,2/1/20,9105,8596,509,5.6
5025,2/1/20,3231,3077,154,4.8
5027,2/1/20,9180,8750,430,4.7
5029,2/1/20,8284,7892,392,4.7
5031,2/1/20,56339,54649,1690,3
5033,2/1/20,26837,25848,989,3.7
5035,2/1/20,21425,20480,945,4.4
5037,2/1/20,7393,7055,338,4.6
5039,2/1/20,2829,2686,143,5.1
5041,2/1/20,5352,5074,278,5.2
5043,2/1/20,7940,7466,474,6
5045,2/1/20,61688,59611,2077,3.4
5047,2/1/20,7474,7185,289,3.9
5049,2/1/20,4971,4755,216,4.3
5051,2/1/20,41253,39584,1669,4
5053,2/1/20,8357,8030,327,3.9
5055,2/1/20,20285,19455,830,4.1
5057,2/1/20,9911,9481,430,4.3
5059,2/1/20,13966,13437,529,3.8
5061,2/1/20,5787,5564,223,3.9
5063,2/1/20,16613,15885,728,4.4
5065,2/1/20,4883,4556,327,6.7
5067,2/1/20,5877,5453,424,7.2
5069,2/1/20,27574,25935,1639,5.9
5071,2/1/20,10226,9761,465,4.5
5073,2/1/20,2476,2348,128,5.2
5075,2/1/20,6894,6571,323,4.7
5077,2/1/20,2872,2694,178,6.2
5079,2/1/20,3973,3763,210,5.3
5081,2/1/20,5577,5295,282,5.1
5083,2/1/20,8523,8114,409,4.8
5085,2/1/20,34179,32916,1263,3.7
5087,2/1/20,7559,7352,207,2.7
5089,2/1/20,6645,6333,312,4.7
5091,2/1/20,19850,18992,858,4.3
5093,2/1/20,17219,16187,1032,6
5095,2/1/20,2806,2670,136,4.8
5097,2/1/20,2938,2768,170,5.8
5099,2/1/20,3625,3473,152,4.2
5101,2/1/20,3357,3212,145,4.3
5103,2/1/20,9792,9251,541,5.5
5105,2/1/20,4230,4048,182,4.3
5107,2/1/20,6372,5916,456,7.2
5109,2/1/20,4256,4061,195,4.6
5111,2/1/20,10499,10072,427,4.1
5113,2/1/20,8238,7772,466,5.7
5115,2/1/20,28754,27487,1267,4.4
5117,2/1/20,3583,3422,161,4.5
5119,2/1/20,187970,180782,7188,3.8
5121,2/1/20,7457,7119,338,4.5
5123,2/1/20,8125,7676,449,5.5
5125,2/1/20,58329,56515,1814,3.1
5127,2/1/20,4351,4185,166,3.8
5129,2/1/20,2823,2652,171,6.1
5131,2/1/20,56463,54388,2075,3.7
5133,2/1/20,5539,5240,299,5.4
5135,2/1/20,5716,5378,338,5.9
5137,2/1/20,4602,4340,262,5.7
5139,2/1/20,15816,14866,950,6
5141,2/1/20,5669,5337,332,5.9
5143,2/1/20,126247,123061,3186,2.5
5145,2/1/20,33800,32010,1790,5.3
5147,2/1/20,2750,2607,143,5.2
5149,2/1/20,8440,8089,351,4.2
6001,2/1/20,840181,815242,24939,3
6003,2/1/20,645,613,32,5
6005,2/1/20,14859,14199,660,4.4
6007,2/1/20,98349,92973,5376,5.5
6009,2/1/20,21605,20700,905,4.2
6011,2/1/20,11212,8985,2227,19.9
6013,2/1/20,558664,541184,17480,3.1
6015,2/1/20,9619,9015,604,6.3
6017,2/1/20,92258,88856,3402,3.7
6019,2/1/20,454296,415683,38613,8.5
6021,2/1/20,13252,12318,934,7
6023,2/1/20,62086,59686,2400,3.9
6025,2/1/20,71543,59283,12260,17.1
6027,2/1/20,8673,8334,339,3.9
6029,2/1/20,396003,359962,36041,9.1
6031,2/1/20,58440,52731,5709,9.8
6033,2/1/20,29102,27427,1675,5.8
6035,2/1/20,9784,9216,568,5.8
6037,2/1/20,5222823,4984604,238219,4.6
6039,2/1/20,63078,57946,5132,8.1
6041,2/1/20,139742,136460,3282,2.3
6043,2/1/20,7197,6752,445,6.2
6045,2/1/20,38401,36595,1806,4.7
6047,2/1/20,115564,103549,12015,10.4
6049,2/1/20,3058,2756,302,9.9
6051,2/1/20,8887,8550,337,3.8
6053,2/1/20,216781,195047,21734,10
6055,2/1/20,73398,71041,2357,3.2
6057,2/1/20,48720,46932,1788,3.7
6059,2/1/20,1623559,1578096,45463,2.8
6061,2/1/20,188486,182459,6027,3.2
6063,2/1/20,7443,6622,821,11
6065,2/1/20,1105334,1059668,45666,4.1
6067,2/1/20,714666,687809,26857,3.8
6069,2/1/20,31628,29668,1960,6.2
6071,2/1/20,970216,933278,36938,3.8
6073,2/1/20,1595019,1544069,50950,3.2
6075,2/1/20,587316,574147,13169,2.2
6077,2/1/20,326199,304561,21638,6.6
6079,2/1/20,142473,138189,4284,3
6081,2/1/20,463060,453342,9718,2.1
6083,2/1/20,215395,205535,9860,4.6
6085,2/1/20,1057582,1030435,27147,2.6
6087,2/1/20,141202,132169,9033,6.4
6089,2/1/20,73340,69328,4012,5.5
6091,2/1/20,1309,1221,88,6.7
6093,2/1/20,17012,15562,1450,8.5
6095,2/1/20,208311,200131,8180,3.9
6097,2/1/20,258914,251570,7344,2.8
6099,2/1/20,243730,227706,16024,6.6
6101,2/1/20,46594,42433,4161,8.9
6103,2/1/20,25750,24156,1594,6.2
6105,2/1/20,4464,4140,324,7.3
6107,2/1/20,205487,181909,23578,11.5
6109,2/1/20,21572,20502,1070,5
6111,2/1/20,424133,408438,15695,3.7
6113,2/1/20,109252,103914,5338,4.9
6115,2/1/20,30832,28692,2140,6.9
8001,2/1/20,280249,271135,9114,3.3
8003,2/1/20,8611,8249,362,4.2
8005,2/1/20,374600,364143,10457,2.8
8007,2/1/20,6640,6392,248,3.7
8009,2/1/20,2073,2027,46,2.2
8011,2/1/20,1821,1770,51,2.8
8013,2/1/20,200110,195214,4896,2.4
8014,2/1/20,41189,40112,1077,2.6
8015,2/1/20,9571,9309,262,2.7
8017,2/1/20,1162,1143,19,1.6
8019,2/1/20,6207,6050,157,2.5
8021,2/1/20,4095,3907,188,4.6
8023,2/1/20,1873,1794,79,4.2
8025,2/1/20,1506,1437,69,4.6
8027,2/1/20,2005,1939,66,3.3
8029,2/1/20,14203,13608,595,4.2
8031,2/1/20,428493,416294,12199,2.8
8033,2/1/20,1129,1088,41,3.6
8035,2/1/20,199341,194491,4850,2.4
8037,2/1/20,39209,38401,808,2.1
8039,2/1/20,15509,15140,369,2.4
8041,2/1/20,347087,335172,11915,3.4
8043,2/1/20,14736,13976,760,5.2
8045,2/1/20,33504,32388,1116,3.3
8047,2/1/20,3876,3791,85,2.2
8049,2/1/20,10372,10140,232,2.2
8051,2/1/20,12024,11755,269,2.2
8053,2/1/20,362,350,12,3.3
8055,2/1/20,2405,2214,191,7.9
8057,2/1/20,988,957,31,3.1
8059,2/1/20,344319,335248,9071,2.6
8061,2/1/20,927,914,13,1.4
8063,2/1/20,4210,4126,84,2
8065,2/1/20,5362,5253,109,2
8067,2/1/20,31497,30536,961,3.1
8069,2/1/20,209090,203556,5534,2.6
8071,2/1/20,6534,6262,272,4.2
8073,2/1/20,2291,2220,71,3.1
8075,2/1/20,10819,10544,275,2.5
8077,2/1/20,76603,73437,3166,4.1
8079,2/1/20,534,519,15,2.8
8081,2/1/20,7334,7018,316,4.3
8083,2/1/20,12676,11962,714,5.6
8085,2/1/20,21648,20873,775,3.6
8087,2/1/20,16154,15701,453,2.8
8089,2/1/20,8370,7995,375,4.5
8091,2/1/20,2335,2251,84,3.6
8093,2/1/20,11480,11185,295,2.6
8095,2/1/20,2472,2431,41,1.7
8097,2/1/20,11487,11203,284,2.5
8099,2/1/20,6280,6114,166,2.6
8101,2/1/20,76605,73303,3302,4.3
8103,2/1/20,2978,2869,109,3.7
8105,2/1/20,5322,5040,282,5.3
8107,2/1/20,17323,16957,366,2.1
8109,2/1/20,3539,3367,172,4.9
8111,2/1/20,537,519,18,3.4
8113,2/1/20,6621,6506,115,1.7
8115,2/1/20,1217,1189,28,2.3
8117,2/1/20,26022,25613,409,1.6
8119,2/1/20,13008,12598,410,3.2
8121,2/1/20,2793,2727,66,2.4
8123,2/1/20,171613,166692,4921,2.9
8125,2/1/20,5602,5496,106,1.9
9001,2/1/20,477944,456925,21019,4.4
9003,2/1/20,486517,464956,21561,4.4
9005,2/1/20,104993,100262,4731,4.5
9007,2/1/20,94658,90971,3687,3.9
9009,2/1/20,464524,443423,21101,4.5
9011,2/1/20,136885,130869,6016,4.4
9013,2/1/20,87764,84298,3466,3.9
9015,2/1/20,64448,61359,3089,4.8
10001,2/1/20,80317,76802,3515,4.4
10003,2/1/20,301931,290585,11346,3.8
10005,2/1/20,105235,100360,4875,4.6
11001,2/1/20,419329,397669,21660,5.2
12001,2/1/20,142667,138843,3824,2.7
12003,2/1/20,12034,11685,349,2.9
12005,2/1/20,82248,79568,2680,3.3
12007,2/1/20,11298,10957,341,3
12009,2/1/20,287256,278381,8875,3.1
12011,2/1/20,1047945,1017575,30370,2.9
12013,2/1/20,4801,4637,164,3.4
12015,2/1/20,73844,71246,2598,3.5
12017,2/1/20,47676,45398,2278,4.8
12019,2/1/20,109398,106198,3200,2.9
12021,2/1/20,184666,179392,5274,2.9
12023,2/1/20,30305,29370,935,3.1
12027,2/1/20,14991,14489,502,3.3
12029,2/1/20,5934,5709,225,3.8
12031,2/1/20,499492,484004,15488,3.1
12033,2/1/20,147035,142330,4705,3.2
12035,2/1/20,47655,45917,1738,3.6
12037,2/1/20,4518,4380,138,3.1
12039,2/1/20,19081,18346,735,3.9
12041,2/1/20,7306,7075,231,3.2
12043,2/1/20,5712,5507,205,3.6
12045,2/1/20,5612,5402,210,3.7
12047,2/1/20,4205,4030,175,4.2
12049,2/1/20,8800,8426,374,4.3
12051,2/1/20,16161,15397,764,4.7
12053,2/1/20,73135,70154,2981,4.1
12055,2/1/20,36651,35024,1627,4.4
12057,2/1/20,764317,742245,22072,2.9
12059,2/1/20,7074,6826,248,3.5
12061,2/1/20,66546,64175,2371,3.6
12063,2/1/20,17207,16626,581,3.4
12065,2/1/20,5671,5489,182,3.2
12067,2/1/20,2897,2815,82,2.8
12069,2/1/20,161427,156399,5028,3.1
12071,2/1/20,356454,345844,10610,3
12073,2/1/20,156835,152396,4439,2.8
12075,2/1/20,16936,16346,590,3.5
12077,2/1/20,2664,2572,92,3.5
12079,2/1/20,7476,7219,257,3.4
12081,2/1/20,183805,178372,5433,3
12083,2/1/20,138788,133643,5145,3.7
12085,2/1/20,75448,73193,2255,3
12086,2/1/20,1404551,1384161,20390,1.5
12087,2/1/20,48094,47133,961,2
12089,2/1/20,41857,40666,1191,2.8
12091,2/1/20,95962,93379,2583,2.7
12093,2/1/20,18213,17680,533,2.9
12095,2/1/20,773709,752391,21318,2.8
12097,2/1/20,186883,181050,5833,3.1
12099,2/1/20,742269,719634,22635,3
12101,2/1/20,242110,234002,8108,3.3
12103,2/1/20,502988,488427,14561,2.9
12105,2/1/20,309185,298486,10699,3.5
12107,2/1/20,26667,25516,1151,4.3
12109,2/1/20,134609,131191,3418,2.5
12111,2/1/20,147475,141973,5502,3.7
12113,2/1/20,83393,81031,2362,2.8
12115,2/1/20,192854,187137,5717,3
12117,2/1/20,259205,251971,7234,2.8
12119,2/1/20,33355,31822,1533,4.6
12121,2/1/20,17974,17367,607,3.4
12123,2/1/20,8155,7884,271,3.3
12125,2/1/20,4701,4568,133,2.8
12127,2/1/20,257800,249164,8636,3.3
12129,2/1/20,15086,14665,421,2.8
12131,2/1/20,31287,30413,874,2.8
12133,2/1/20,9608,9273,335,3.5
13001,2/1/20,9906,9543,363,3.7
13003,2/1/20,5152,4998,154,3
13005,2/1/20,5061,4871,190,3.8
13007,2/1/20,1230,1173,57,4.6
13009,2/1/20,17825,17028,797,4.5
13011,2/1/20,9905,9623,282,2.8
13013,2/1/20,41076,39871,1205,2.9
13015,2/1/20,51465,49692,1773,3.4
13017,2/1/20,5363,5065,298,5.6
13019,2/1/20,7717,7371,346,4.5
13021,2/1/20,68603,65908,2695,3.9
13023,2/1/20,4582,4355,227,5
13025,2/1/20,7255,6972,283,3.9
13027,2/1/20,7136,6875,261,3.7
13029,2/1/20,18372,17796,576,3.1
13031,2/1/20,36974,35571,1403,3.8
13033,2/1/20,9324,8856,468,5
13035,2/1/20,10936,10554,382,3.5
13037,2/1/20,2385,2302,83,3.5
13039,2/1/20,21049,20262,787,3.7
13043,2/1/20,5721,5566,155,2.7
13045,2/1/20,56249,54148,2101,3.7
13047,2/1/20,34204,33154,1050,3.1
13049,2/1/20,4898,4714,184,3.8
13051,2/1/20,140241,135432,4809,3.4
13053,2/1/20,2022,1932,90,4.5
13055,2/1/20,10384,9880,504,4.9
13057,2/1/20,137819,133954,3865,2.8
13059,2/1/20,59924,57810,2114,3.5
13061,2/1/20,911,846,65,7.1
13063,2/1/20,140152,134066,6086,4.3
13065,2/1/20,2644,2541,103,3.9
13067,2/1/20,431595,418420,13175,3.1
13069,2/1/20,19305,18505,800,4.1
13071,2/1/20,22009,21316,693,3.1
13073,2/1/20,75917,73578,2339,3.1
13075,2/1/20,8227,7939,288,3.5
13077,2/1/20,75796,73539,2257,3
13079,2/1/20,5695,5492,203,3.6
13081,2/1/20,9661,9272,389,4
13083,2/1/20,8341,8055,286,3.4
13085,2/1/20,12496,12142,354,2.8
13087,2/1/20,11923,11477,446,3.7
13089,2/1/20,405439,391256,14183,3.5
13091,2/1/20,7069,6686,383,5.4
13093,2/1/20,5197,5000,197,3.8
13095,2/1/20,38947,37080,1867,4.8
13097,2/1/20,74362,71652,2710,3.6
13099,2/1/20,4552,4353,199,4.4
13101,2/1/20,2002,1945,57,2.8
13103,2/1/20,31055,30124,931,3
13105,2/1/20,7755,7421,334,4.3
13107,2/1/20,8456,8061,395,4.7
13109,2/1/20,4986,4807,179,3.6
13111,2/1/20,11540,11119,421,3.6
13113,2/1/20,58867,57107,1760,3
13115,2/1/20,44883,43207,1676,3.7
13117,2/1/20,123947,120529,3418,2.8
13119,2/1/20,10100,9715,385,3.8
13121,2/1/20,565480,545570,19910,3.5
13123,2/1/20,11898,11452,446,3.7
13125,2/1/20,1307,1253,54,4.1
13127,2/1/20,39160,37847,1313,3.4
13129,2/1/20,28535,27520,1015,3.6
13131,2/1/20,10625,10262,363,3.4
13133,2/1/20,7011,6725,286,4.1
13135,2/1/20,496767,481430,15337,3.1
13137,2/1/20,19238,18569,669,3.5
13139,2/1/20,103789,100933,2856,2.8
13141,2/1/20,2551,2410,141,5.5
13143,2/1/20,12768,12306,462,3.6
13145,2/1/20,16791,16262,529,3.2
13147,2/1/20,11203,10721,482,4.3
13149,2/1/20,5362,5162,200,3.7
13151,2/1/20,117429,113231,4198,3.6
13153,2/1/20,71443,69049,2394,3.4
13155,2/1/20,3454,3291,163,4.7
13157,2/1/20,37035,36023,1012,2.7
13159,2/1/20,7055,6847,208,2.9
13161,2/1/20,6140,5850,290,4.7
13163,2/1/20,6764,6426,338,5
13165,2/1/20,3134,2989,145,4.6
13167,2/1/20,4064,3897,167,4.1
13169,2/1/20,13892,13430,462,3.3
13171,2/1/20,8411,8017,394,4.7
13173,2/1/20,3805,3651,154,4
13175,2/1/20,19161,18192,969,5.1
13177,2/1/20,14966,14497,469,3.1
13179,2/1/20,26724,25692,1032,3.9
13181,2/1/20,3641,3494,147,4
13183,2/1/20,8360,8067,293,3.5
13185,2/1/20,51911,49994,1917,3.7
13187,2/1/20,16913,16392,521,3.1
13189,2/1/20,8974,8504,470,5.2
13191,2/1/20,6211,5990,221,3.6
13193,2/1/20,4841,4619,222,4.6
13195,2/1/20,13481,13047,434,3.2
13197,2/1/20,3339,3191,148,4.4
13199,2/1/20,9049,8658,391,4.3
13201,2/1/20,2848,2752,96,3.4
13205,2/1/20,8798,8386,412,4.7
13207,2/1/20,13185,12723,462,3.5
13209,2/1/20,3860,3684,176,4.6
13211,2/1/20,9427,9126,301,3.2
13213,2/1/20,15644,14819,825,5.3
13215,2/1/20,77771,74328,3443,4.4
13217,2/1/20,53039,50992,2047,3.9
13219,2/1/20,19757,19265,492,2.5
13221,2/1/20,7082,6851,231,3.3
13223,2/1/20,87404,84725,2679,3.1
13225,2/1/20,12041,11578,463,3.8
13227,2/1/20,15527,15036,491,3.2
13229,2/1/20,8840,8561,279,3.2
13231,2/1/20,9049,8766,283,3.1
13233,2/1/20,18629,17938,691,3.7
13235,2/1/20,4148,3982,166,4
13237,2/1/20,8277,7926,351,4.2
13239,2/1/20,797,761,36,4.5
13241,2/1/20,6954,6700,254,3.7
13243,2/1/20,2618,2492,126,4.8
13245,2/1/20,85980,82142,3838,4.5
13247,2/1/20,45456,43690,1766,3.9
13249,2/1/20,2254,2171,83,3.7
13251,2/1/20,5116,4891,225,4.4
13253,2/1/20,3126,2992,134,4.3
13255,2/1/20,29202,27962,1240,4.2
13257,2/1/20,10726,10305,421,3.9
13259,2/1/20,2458,2367,91,3.7
13261,2/1/20,13074,12439,635,4.9
13263,2/1/20,2826,2710,116,4.1
13265,2/1/20,582,540,42,7.2
13267,2/1/20,9814,9422,392,4
13269,2/1/20,3259,3144,115,3.5
13271,2/1/20,4208,3809,399,9.5
13273,2/1/20,3550,3396,154,4.3
13275,2/1/20,16608,15920,688,4.1
13277,2/1/20,20353,19652,701,3.4
13279,2/1/20,11849,11294,555,4.7
13281,2/1/20,3871,3672,199,5.1
13283,2/1/20,2681,2533,148,5.5
13285,2/1/20,37855,36654,1201,3.2
13287,2/1/20,3237,3079,158,4.9
13289,2/1/20,2935,2764,171,5.8
13291,2/1/20,10415,10055,360,3.5
13293,2/1/20,11575,11110,465,4
13295,2/1/20,31957,30882,1075,3.4
13297,2/1/20,46783,45309,1474,3.2
13299,2/1/20,15855,15258,597,3.8
13301,2/1/20,2905,2782,123,4.2
13303,2/1/20,7079,6745,334,4.7
13305,2/1/20,11406,10957,449,3.9
13307,2/1/20,1045,993,52,5
13309,2/1/20,1666,1541,125,7.5
13311,2/1/20,16482,16042,440,2.7
13313,2/1/20,43559,41798,1761,4
13315,2/1/20,2756,2640,116,4.2
13317,2/1/20,3894,3681,213,5.5
13319,2/1/20,4055,3904,151,3.7
13321,2/1/20,9102,8756,346,3.8
15001,2/1/20,91793,88771,3022,3.3
15003,2/1/20,453705,442404,11301,2.5
15007,2/1/20,36596,35584,1012,2.8
15009,2/1/20,87021,84722,2299,2.6
16001,2/1/20,260386,254135,6251,2.4
16003,2/1/20,1658,1545,113,6.8
16005,2/1/20,43582,42255,1327,3
16007,2/1/20,2919,2813,106,3.6
16009,2/1/20,4138,3880,258,6.2
16011,2/1/20,23406,22716,690,2.9
16013,2/1/20,12637,12242,395,3.1
16015,2/1/20,3656,3461,195,5.3
16017,2/1/20,20350,19357,993,4.9
16019,2/1/20,58171,56666,1505,2.6
16021,2/1/20,5237,4960,277,5.3
16023,2/1/20,1383,1349,34,2.5
16025,2/1/20,680,661,19,2.8
16027,2/1/20,106255,102796,3459,3.3
16029,2/1/20,4091,3953,138,3.4
16031,2/1/20,12027,11741,286,2.4
16033,2/1/20,359,342,17,4.7
16035,2/1/20,2809,2622,187,6.7
16037,2/1/20,1982,1893,89,4.5
16039,2/1/20,11462,11047,415,3.6
16041,2/1/20,6986,6830,156,2.2
16043,2/1/20,7785,7553,232,3
16045,2/1/20,8442,8142,300,3.6
16047,2/1/20,8083,7828,255,3.2
16049,2/1/20,6419,6089,330,5.1
16051,2/1/20,14100,13743,357,2.5
16053,2/1/20,12130,11755,375,3.1
16055,2/1/20,80624,77309,3315,4.1
16057,2/1/20,21135,20614,521,2.5
16059,2/1/20,3458,3246,212,6.1
16061,2/1/20,1570,1472,98,6.2
16063,2/1/20,2725,2568,157,5.8
16065,2/1/20,21978,21575,403,1.8
16067,2/1/20,11262,10937,325,2.9
16069,2/1/20,21345,20707,638,3
16071,2/1/20,2280,2222,58,2.5
16073,2/1/20,5268,5066,202,3.8
16075,2/1/20,11627,11170,457,3.9
16077,2/1/20,3814,3670,144,3.8
16079,2/1/20,5086,4747,339,6.7
16081,2/1/20,6287,6151,136,2.2
16083,2/1/20,41434,40178,1256,3
16085,2/1/20,5622,5378,244,4.3
16087,2/1/20,4609,4398,211,4.6
17001,2/1/20,31412,30543,869,2.8
17003,2/1/20,2029,1927,102,5
17005,2/1/20,7574,7333,241,3.2
17007,2/1/20,25422,24032,1390,5.5
17009,2/1/20,2928,2872,56,1.9
17011,2/1/20,16495,15772,723,4.4
17013,2/1/20,2262,2175,87,3.8
17015,2/1/20,7018,6735,283,4
17017,2/1/20,5918,5698,220,3.7
17019,2/1/20,110591,107699,2892,2.6
17021,2/1/20,13884,13283,601,4.3
17023,2/1/20,7364,7069,295,4
17025,2/1/20,6207,5939,268,4.3
17027,2/1/20,20099,19550,549,2.7
17029,2/1/20,23875,23202,673,2.8
17031,2/1/20,2565239,2477090,88149,3.4
17033,2/1/20,8430,8137,293,3.5
17035,2/1/20,6029,5846,183,3
17037,2/1/20,54282,52378,1904,3.5
17039,2/1/20,7225,6979,246,3.4
17041,2/1/20,10037,9780,257,2.6
17043,2/1/20,502291,489036,13255,2.6
17045,2/1/20,8397,8116,281,3.3
17047,2/1/20,2640,2530,110,4.2
17049,2/1/20,19082,18547,535,2.8
17051,2/1/20,9550,9167,383,4
17053,2/1/20,6350,6128,222,3.5
17055,2/1/20,16075,15374,701,4.4
17057,2/1/20,14746,13963,783,5.3
17059,2/1/20,2294,2188,106,4.6
17061,2/1/20,5799,5602,197,3.4
17063,2/1/20,25180,24001,1179,4.7
17065,2/1/20,4303,4166,137,3.2
17067,2/1/20,7955,7613,342,4.3
17069,2/1/20,1286,1214,72,5.6
17071,2/1/20,3427,3264,163,4.8
17073,2/1/20,24229,23181,1048,4.3
17075,2/1/20,13673,13093,580,4.2
17077,2/1/20,27759,26988,771,2.8
17079,2/1/20,4614,4447,167,3.6
17081,2/1/20,17171,16556,615,3.6
17083,2/1/20,10847,10443,404,3.7
17085,2/1/20,10245,9797,448,4.4
17087,2/1/20,4218,4000,218,5.2
17089,2/1/20,270519,259518,11001,4.1
17091,2/1/20,55248,52739,2509,4.5
17093,2/1/20,67894,65632,2262,3.3
17095,2/1/20,20828,19951,877,4.2
17097,2/1/20,368821,355006,13815,3.7
17099,2/1/20,53491,50916,2575,4.8
17101,2/1/20,5770,5536,234,4.1
17103,2/1/20,17295,16731,564,3.3
17105,2/1/20,15857,15290,567,3.6
17107,2/1/20,12281,11863,418,3.4
17109,2/1/20,13084,12663,421,3.2
17111,2/1/20,164019,158446,5573,3.4
17113,2/1/20,86639,84252,2387,2.8
17115,2/1/20,47095,45052,2043,4.3
17117,2/1/20,22555,21758,797,3.5
17119,2/1/20,133032,129001,4031,3
17121,2/1/20,17054,16448,606,3.6
17123,2/1/20,5092,4857,235,4.6
17125,2/1/20,6068,5781,287,4.7
17127,2/1/20,5574,5335,239,4.3
17129,2/1/20,6352,6124,228,3.6
17131,2/1/20,7857,7427,430,5.5
17133,2/1/20,18620,18160,460,2.5
17135,2/1/20,11361,10777,584,5.1
17137,2/1/20,15994,15442,552,3.5
17139,2/1/20,7422,7234,188,2.5
17141,2/1/20,23943,22893,1050,4.4
17143,2/1/20,82421,78698,3723,4.5
17145,2/1/20,8190,7881,309,3.8
17147,2/1/20,8603,8372,231,2.7
17149,2/1/20,6594,6314,280,4.2
17151,2/1/20,1653,1582,71,4.3
17153,2/1/20,1912,1795,117,6.1
17155,2/1/20,3069,2909,160,5.2
17157,2/1/20,14042,13627,415,3
17159,2/1/20,7061,6831,230,3.3
17161,2/1/20,69905,66922,2983,4.3
17163,2/1/20,125370,121168,4202,3.4
17165,2/1/20,9494,9067,427,4.5
17167,2/1/20,99024,95831,3193,3.2
17169,2/1/20,3049,2933,116,3.8
17171,2/1/20,2443,2328,115,4.7
17173,2/1/20,10251,9909,342,3.3
17175,2/1/20,2374,2253,121,5.1
17177,2/1/20,20950,20099,851,4.1
17179,2/1/20,61733,59286,2447,4
17181,2/1/20,7399,7017,382,5.2
17183,2/1/20,32306,30992,1314,4.1
17185,2/1/20,5863,5694,169,2.9
17187,2/1/20,8127,7866,261,3.2
17189,2/1/20,9770,9573,197,2
17191,2/1/20,6728,6471,257,3.8
17193,2/1/20,6391,6190,201,3.1
17195,2/1/20,27780,26763,1017,3.7
17197,2/1/20,353851,340245,13606,3.8
17199,2/1/20,31931,30829,1102,3.5
17201,2/1/20,134662,128345,6317,4.7
17203,2/1/20,18048,17481,567,3.1
18001,2/1/20,16935,16417,518,3.1
18003,2/1/20,187606,181210,6396,3.4
18005,2/1/20,45281,44151,1130,2.5
18007,2/1/20,4539,4404,135,3
18009,2/1/20,4823,4615,208,4.3
18011,2/1/20,36348,35489,859,2.4
18013,2/1/20,7750,7495,255,3.3
18015,2/1/20,10347,10008,339,3.3
18017,2/1/20,17824,17142,682,3.8
18019,2/1/20,62297,60342,1955,3.1
18021,2/1/20,12079,11622,457,3.8
18023,2/1/20,17029,16572,457,2.7
18025,2/1/20,4892,4620,272,5.6
18027,2/1/20,16723,16263,460,2.8
18029,2/1/20,25908,24907,1001,3.9
18031,2/1/20,14814,14346,468,3.2
18033,2/1/20,22834,22169,665,2.9
18035,2/1/20,54975,52797,2178,4
18037,2/1/20,22955,22399,556,2.4
18039,2/1/20,112840,109757,3083,2.7
18041,2/1/20,8507,8125,382,4.5
18043,2/1/20,42083,40794,1289,3.1
18045,2/1/20,7867,7592,275,3.5
18047,2/1/20,11200,10760,440,3.9
18049,2/1/20,9537,9170,367,3.8
18051,2/1/20,19809,19291,518,2.6
18053,2/1/20,32210,31047,1163,3.6
18055,2/1/20,13773,13149,624,4.5
18057,2/1/20,185018,180614,4404,2.4
18059,2/1/20,40479,39340,1139,2.8
18061,2/1/20,20531,19848,683,3.3
18063,2/1/20,90660,88341,2319,2.6
18065,2/1/20,22093,21342,751,3.4
18067,2/1/20,37220,35791,1429,3.8
18069,2/1/20,18240,17644,596,3.3
18071,2/1/20,23014,22444,570,2.5
18073,2/1/20,16335,15575,760,4.7
18075,2/1/20,9318,9021,297,3.2
18077,2/1/20,15051,14542,509,3.4
18079,2/1/20,13673,13190,483,3.5
18081,2/1/20,83503,81306,2197,2.6
18083,2/1/20,18505,17915,590,3.2
18085,2/1/20,42084,40884,1200,2.9
18087,2/1/20,19714,19231,483,2.5
18089,2/1/20,232266,220319,11947,5.1
18091,2/1/20,47784,45534,2250,4.7
18093,2/1/20,21369,20577,792,3.7
18095,2/1/20,59725,57310,2415,4
18097,2/1/20,494512,478989,15523,3.1
18099,2/1/20,22813,22058,755,3.3
18101,2/1/20,5368,5237,131,2.4
18103,2/1/20,15157,14523,634,4.2
18105,2/1/20,72481,70159,2322,3.2
18107,2/1/20,18678,18119,559,3
18109,2/1/20,36615,35407,1208,3.3
18111,2/1/20,6952,6607,345,5
18113,2/1/20,23289,22581,708,3
18115,2/1/20,3191,3084,107,3.4
18117,2/1/20,8848,8516,332,3.8
18119,2/1/20,9631,9243,388,4
18121,2/1/20,6822,6559,263,3.9
18123,2/1/20,9239,8923,316,3.4
18125,2/1/20,6194,5960,234,3.8
18127,2/1/20,87548,83948,3600,4.1
18129,2/1/20,13626,13245,381,2.8
18131,2/1/20,6401,6159,242,3.8
18133,2/1/20,16813,16243,570,3.4
18135,2/1/20,11002,10536,466,4.2
18137,2/1/20,14220,13694,526,3.7
18139,2/1/20,8760,8518,242,2.8
18141,2/1/20,137342,132388,4954,3.6
18143,2/1/20,10640,10299,341,3.2
18145,2/1/20,23278,22592,686,2.9
18147,2/1/20,10267,9853,414,4
18149,2/1/20,9660,9195,465,4.8
18151,2/1/20,20970,20441,529,2.5
18153,2/1/20,8402,7997,405,4.8
18155,2/1/20,4923,4747,176,3.6
18157,2/1/20,101709,98779,2930,2.9
18159,2/1/20,9094,8837,257,2.8
18161,2/1/20,3533,3417,116,3.3
18163,2/1/20,95411,92496,2915,3.1
18165,2/1/20,6986,6602,384,5.5
18167,2/1/20,48432,46378,2054,4.2
18169,2/1/20,15121,14630,491,3.2
18171,2/1/20,4154,4030,124,3
18173,2/1/20,33319,32345,974,2.9
18175,2/1/20,13703,13197,506,3.7
18177,2/1/20,30980,29878,1102,3.6
18179,2/1/20,14433,14003,430,3
18181,2/1/20,13327,12951,376,2.8
18183,2/1/20,17841,17318,523,2.9
19001,2/1/20,4295,4165,130,3
19003,2/1/20,2182,2142,40,1.8
19005,2/1/20,7602,7213,389,5.1
19007,2/1/20,6010,5795,215,3.6
19009,2/1/20,3131,3049,82,2.6
19011,2/1/20,13696,13235,461,3.4
19013,2/1/20,69416,66979,2437,3.5
19015,2/1/20,15163,14750,413,2.7
19017,2/1/20,14025,13652,373,2.7
19019,2/1/20,11396,10992,404,3.5
19021,2/1/20,12182,11918,264,2.2
19023,2/1/20,8082,7739,343,4.2
19025,2/1/20,4292,4176,116,2.7
19027,2/1/20,11036,10818,218,2
19029,2/1/20,6949,6718,231,3.3
19031,2/1/20,10992,10647,345,3.1
19033,2/1/20,23722,23026,696,2.9
19035,2/1/20,6324,6122,202,3.2
19037,2/1/20,6678,6419,259,3.9
19039,2/1/20,4990,4804,186,3.7
19041,2/1/20,8581,8301,280,3.3
19043,2/1/20,10210,9567,643,6.3
19045,2/1/20,22880,21933,947,4.1
19047,2/1/20,8355,7953,402,4.8
19049,2/1/20,50084,49096,988,2
19051,2/1/20,4316,4196,120,2.8
19053,2/1/20,4550,4450,100,2.2
19055,2/1/20,10819,10490,329,3
19057,2/1/20,19123,18161,962,5
19059,2/1/20,9749,9347,402,4.1
19061,2/1/20,57095,55156,1939,3.4
19063,2/1/20,5308,5148,160,3
19065,2/1/20,11043,10542,501,4.5
19067,2/1/20,8781,8386,395,4.5
19069,2/1/20,5771,5589,182,3.2
19071,2/1/20,3723,3644,79,2.1
19073,2/1/20,5541,5415,126,2.3
19075,2/1/20,6653,6441,212,3.2
19077,2/1/20,5807,5578,229,3.9
19079,2/1/20,7015,6796,219,3.1
19081,2/1/20,6020,5859,161,2.7
19083,2/1/20,8142,7845,297,3.6
19085,2/1/20,7582,7379,203,2.7
19087,2/1/20,9927,9599,328,3.3
19089,2/1/20,5337,5132,205,3.8
19091,2/1/20,5159,4991,168,3.3
19093,2/1/20,4281,4155,126,2.9
19095,2/1/20,10694,10383,311,2.9
19097,2/1/20,11166,10666,500,4.5
19099,2/1/20,20054,19372,682,3.4
19101,2/1/20,10440,10191,249,2.4
19103,2/1/20,86461,84795,1666,1.9
19105,2/1/20,11005,10494,511,4.6
19107,2/1/20,5365,5131,234,4.4
19109,2/1/20,8554,8328,226,2.6
19111,2/1/20,16253,15575,678,4.2
19113,2/1/20,122894,118894,4000,3.3
19115,2/1/20,6204,5940,264,4.3
19117,2/1/20,4707,4604,103,2.2
19119,2/1/20,7175,7012,163,2.3
19121,2/1/20,8784,8389,395,4.5
19123,2/1/20,12032,11691,341,2.8
19125,2/1/20,18577,18130,447,2.4
19127,2/1/20,18295,17041,1254,6.9
19129,2/1/20,7567,7391,176,2.3
19131,2/1/20,7195,7053,142,2
19133,2/1/20,4527,4372,155,3.4
19135,2/1/20,4141,4007,134,3.2
19137,2/1/20,5102,4958,144,2.8
19139,2/1/20,22137,21437,700,3.2
19141,2/1/20,8435,8232,203,2.4
19143,2/1/20,3589,3504,85,2.4
19145,2/1/20,6465,6296,169,2.6
19147,2/1/20,4837,4700,137,2.8
19149,2/1/20,15110,14769,341,2.3
19151,2/1/20,4589,4490,99,2.2
19153,2/1/20,272195,263851,8344,3.1
19155,2/1/20,49530,48255,1275,2.6
19157,2/1/20,10797,10433,364,3.4
19159,2/1/20,2512,2443,69,2.7
19161,2/1/20,5351,5186,165,3.1
19163,2/1/20,89082,85817,3265,3.7
19165,2/1/20,6789,6621,168,2.5
19167,2/1/20,21840,21300,540,2.5
19169,2/1/20,60221,59226,995,1.7
19171,2/1/20,9604,9185,419,4.4
19173,2/1/20,3264,3205,59,1.8
19175,2/1/20,6454,6206,248,3.8
19177,2/1/20,3701,3569,132,3.6
19179,2/1/20,17941,17282,659,3.7
19181,2/1/20,28737,27871,866,3
19183,2/1/20,12280,11873,407,3.3
19185,2/1/20,2889,2815,74,2.6
19187,2/1/20,19655,18987,668,3.4
19189,2/1/20,5265,5112,153,2.9
19191,2/1/20,12610,12100,510,4
19193,2/1/20,56521,54735,1786,3.2
19195,2/1/20,4335,4184,151,3.5
19197,2/1/20,7162,6956,206,2.9
20001,2/1/20,6423,6193,230,3.6
20003,2/1/20,4201,4059,142,3.4
20005,2/1/20,7036,6641,395,5.6
20007,2/1/20,2297,2236,61,2.7
20009,2/1/20,13296,12794,502,3.8
20011,2/1/20,6595,6278,317,4.8
20013,2/1/20,5362,5203,159,3
20015,2/1/20,32994,31875,1119,3.4
20017,2/1/20,1552,1509,43,2.8
20019,2/1/20,1424,1376,48,3.4
20021,2/1/20,10166,9847,319,3.1
20023,2/1/20,1315,1285,30,2.3
20025,2/1/20,1080,1055,25,2.3
20027,2/1/20,3769,3653,116,3.1
20029,2/1/20,3749,3642,107,2.9
20031,2/1/20,4183,3991,192,4.6
20033,2/1/20,839,816,23,2.7
20035,2/1/20,16325,15751,574,3.5
20037,2/1/20,18620,17876,744,4
20039,2/1/20,1180,1141,39,3.3
20041,2/1/20,8762,8409,353,4
20043,2/1/20,4134,3975,159,3.8
20045,2/1/20,67031,65029,2002,3
20047,2/1/20,1384,1352,32,2.3
20049,2/1/20,1147,1113,34,3
20051,2/1/20,17040,16682,358,2.1
20053,2/1/20,2690,2621,69,2.6
20055,2/1/20,20878,20442,436,2.1
20057,2/1/20,16969,16556,413,2.4
20059,2/1/20,14304,13787,517,3.6
20061,2/1/20,11407,10894,513,4.5
20063,2/1/20,1475,1447,28,1.9
20065,2/1/20,1084,1056,28,2.6
20067,2/1/20,3139,3059,80,2.5
20069,2/1/20,3173,3102,71,2.2
20071,2/1/20,778,764,14,1.8
20073,2/1/20,3316,3188,128,3.9
20075,2/1/20,1620,1592,28,1.7
20077,2/1/20,2988,2913,75,2.5
20079,2/1/20,17253,16717,536,3.1
20081,2/1/20,2170,2124,46,2.1
20083,2/1/20,977,949,28,2.9
20085,2/1/20,7197,6958,239,3.3
20087,2/1/20,10151,9786,365,3.6
20089,2/1/20,1244,1212,32,2.6
20091,2/1/20,342133,332950,9183,2.7
20093,2/1/20,2022,1985,37,1.8
20095,2/1/20,3461,3351,110,3.2
20097,2/1/20,1266,1238,28,2.2
20099,2/1/20,9949,9530,419,4.2
20101,2/1/20,746,725,21,2.8
20103,2/1/20,36990,35587,1403,3.8
20105,2/1/20,1698,1659,39,2.3
20107,2/1/20,4530,4209,321,7.1
20109,2/1/20,1616,1580,36,2.2
20111,2/1/20,16831,16243,588,3.5
20113,2/1/20,17215,16804,411,2.4
20115,2/1/20,5920,5765,155,2.6
20117,2/1/20,5448,5291,157,2.9
20119,2/1/20,2069,2021,48,2.3
20121,2/1/20,17748,17071,677,3.8
20123,2/1/20,3259,3184,75,2.3
20125,2/1/20,14519,13842,677,4.7
20127,2/1/20,3034,2936,98,3.2
20129,2/1/20,1108,1080,28,2.5
20131,2/1/20,5246,5109,137,2.6
20133,2/1/20,6196,5927,269,4.3
20135,2/1/20,1312,1278,34,2.6
20137,2/1/20,2655,2600,55,2.1
20139,2/1/20,8004,7687,317,4
20141,2/1/20,2078,2021,57,2.7
20143,2/1/20,2978,2898,80,2.7
20145,2/1/20,2835,2742,93,3.3
20147,2/1/20,2611,2549,62,2.4
20149,2/1/20,12734,12346,388,3
20151,2/1/20,4881,4765,116,2.4
20153,2/1/20,1462,1434,28,1.9
20155,2/1/20,29659,28687,972,3.3
20157,2/1/20,2183,2128,55,2.5
20159,2/1/20,5195,5065,130,2.5
20161,2/1/20,35871,34923,948,2.6
20163,2/1/20,2462,2384,78,3.2
20165,2/1/20,1614,1571,43,2.7
20167,2/1/20,3222,3124,98,3
20169,2/1/20,30282,29258,1024,3.4
20171,2/1/20,2809,2756,53,1.9
20173,2/1/20,256214,246019,10195,4
20175,2/1/20,9261,8976,285,3.1
20177,2/1/20,90742,87477,3265,3.6
20179,2/1/20,1390,1358,32,2.3
20181,2/1/20,2760,2680,80,2.9
20183,2/1/20,1961,1906,55,2.8
20185,2/1/20,2035,1974,61,3
20187,2/1/20,965,940,25,2.6
20189,2/1/20,2478,2401,77,3.1
20191,2/1/20,11054,10662,392,3.5
20193,2/1/20,4267,4180,87,2
20195,2/1/20,1419,1374,45,3.2
20197,2/1/20,3658,3517,141,3.9
20199,2/1/20,782,762,20,2.6
20201,2/1/20,2893,2813,80,2.8
20203,2/1/20,1183,1162,21,1.8
20205,2/1/20,3994,3811,183,4.6
20207,2/1/20,1575,1516,59,3.7
20209,2/1/20,78170,74690,3480,4.5
21001,2/1/20,7210,6790,420,5.8
21003,2/1/20,8995,8645,350,3.9
21005,2/1/20,12275,11799,476,3.9
21007,2/1/20,3510,3305,205,5.8
21009,2/1/20,18822,17936,886,4.7
21011,2/1/20,4649,4273,376,8.1
21013,2/1/20,8535,7923,612,7.2
21015,2/1/20,71103,68694,2409,3.4
21017,2/1/20,9509,9125,384,4
21019,2/1/20,18021,16922,1099,6.1
21021,2/1/20,12426,11880,546,4.4
21023,2/1/20,3868,3640,228,5.9
21025,2/1/20,3489,3130,359,10.3
21027,2/1/20,7919,7438,481,6.1
21029,2/1/20,43184,41510,1674,3.9
21031,2/1/20,5223,4951,272,5.2
21033,2/1/20,5497,5218,279,5.1
21035,2/1/20,18829,17838,991,5.3
21037,2/1/20,50961,49204,1757,3.4
21039,2/1/20,2295,2200,95,4.1
21041,2/1/20,5220,5000,220,4.2
21043,2/1/20,9922,9051,871,8.8
21045,2/1/20,6671,6400,271,4.1
21047,2/1/20,25594,24222,1372,5.4
21049,2/1/20,17150,16439,711,4.1
21051,2/1/20,5189,4825,364,7
21053,2/1/20,4014,3781,233,5.8
21055,2/1/20,3839,3660,179,4.7
21057,2/1/20,3199,3025,174,5.4
21059,2/1/20,47756,45879,1877,3.9
21061,2/1/20,4882,4633,249,5.1
21063,2/1/20,2116,1886,230,10.9
21065,2/1/20,5471,5163,308,5.6
21067,2/1/20,173767,168418,5349,3.1
21069,2/1/20,6130,5738,392,6.4
21071,2/1/20,11053,10231,822,7.4
21073,2/1/20,25661,24737,924,3.6
21075,2/1/20,2024,1929,95,4.7
21077,2/1/20,4071,3910,161,4
21079,2/1/20,7648,7295,353,4.6
21081,2/1/20,11793,11261,532,4.5
21083,2/1/20,15670,14940,730,4.7
21085,2/1/20,11101,10530,571,5.1
21087,2/1/20,5055,4838,217,4.3
21089,2/1/20,13628,12571,1057,7.8
21091,2/1/20,3981,3848,133,3.3
21093,2/1/20,49317,47300,2017,4.1
21095,2/1/20,6759,5962,797,11.8
21097,2/1/20,8843,8479,364,4.1
21099,2/1/20,8036,7527,509,6.3
21101,2/1/20,22126,21288,838,3.8
21103,2/1/20,8256,7957,299,3.6
21105,2/1/20,1712,1623,89,5.2
21107,2/1/20,18400,17540,860,4.7
21109,2/1/20,4097,3825,272,6.6
21111,2/1/20,403607,389039,14568,3.6
21113,2/1/20,26427,25538,889,3.4
21115,2/1/20,6735,6246,489,7.3
21117,2/1/20,88026,84913,3113,3.5
21119,2/1/20,4461,4133,328,7.4
21121,2/1/20,9884,9343,541,5.5
21123,2/1/20,6037,5758,279,4.6
21125,2/1/20,24644,23474,1170,4.7
21127,2/1/20,5273,4848,425,8.1
21129,2/1/20,2120,1987,133,6.3
21131,2/1/20,2761,2454,307,11.1
21133,2/1/20,6485,5902,583,9
21135,2/1/20,4719,4225,494,10.5
21137,2/1/20,9238,8769,469,5.1
21139,2/1/20,3674,3439,235,6.4
21141,2/1/20,12638,12123,515,4.1
21143,2/1/20,3025,2886,139,4.6
21145,2/1/20,29289,27807,1482,5.1
21147,2/1/20,4656,4359,297,6.4
21149,2/1/20,4205,4020,185,4.4
21151,2/1/20,47543,45794,1749,3.7
21153,2/1/20,3432,2882,550,16
21155,2/1/20,9668,9346,322,3.3
21157,2/1/20,15181,14400,781,5.1
21159,2/1/20,2838,2574,264,9.3
21161,2/1/20,6998,6588,410,5.9
21163,2/1/20,12344,11747,597,4.8
21165,2/1/20,2351,2138,213,9.1
21167,2/1/20,9979,9511,468,4.7
21169,2/1/20,4084,3877,207,5.1
21171,2/1/20,4716,4488,228,4.8
21173,2/1/20,11636,10970,666,5.7
21175,2/1/20,4633,4329,304,6.6
21177,2/1/20,10486,9744,742,7.1
21179,2/1/20,23317,22319,998,4.3
21181,2/1/20,3314,3148,166,5
21183,2/1/20,9890,9306,584,5.9
21185,2/1/20,33549,32574,975,2.9
21187,2/1/20,5069,4851,218,4.3
21189,2/1/20,1145,1061,84,7.3
21191,2/1/20,7056,6741,315,4.5
21193,2/1/20,8388,7722,666,7.9
21195,2/1/20,19938,18540,1398,7
21197,2/1/20,5027,4696,331,6.6
21199,2/1/20,26794,25526,1268,4.7
21201,2/1/20,819,775,44,5.4
21203,2/1/20,6737,6401,336,5
21205,2/1/20,10624,10022,602,5.7
21207,2/1/20,6216,5862,354,5.7
21209,2/1/20,28920,27960,960,3.3
21211,2/1/20,25572,24794,778,3
21213,2/1/20,8843,8466,377,4.3
21215,2/1/20,10313,9965,348,3.4
21217,2/1/20,12528,12021,507,4
21219,2/1/20,5493,5262,231,4.2
21221,2/1/20,6134,5816,318,5.2
21223,2/1/20,3898,3732,166,4.3
21225,2/1/20,6121,5842,279,4.6
21227,2/1/20,65720,63298,2422,3.7
21229,2/1/20,6249,6018,231,3.7
21231,2/1/20,7366,6957,409,5.6
21233,2/1/20,5540,5279,261,4.7
21235,2/1/20,13667,12993,674,4.9
21237,2/1/20,2024,1855,169,8.3
21239,2/1/20,14556,14082,474,3.3
22001,2/1/20,23579,22489,1090,4.6
22003,2/1/20,8921,8421,500,5.6
22005,2/1/20,64632,62307,2325,3.6
22007,2/1/20,8867,8364,503,5.7
22009,2/1/20,14911,14129,782,5.2
22011,2/1/20,14574,13867,707,4.9
22013,2/1/20,5511,5194,317,5.8
22015,2/1/20,57369,55238,2131,3.7
22017,2/1/20,102960,98039,4921,4.8
22019,2/1/20,103389,99236,4153,4
22021,2/1/20,3761,3509,252,6.7
22023,2/1/20,3838,3694,144,3.8
22025,2/1/20,3356,3170,186,5.5
22027,2/1/20,5853,5507,346,5.9
22029,2/1/20,7082,6639,443,6.3
22031,2/1/20,10836,10223,613,5.7
22033,2/1/20,232599,223883,8716,3.7
22035,2/1/20,1862,1654,208,11.2
22037,2/1/20,8019,7715,304,3.8
22039,2/1/20,11637,11035,602,5.2
22041,2/1/20,7299,6801,498,6.8
22043,2/1/20,8149,7704,445,5.5
22045,2/1/20,27899,26439,1460,5.2
22047,2/1/20,14205,13425,780,5.5
22049,2/1/20,6822,6514,308,4.5
22051,2/1/20,215064,207239,7825,3.6
22053,2/1/20,13038,12482,556,4.3
22055,2/1/20,112649,108253,4396,3.9
22057,2/1/20,41867,40277,1590,3.8
22059,2/1/20,6753,6501,252,3.7
22061,2/1/20,22089,21163,926,4.2
22063,2/1/20,69312,66915,2397,3.5
22065,2/1/20,3445,3195,250,7.3
22067,2/1/20,10078,9199,879,8.7
22069,2/1/20,16478,15700,778,4.7
22071,2/1/20,179578,172058,7520,4.2
22073,2/1/20,70231,66787,3444,4.9
22075,2/1/20,10091,9728,363,3.6
22077,2/1/20,9911,9464,447,4.5
22079,2/1/20,54807,52390,2417,4.4
22081,2/1/20,3734,3541,193,5.2
22083,2/1/20,8130,7603,527,6.5
22085,2/1/20,9073,8674,399,4.4
22087,2/1/20,19965,19075,890,4.5
22089,2/1/20,25291,24343,948,3.7
22091,2/1/20,4302,4072,230,5.3
22093,2/1/20,9307,8793,514,5.5
22095,2/1/20,19793,18787,1006,5.1
22097,2/1/20,31699,29867,1832,5.8
22099,2/1/20,22033,21008,1025,4.7
22101,2/1/20,19602,18581,1021,5.2
22103,2/1/20,119785,115572,4213,3.5
22105,2/1/20,54451,51869,2582,4.7
22107,2/1/20,1361,1241,120,8.8
22109,2/1/20,46184,44337,1847,4
22111,2/1/20,9126,8619,507,5.6
22113,2/1/20,23815,22736,1079,4.5
22115,2/1/20,16126,15138,988,6.1
22117,2/1/20,16676,15836,840,5
22119,2/1/20,14460,13638,822,5.7
22121,2/1/20,13767,13242,525,3.8
22123,2/1/20,3591,3166,425,11.8
22125,2/1/20,5436,5235,201,3.7
22127,2/1/20,4829,4541,288,6
23001,2/1/20,55336,53227,2109,3.8
23003,2/1/20,30562,28682,1880,6.2
23005,2/1/20,162378,157521,4857,3
23007,2/1/20,14534,13849,685,4.7
23009,2/1/20,27556,25699,1857,6.7
23011,2/1/20,61790,59309,2481,4
23013,2/1/20,19615,18660,955,4.9
23015,2/1/20,16166,15394,772,4.8
23017,2/1/20,26799,25520,1279,4.8
23019,2/1/20,77484,73962,3522,4.5
23021,2/1/20,7324,6917,407,5.6
23023,2/1/20,19226,18636,590,3.1
23025,2/1/20,22436,20951,1485,6.6
23027,2/1/20,20431,19428,1003,4.9
23029,2/1/20,13787,12730,1057,7.7
23031,2/1/20,112413,107882,4531,4
24001,2/1/20,32464,30715,1749,5.4
24003,2/1/20,319089,309362,9727,3
24005,2/1/20,459124,442386,16738,3.6
24009,2/1/20,51035,49495,1540,3
24011,2/1/20,18218,17528,690,3.8
24013,2/1/20,97386,94407,2979,3.1
24015,2/1/20,53753,51548,2205,4.1
24017,2/1/20,89101,85949,3152,3.5
24019,2/1/20,15300,14539,761,5
24021,2/1/20,136339,131955,4384,3.2
24023,2/1/20,15617,14783,834,5.3
24025,2/1/20,142856,137991,4865,3.4
24027,2/1/20,189727,184648,5079,2.7
24029,2/1/20,10304,9797,507,4.9
24031,2/1/20,566488,549988,16500,2.9
24033,2/1/20,519518,500780,18738,3.6
24035,2/1/20,28534,27589,945,3.3
24037,2/1/20,58041,56153,1888,3.3
24039,2/1/20,9249,8685,564,6.1
24041,2/1/20,18929,18192,737,3.9
24043,2/1/20,75169,72039,3130,4.2
24045,2/1/20,50964,48401,2563,5
24047,2/1/20,25990,23537,2453,9.4
24510,2/1/20,290761,276872,13889,4.8
25001,2/1/20,108886,102225,6661,6.1
25003,2/1/20,64286,61514,2772,4.3
25005,2/1/20,305366,291381,13985,4.6
25007,2/1/20,8474,7857,617,7.3
25009,2/1/20,429565,415355,14210,3.3
25011,2/1/20,41417,40118,1299,3.1
25013,2/1/20,231760,221575,10185,4.4
25015,2/1/20,91548,88793,2755,3
25017,2/1/20,930144,907368,22776,2.4
25019,2/1/20,6278,5555,723,11.5
25021,2/1/20,396812,386012,10800,2.7
25023,2/1/20,286741,276458,10283,3.6
25025,2/1/20,462100,449833,12267,2.7
25027,2/1/20,451988,435929,16059,3.6
26001,2/1/20,3836,3557,279,7.3
26003,2/1/20,3101,2874,227,7.3
26005,2/1/20,62571,60738,1833,2.9
26007,2/1/20,13437,12821,616,4.6
26009,2/1/20,10194,9625,569,5.6
26011,2/1/20,5998,5564,434,7.2
26013,2/1/20,3307,3107,200,6
26015,2/1/20,32143,31141,1002,3.1
26017,2/1/20,49995,47688,2307,4.6
26019,2/1/20,8808,8291,517,5.9
26021,2/1/20,74016,71231,2785,3.8
26023,2/1/20,19399,18757,642,3.3
26025,2/1/20,63094,60828,2266,3.6
26027,2/1/20,24820,23851,969,3.9
26029,2/1/20,12367,11728,639,5.2
26031,2/1/20,10058,8620,1438,14.3
26033,2/1/20,16251,15194,1057,6.5
26035,2/1/20,11731,10967,764,6.5
26037,2/1/20,41998,40944,1054,2.5
26039,2/1/20,5674,5333,341,6
26041,2/1/20,17140,16217,923,5.4
26043,2/1/20,12312,11793,519,4.2
26045,2/1/20,58629,56944,1685,2.9
26047,2/1/20,17258,16174,1084,6.3
26049,2/1/20,185751,178182,7569,4.1
26051,2/1/20,9871,9295,576,5.8
26053,2/1/20,6124,5794,330,5.4
26055,2/1/20,49094,47361,1733,3.5
26057,2/1/20,18350,17632,718,3.9
26059,2/1/20,20435,19691,744,3.6
26061,2/1/20,16935,16201,734,4.3
26063,2/1/20,15242,14558,684,4.5
26065,2/1/20,154575,150313,4262,2.8
26067,2/1/20,30564,29673,891,2.9
26069,2/1/20,10170,9465,705,6.9
26071,2/1/20,5202,4889,313,6
26073,2/1/20,35101,33834,1267,3.6
26075,2/1/20,74964,72405,2559,3.4
26077,2/1/20,135889,132185,3704,2.7
26079,2/1/20,7880,7369,511,6.5
26081,2/1/20,365045,356339,8706,2.4
26083,2/1/20,911,862,49,5.4
26085,2/1/20,3859,3626,233,6
26087,2/1/20,41477,39114,2363,5.7
26089,2/1/20,10346,9943,403,3.9
26091,2/1/20,46981,45366,1615,3.4
26093,2/1/20,103655,100540,3115,3
26095,2/1/20,2299,2164,135,5.9
26097,2/1/20,4323,3549,774,17.9
26099,2/1/20,448060,431637,16423,3.7
26101,2/1/20,10231,9634,597,5.8
26103,2/1/20,33322,31759,1563,4.7
26105,2/1/20,13137,12448,689,5.2
26107,2/1/20,18513,17648,865,4.7
26109,2/1/20,11043,10622,421,3.8
26111,2/1/20,40298,38820,1478,3.7
26113,2/1/20,6939,6579,360,5.2
26115,2/1/20,76011,73441,2570,3.4
26117,2/1/20,28674,27614,1060,3.7
26119,2/1/20,2963,2684,279,9.4
26121,2/1/20,77797,74872,2925,3.8
26123,2/1/20,23525,22558,967,4.1
26125,2/1/20,675784,656260,19524,2.9
26127,2/1/20,11591,10817,774,6.7
26129,2/1/20,7805,7196,609,7.8
26131,2/1/20,2109,1976,133,6.3
26133,2/1/20,11495,11054,441,3.8
26135,2/1/20,2943,2753,190,6.5
26137,2/1/20,11582,11011,571,4.9
26139,2/1/20,163087,159359,3728,2.3
26141,2/1/20,4840,4339,501,10.4
26143,2/1/20,7489,6866,623,8.3
26145,2/1/20,87199,83372,3827,4.4
26147,2/1/20,75907,72367,3540,4.7
26149,2/1/20,27679,26787,892,3.2
26151,2/1/20,19429,18496,933,4.8
26153,2/1/20,3273,3021,252,7.7
26155,2/1/20,34008,32738,1270,3.7
26157,2/1/20,24163,22931,1232,5.1
26159,2/1/20,35590,33981,1609,4.5
26161,2/1/20,203716,199261,4455,2.2
26163,2/1/20,803865,768862,35003,4.4
26165,2/1/20,14972,14289,683,4.6
27001,2/1/20,7240,6667,573,7.9
27003,2/1/20,199879,193295,6584,3.3
27005,2/1/20,18622,17583,1039,5.6
27007,2/1/20,24592,23376,1216,4.9
27009,2/1/20,22422,21279,1143,5.1
27011,2/1/20,2379,2236,143,6
27013,2/1/20,41667,40444,1223,2.9
27015,2/1/20,14159,13483,676,4.8
27017,2/1/20,18087,17108,979,5.4
27019,2/1/20,58948,57290,1658,2.8
27021,2/1/20,13975,12896,1079,7.7
27023,2/1/20,6909,6566,343,5
27025,2/1/20,30553,29049,1504,4.9
27027,2/1/20,36606,35379,1227,3.4
27029,2/1/20,4576,4060,516,11.3
27031,2/1/20,2909,2746,163,5.6
27033,2/1/20,5888,5662,226,3.8
27035,2/1/20,31784,30009,1775,5.6
27037,2/1/20,243930,236793,7137,2.9
27039,2/1/20,11879,11382,497,4.2
27041,2/1/20,20944,20141,803,3.8
27043,2/1/20,6800,6437,363,5.3
27045,2/1/20,11488,10962,526,4.6
27047,2/1/20,16103,15503,600,3.7
27049,2/1/20,27124,26100,1024,3.8
27051,2/1/20,3213,3024,189,5.9
27053,2/1/20,711704,693511,18193,2.6
27055,2/1/20,10517,10092,425,4
27057,2/1/20,9761,9085,676,6.9
27059,2/1/20,21750,20588,1162,5.3
27061,2/1/20,22174,20658,1516,6.8
27063,2/1/20,5642,5429,213,3.8
27065,2/1/20,9219,8371,848,9.2
27067,2/1/20,23972,22888,1084,4.5
27069,2/1/20,2304,2198,106,4.6
27071,2/1/20,5733,5387,346,6
27073,2/1/20,3523,3324,199,5.6
27075,2/1/20,5377,5152,225,4.2
27077,2/1/20,2588,2490,98,3.8
27079,2/1/20,16501,15436,1065,6.5
27081,2/1/20,3160,2976,184,5.8
27083,2/1/20,14170,13633,537,3.8
27085,2/1/20,19167,18265,902,4.7
27087,2/1/20,2284,2132,152,6.7
27089,2/1/20,5322,4852,470,8.8
27091,2/1/20,9728,9350,378,3.9
27093,2/1/20,13350,12662,688,5.2
27095,2/1/20,13343,12298,1045,7.8
27097,2/1/20,17516,16181,1335,7.6
27099,2/1/20,20256,19566,690,3.4
27101,2/1/20,4624,4331,293,6.3
27103,2/1/20,21427,20861,566,2.6
27105,2/1/20,11076,10702,374,3.4
27107,2/1/20,3123,2939,184,5.9
27109,2/1/20,88968,86617,2351,2.6
27111,2/1/20,31109,29370,1739,5.6
27113,2/1/20,8757,8156,601,6.9
27115,2/1/20,15246,14049,1197,7.9
27117,2/1/20,4747,4517,230,4.8
27119,2/1/20,16522,15778,744,4.5
27121,2/1/20,6462,6223,239,3.7
27123,2/1/20,291941,283551,8390,2.9
27125,2/1/20,2221,2040,181,8.1
27127,2/1/20,7426,7108,318,4.3
27129,2/1/20,8226,7723,503,6.1
27131,2/1/20,37403,36062,1341,3.6
27133,2/1/20,5492,5352,140,2.5
27135,2/1/20,7900,7503,397,5
27137,2/1/20,102838,98351,4487,4.4
27139,2/1/20,84396,81954,2442,2.9
27141,2/1/20,53315,50986,2329,4.4
27143,2/1/20,8487,8071,416,4.9
27145,2/1/20,91501,88032,3469,3.8
27147,2/1/20,21447,20707,740,3.5
27149,2/1/20,5195,5026,169,3.3
27151,2/1/20,4779,4517,262,5.5
27153,2/1/20,13518,12791,727,5.4
27155,2/1/20,1690,1603,87,5.1
27157,2/1/20,12252,11723,529,4.3
27159,2/1/20,6054,5551,503,8.3
27161,2/1/20,8879,8429,450,5.1
27163,2/1/20,144715,140449,4266,2.9
27165,2/1/20,6252,5966,286,4.6
27167,2/1/20,3351,3230,121,3.6
27169,2/1/20,28711,27829,882,3.1
27171,2/1/20,76772,73715,3057,4
27173,2/1/20,5261,5035,226,4.3
28001,2/1/20,11119,10390,729,6.6
28003,2/1/20,16151,15424,727,4.5
28005,2/1/20,4352,4057,295,6.8
28007,2/1/20,6952,6514,438,6.3
28009,2/1/20,3031,2851,180,5.9
28011,2/1/20,11983,11135,848,7.1
28013,2/1/20,5539,5229,310,5.6
28015,2/1/20,3443,3232,211,6.1
28017,2/1/20,6756,6414,342,5.1
28019,2/1/20,3638,3450,188,5.2
28021,2/1/20,2951,2670,281,9.5
28023,2/1/20,5918,5560,358,6
28025,2/1/20,7608,7067,541,7.1
28027,2/1/20,8212,7553,659,8
28029,2/1/20,11024,10364,660,6
28031,2/1/20,8016,7635,381,4.8
28033,2/1/20,90647,86927,3720,4.1
28035,2/1/20,33263,31736,1527,4.6
28037,2/1/20,2730,2560,170,6.2
28039,2/1/20,8694,8096,598,6.9
28041,2/1/20,4306,3979,327,7.6
28043,2/1/20,9286,8841,445,4.8
28045,2/1/20,18769,17778,991,5.3
28047,2/1/20,86297,82103,4194,4.9
28049,2/1/20,105528,100454,5074,4.8
28051,2/1/20,5603,5081,522,9.3
28053,2/1/20,2228,1971,257,11.5
28055,2/1/20,366,335,31,8.5
28057,2/1/20,10501,9987,514,4.9
28059,2/1/20,58325,55066,3259,5.6
28061,2/1/20,6102,5663,439,7.2
28063,2/1/20,1942,1676,266,13.7
28065,2/1/20,4116,3845,271,6.6
28067,2/1/20,25799,24452,1347,5.2
28069,2/1/20,3513,3260,253,7.2
28071,2/1/20,28454,27360,1094,3.8
28073,2/1/20,30833,29592,1241,4
28075,2/1/20,30375,28880,1495,4.9
28077,2/1/20,4499,4234,265,5.9
28079,2/1/20,7821,7392,429,5.5
28081,2/1/20,40960,39271,1689,4.1
28083,2/1/20,9918,9196,722,7.3
28085,2/1/20,14376,13638,738,5.1
28087,2/1/20,25085,23816,1269,5.1
28089,2/1/20,52615,50490,2125,4
28091,2/1/20,9937,9406,531,5.3
28093,2/1/20,14368,13609,759,5.3
28095,2/1/20,15477,14687,790,5.1
28097,2/1/20,3889,3658,231,5.9
28099,2/1/20,9995,9412,583,5.8
28101,2/1/20,8803,8352,451,5.1
28103,2/1/20,3734,3471,263,7
28105,2/1/20,22048,20974,1074,4.9
28107,2/1/20,12311,11544,767,6.2
28109,2/1/20,23776,22634,1142,4.8
28111,2/1/20,4308,4021,287,6.7
28113,2/1/20,14277,13438,839,5.9
28115,2/1/20,14700,14098,602,4.1
28117,2/1/20,11202,10656,546,4.9
28119,2/1/20,2313,2134,179,7.7
28121,2/1/20,75331,72445,2886,3.8
28123,2/1/20,12497,11951,546,4.4
28125,2/1/20,1589,1445,144,9.1
28127,2/1/20,10646,10092,554,5.2
28129,2/1/20,6795,6444,351,5.2
28131,2/1/20,6847,6453,394,5.8
28133,2/1/20,7593,6887,706,9.3
28135,2/1/20,5209,4872,337,6.5
28137,2/1/20,12264,11625,639,5.2
28139,2/1/20,9359,8924,435,4.6
28141,2/1/20,8568,8082,486,5.7
28143,2/1/20,4412,4141,271,6.1
28145,2/1/20,14289,13711,578,4
28147,2/1/20,4746,4435,311,6.6
28149,2/1/20,19913,18855,1058,5.3
28151,2/1/20,16709,15471,1238,7.4
28153,2/1/20,7377,6932,445,6
28155,2/1/20,3936,3716,220,5.6
28157,2/1/20,2777,2514,263,9.5
28159,2/1/20,7359,6928,431,5.9
28161,2/1/20,4947,4692,255,5.2
28163,2/1/20,9275,8722,553,6
29001,2/1/20,10244,9863,381,3.7
29003,2/1/20,9789,9463,326,3.3
29005,2/1/20,2710,2627,83,3.1
29007,2/1/20,10734,10303,431,4
29009,2/1/20,15825,15146,679,4.3
29011,2/1/20,5274,5100,174,3.3
29013,2/1/20,8001,7646,355,4.4
29015,2/1/20,7288,6825,463,6.4
29017,2/1/20,5581,5342,239,4.3
29019,2/1/20,99069,96547,2522,2.5
29021,2/1/20,44586,42988,1598,3.6
29023,2/1/20,18119,17291,828,4.6
29025,2/1/20,4436,4267,169,3.8
29027,2/1/20,21392,20647,745,3.5
29029,2/1/20,17790,16557,1233,6.9
29031,2/1/20,41329,39997,1332,3.2
29033,2/1/20,4895,4721,174,3.6
29035,2/1/20,2554,2387,167,6.5
29037,2/1/20,55204,53290,1914,3.5
29039,2/1/20,5822,5598,224,3.8
29041,2/1/20,3799,3657,142,3.7
29043,2/1/20,45494,44031,1463,3.2
29045,2/1/20,3255,3103,152,4.7
29047,2/1/20,136713,132637,4076,3
29049,2/1/20,10802,10442,360,3.3
29051,2/1/20,38925,37789,1136,2.9
29053,2/1/20,7538,7234,304,4
29055,2/1/20,11058,10539,519,4.7
29057,2/1/20,3610,3476,134,3.7
29059,2/1/20,7158,6832,326,4.6
29061,2/1/20,4169,4013,156,3.7
29063,2/1/20,4886,4686,200,4.1
29065,2/1/20,6297,6043,254,4
29067,2/1/20,5121,4871,250,4.9
29069,2/1/20,11760,10968,792,6.7
29071,2/1/20,53489,51412,2077,3.9
29073,2/1/20,7706,7429,277,3.6
29075,2/1/20,3534,3434,100,2.8
29077,2/1/20,152851,148192,4659,3
29079,2/1/20,4452,4298,154,3.5
29081,2/1/20,3888,3692,196,5
29083,2/1/20,9789,9358,431,4.4
29085,2/1/20,3827,3632,195,5.1
29087,2/1/20,2589,2509,80,3.1
29089,2/1/20,4910,4741,169,3.4
29091,2/1/20,16674,16001,673,4
29093,2/1/20,3566,3361,205,5.7
29095,2/1/20,364237,349858,14379,3.9
29097,2/1/20,57903,56096,1807,3.1
29099,2/1/20,118687,114189,4498,3.8
29101,2/1/20,23547,22527,1020,4.3
29103,2/1/20,1807,1719,88,4.9
29105,2/1/20,17271,16238,1033,6
29107,2/1/20,17032,16382,650,3.8
29109,2/1/20,18220,17457,763,4.2
29111,2/1/20,5009,4826,183,3.7
29113,2/1/20,28562,27459,1103,3.9
29115,2/1/20,5157,4879,278,5.4
29117,2/1/20,7440,7208,232,3.1
29119,2/1/20,10922,10564,358,3.3
29121,2/1/20,7642,7331,311,4.1
29123,2/1/20,5533,5283,250,4.5
29125,2/1/20,3931,3784,147,3.7
29127,2/1/20,14413,13917,496,3.4
29129,2/1/20,1940,1861,79,4.1
29131,2/1/20,12292,11608,684,5.6
29133,2/1/20,5855,5596,259,4.4
29135,2/1/20,7362,7098,264,3.6
29137,2/1/20,3894,3702,192,4.9
29139,2/1/20,5803,5584,219,3.8
29141,2/1/20,8167,7684,483,5.9
29143,2/1/20,8457,8044,413,4.9
29145,2/1/20,27717,26782,935,3.4
29147,2/1/20,11098,10735,363,3.3
29149,2/1/20,4096,3903,193,4.7
29151,2/1/20,7112,6932,180,2.5
29153,2/1/20,3362,3161,201,6
29155,2/1/20,6451,6071,380,5.9
29157,2/1/20,10008,9702,306,3.1
29159,2/1/20,21792,20463,1329,6.1
29161,2/1/20,19941,19175,766,3.8
29163,2/1/20,7481,7180,301,4
29165,2/1/20,58823,57216,1607,2.7
29167,2/1/20,14730,14236,494,3.4
29169,2/1/20,14805,14206,599,4
29171,2/1/20,2307,2215,92,4
29173,2/1/20,5638,5427,211,3.7
29175,2/1/20,10618,10168,450,4.2
29177,2/1/20,11061,10645,416,3.8
29179,2/1/20,3010,2881,129,4.3
29181,2/1/20,5016,4767,249,5
29183,2/1/20,227080,220591,6489,2.9
29185,2/1/20,3777,3592,185,4.9
29186,2/1/20,9220,8852,368,4
29187,2/1/20,26769,25427,1342,5
29189,2/1/20,532488,515220,17268,3.2
29195,2/1/20,10729,10284,445,4.1
29197,2/1/20,1969,1871,98,5
29199,2/1/20,2421,2347,74,3.1
29201,2/1/20,20129,19312,817,4.1
29203,2/1/20,3208,3005,203,6.3
29205,2/1/20,3178,3034,144,4.5
29207,2/1/20,13224,12536,688,5.2
29209,2/1/20,12977,11558,1419,10.9
29211,2/1/20,2751,2623,128,4.7
29213,2/1/20,25556,22372,3184,12.5
29215,2/1/20,9125,8688,437,4.8
29217,2/1/20,9586,9234,352,3.7
29219,2/1/20,18087,17422,665,3.7
29221,2/1/20,10336,9704,632,6.1
29223,2/1/20,5205,4943,262,5
29225,2/1/20,17527,16846,681,3.9
29227,2/1/20,1187,1153,34,2.9
29229,2/1/20,7652,7249,403,5.3
29510,2/1/20,152750,146635,6115,4
30001,2/1/20,5025,4854,171,3.4
30003,2/1/20,4657,4311,346,7.4
30005,2/1/20,2530,2425,105,4.2
30007,2/1/20,2595,2465,130,5
30009,2/1/20,5510,5259,251,4.6
30011,2/1/20,628,613,15,2.4
30013,2/1/20,38072,36644,1428,3.8
30015,2/1/20,2451,2369,82,3.3
30017,2/1/20,6129,5875,254,4.1
30019,2/1/20,896,869,27,3
30021,2/1/20,4568,4433,135,3
30023,2/1/20,4999,4807,192,3.8
30025,2/1/20,1689,1655,34,2
30027,2/1/20,6076,5797,279,4.6
30029,2/1/20,47777,44820,2957,6.2
30031,2/1/20,69577,67843,1734,2.5
30033,2/1/20,730,708,22,3
30035,2/1/20,5420,4973,447,8.2
30037,2/1/20,368,350,18,4.9
30039,2/1/20,1729,1610,119,6.9
30041,2/1/20,7627,7356,271,3.6
30043,2/1/20,5710,5481,229,4
30045,2/1/20,985,943,42,4.3
30047,2/1/20,13259,12531,728,5.5
30049,2/1/20,35833,34557,1276,3.6
30051,2/1/20,953,925,28,2.9
30053,2/1/20,8043,7263,780,9.7
30055,2/1/20,951,931,20,2.1
30057,2/1/20,5554,5351,203,3.7
30059,2/1/20,1008,970,38,3.8
30061,2/1/20,1771,1590,181,10.2
30063,2/1/20,64477,61912,2565,4
30065,2/1/20,2293,2165,128,5.6
30067,2/1/20,8696,8307,389,4.5
30069,2/1/20,283,269,14,4.9
30071,2/1/20,1876,1790,86,4.6
30073,2/1/20,2641,2551,90,3.4
30075,2/1/20,956,927,29,3
30077,2/1/20,2920,2797,123,4.2
30079,2/1/20,484,460,24,5
30081,2/1/20,20339,19326,1013,5
30083,2/1/20,5904,5724,180,3
30085,2/1/20,4493,4271,222,4.9
30087,2/1/20,3765,3581,184,4.9
30089,2/1/20,4818,4436,382,7.9
30091,2/1/20,1727,1680,47,2.7
30093,2/1/20,17169,16390,779,4.5
30095,2/1/20,5334,5150,184,3.4
30097,2/1/20,1803,1750,53,2.9
30099,2/1/20,2743,2628,115,4.2
30101,2/1/20,2093,2023,70,3.3
30103,2/1/20,335,327,8,2.4
30105,2/1/20,4020,3871,149,3.7
30107,2/1/20,785,747,38,4.8
30109,2/1/20,451,438,13,2.9
30111,2/1/20,81633,78642,2991,3.7
31001,2/1/20,16817,16282,535,3.2
31003,2/1/20,3597,3495,102,2.8
31005,2/1/20,232,218,14,6
31007,2/1/20,389,377,12,3.1
31009,2/1/20,265,253,12,4.5
31011,2/1/20,2978,2893,85,2.9
31013,2/1/20,5354,5192,162,3
31015,2/1/20,1103,1070,33,3
31017,2/1/20,1403,1361,42,3
31019,2/1/20,27790,27085,705,2.5
31021,2/1/20,3490,3347,143,4.1
31023,2/1/20,4511,4382,129,2.9
31025,2/1/20,13690,13236,454,3.3
31027,2/1/20,4506,4388,118,2.6
31029,2/1/20,2304,2260,44,1.9
31031,2/1/20,3356,3277,79,2.4
31033,2/1/20,4275,4134,141,3.3
31035,2/1/20,3309,3207,102,3.1
31037,2/1/20,5572,5437,135,2.4
31039,2/1/20,4691,4575,116,2.5
31041,2/1/20,6435,6302,133,2.1
31043,2/1/20,10829,10375,454,4.2
31045,2/1/20,4905,4789,116,2.4
31047,2/1/20,13176,12769,407,3.1
31049,2/1/20,955,934,21,2.2
31051,2/1/20,3065,2967,98,3.2
31053,2/1/20,19529,18959,570,2.9
31055,2/1/20,301776,291999,9777,3.2
31057,2/1/20,1195,1168,27,2.3
31059,2/1/20,3117,3047,70,2.2
31061,2/1/20,1460,1418,42,2.9
31063,2/1/20,1646,1586,60,3.6
31065,2/1/20,2537,2475,62,2.4
31067,2/1/20,11049,10667,382,3.5
31069,2/1/20,1088,1049,39,3.6
31071,2/1/20,1155,1128,27,2.3
31073,2/1/20,1098,1075,23,2.1
31075,2/1/20,438,428,10,2.3
31077,2/1/20,1226,1191,35,2.9
31079,2/1/20,31836,30652,1184,3.7
31081,2/1/20,4768,4629,139,2.9
31083,2/1/20,1773,1719,54,3
31085,2/1/20,633,614,19,3
31087,2/1/20,1267,1223,44,3.5
31089,2/1/20,5818,5667,151,2.6
31091,2/1/20,374,362,12,3.2
31093,2/1/20,3348,3248,100,3
31095,2/1/20,4191,4081,110,2.6
31097,2/1/20,2080,2005,75,3.6
31099,2/1/20,3832,3745,87,2.3
31101,2/1/20,4462,4327,135,3
31103,2/1/20,616,602,14,2.3
31105,2/1/20,2022,1968,54,2.7
31107,2/1/20,4656,4494,162,3.5
31109,2/1/20,180227,175461,4766,2.6
31111,2/1/20,18173,17569,604,3.3
31113,2/1/20,479,467,12,2.5
31115,2/1/20,415,398,17,4.1
31117,2/1/20,444,430,14,3.2
31119,2/1/20,19803,19212,591,3
31121,2/1/20,4008,3890,118,2.9
31123,2/1/20,2649,2549,100,3.8
31125,2/1/20,1992,1936,56,2.8
31127,2/1/20,3618,3516,102,2.8
31129,2/1/20,2458,2379,79,3.2
31131,2/1/20,8469,8237,232,2.7
31133,2/1/20,1489,1452,37,2.5
31135,2/1/20,1835,1798,37,2
31137,2/1/20,5004,4888,116,2.3
31139,2/1/20,4076,3968,108,2.6
31141,2/1/20,17738,17240,498,2.8
31143,2/1/20,2976,2876,100,3.4
31145,2/1/20,5878,5714,164,2.8
31147,2/1/20,4213,4087,126,3
31149,2/1/20,892,871,21,2.4
31151,2/1/20,7460,7195,265,3.6
31153,2/1/20,97288,94501,2787,2.9
31155,2/1/20,11281,10970,311,2.8
31157,2/1/20,18002,17392,610,3.4
31159,2/1/20,9110,8855,255,2.8
31161,2/1/20,2690,2622,68,2.5
31163,2/1/20,1697,1641,56,3.3
31165,2/1/20,745,728,17,2.3
31167,2/1/20,3531,3431,100,2.8
31169,2/1/20,2769,2701,68,2.5
31171,2/1/20,435,414,21,4.8
31173,2/1/20,3101,2987,114,3.7
31175,2/1/20,2127,2065,62,2.9
31177,2/1/20,11372,11053,319,2.8
31179,2/1/20,5923,5778,145,2.4
31181,2/1/20,1698,1638,60,3.5
31183,2/1/20,566,554,12,2.1
31185,2/1/20,7207,7029,178,2.5
32001,2/1/20,11338,10928,410,3.6
32003,2/1/20,1154157,1109543,44614,3.9
32005,2/1/20,23517,22592,925,3.9
32007,2/1/20,27035,26153,882,3.3
32009,2/1/20,460,442,18,3.9
32011,2/1/20,1102,1076,26,2.4
32013,2/1/20,8308,8036,272,3.3
32015,2/1/20,3262,3141,121,3.7
32017,2/1/20,2155,2073,82,3.8
32019,2/1/20,23633,22463,1170,5
32021,2/1/20,2023,1943,80,4
32023,2/1/20,17919,17041,878,4.9
32027,2/1/20,2592,2478,114,4.4
32029,2/1/20,2085,2007,78,3.7
32031,2/1/20,261709,253303,8406,3.2
32033,2/1/20,4693,4536,157,3.3
32510,2/1/20,26934,25829,1105,4.1
33001,2/1/20,31039,30056,983,3.2
33003,2/1/20,23718,22968,750,3.2
33005,2/1/20,41500,40197,1303,3.1
33007,2/1/20,14724,14114,610,4.1
33009,2/1/20,51045,49751,1294,2.5
33011,2/1/20,245905,238128,7777,3.2
33013,2/1/20,84821,82594,2227,2.6
33015,2/1/20,188982,182684,6298,3.3
33017,2/1/20,75410,73328,2082,2.8
33019,2/1/20,23061,22433,628,2.7
34001,2/1/20,121118,113397,7721,6.4
34003,2/1/20,493851,477115,16736,3.4
34005,2/1/20,234778,226030,8748,3.7
34007,2/1/20,258078,246321,11757,4.6
34009,2/1/20,41936,36860,5076,12.1
34011,2/1/20,66372,61829,4543,6.8
34013,2/1/20,376330,357495,18835,5
34015,2/1/20,152835,146246,6589,4.3
34017,2/1/20,369656,356227,13429,3.6
34019,2/1/20,65675,63446,2229,3.4
34021,2/1/20,207712,200211,7501,3.6
34023,2/1/20,447460,431590,15870,3.5
34025,2/1/20,335404,322823,12581,3.8
34027,2/1/20,261687,253045,8642,3.3
34029,2/1/20,281795,268846,12949,4.6
34031,2/1/20,248766,236200,12566,5.1
34033,2/1/20,29635,27918,1717,5.8
34035,2/1/20,174627,168547,6080,3.5
34037,2/1/20,75675,72330,3345,4.4
34039,2/1/20,282211,270033,12178,4.3
34041,2/1/20,57157,54784,2373,4.2
35001,2/1/20,336256,321283,14973,4.5
35003,2/1/20,1134,1038,96,8.5
35005,2/1/20,27313,25978,1335,4.9
35006,2/1/20,8998,8418,580,6.4
35007,2/1/20,5293,5044,249,4.7
35009,2/1/20,21569,20698,871,4
35011,2/1/20,701,671,30,4.3
35013,2/1/20,98822,92645,6177,6.3
35015,2/1/20,36375,35244,1131,3.1
35017,2/1/20,12181,11589,592,4.9
35019,2/1/20,1462,1390,72,4.9
35021,2/1/20,286,273,13,4.5
35023,2/1/20,2000,1906,94,4.7
35025,2/1/20,32614,31273,1341,4.1
35027,2/1/20,8673,8235,438,5.1
35028,2/1/20,9462,9159,303,3.2
35029,2/1/20,9906,8195,1711,17.3
35031,2/1/20,24344,22642,1702,7
35033,2/1/20,2070,1923,147,7.1
35035,2/1/20,24950,23695,1255,5
35037,2/1/20,3156,2993,163,5.2
35039,2/1/20,16637,15683,954,5.7
35041,2/1/20,7957,7609,348,4.4
35043,2/1/20,66625,63408,3217,4.8
35045,2/1/20,51746,48498,3248,6.3
35047,2/1/20,11051,10406,645,5.8
35049,2/1/20,76429,73383,3046,4
35051,2/1/20,3785,3469,316,8.3
35053,2/1/20,6298,5955,343,5.4
35055,2/1/20,15603,14639,964,6.2
35057,2/1/20,5447,5063,384,7
35059,2/1/20,1668,1598,70,4.2
35061,2/1/20,30800,29155,1645,5.3
36001,2/1/20,160026,154137,5889,3.7
36003,2/1/20,20241,18985,1256,6.2
36005,2/1/20,598053,570227,27826,4.7
36007,2/1/20,84242,79672,4570,5.4
36009,2/1/20,34978,32855,2123,6.1
36011,2/1/20,35712,33882,1830,5.1
36013,2/1/20,54696,51619,3077,5.6
36015,2/1/20,35341,33665,1676,4.7
36017,2/1/20,22131,20908,1223,5.5
36019,2/1/20,36572,34732,1840,5
36021,2/1/20,31021,29851,1170,3.8
36023,2/1/20,23582,22203,1379,5.8
36025,2/1/20,19217,18172,1045,5.4
36027,2/1/20,145188,139584,5604,3.9
36029,2/1/20,443704,422841,20863,4.7
36031,2/1/20,17504,16482,1022,5.8
36033,2/1/20,19897,18774,1123,5.6
36035,2/1/20,22953,21627,1326,5.8
36037,2/1/20,29672,28223,1449,4.9
36039,2/1/20,20999,19954,1045,5
36041,2/1/20,2134,1948,186,8.7
36043,2/1/20,28127,26489,1638,5.8
36045,2/1/20,43730,40633,3097,7.1
36047,2/1/20,1201414,1159560,41854,3.5
36049,2/1/20,11874,10991,883,7.4
36051,2/1/20,31068,29522,1546,5
36053,2/1/20,33071,31356,1715,5.2
36055,2/1/20,364870,349037,15833,4.3
36057,2/1/20,22483,21115,1368,6.1
36059,2/1/20,711904,686958,24946,3.5
36061,2/1/20,915196,887523,27673,3
36063,2/1/20,99662,93880,5782,5.8
36065,2/1/20,101316,96698,4618,4.6
36067,2/1/20,222566,213096,9470,4.3
36069,2/1/20,56048,53544,2504,4.5
36071,2/1/20,184812,177324,7488,4.1
36073,2/1/20,17708,16739,969,5.5
36075,2/1/20,53757,50330,3427,6.4
36077,2/1/20,28215,26765,1450,5.1
36079,2/1/20,51702,49653,2049,4
36081,2/1/20,1143625,1109397,34228,3
36083,2/1/20,82638,79274,3364,4.1
36085,2/1/20,222831,215430,7401,3.3
36087,2/1/20,155259,149588,5671,3.7
36089,2/1/20,44014,41357,2657,6
36091,2/1/20,121118,116735,4383,3.6
36093,2/1/20,77355,74285,3070,4
36095,2/1/20,14994,14109,885,5.9
36097,2/1/20,8017,7505,512,6.4
36099,2/1/20,16142,15369,773,4.8
36101,2/1/20,42772,40433,2339,5.5
36103,2/1/20,783835,752302,31533,4
36105,2/1/20,37040,35340,1700,4.6
36107,2/1/20,22916,21758,1158,5.1
36109,2/1/20,50164,48378,1786,3.6
36111,2/1/20,88633,85016,3617,4.1
36113,2/1/20,31331,29661,1670,5.3
36115,2/1/20,27730,26395,1335,4.8
36117,2/1/20,44351,42178,2173,4.9
36119,2/1/20,484989,466140,18849,3.9
36121,2/1/20,18043,16964,1079,6
36123,2/1/20,11959,11372,587,4.9
37001,2/1/20,83133,80174,2959,3.6
37003,2/1/20,18294,17747,547,3
37005,2/1/20,4428,4199,229,5.2
37007,2/1/20,11098,10603,495,4.5
37009,2/1/20,13042,12538,504,3.9
37011,2/1/20,7350,7060,290,3.9
37013,2/1/20,19604,18736,868,4.4
37015,2/1/20,7899,7483,416,5.3
37017,2/1/20,14862,14144,718,4.8
37019,2/1/20,53772,50966,2806,5.2
37021,2/1/20,142698,138555,4143,2.9
37023,2/1/20,41669,40211,1458,3.5
37025,2/1/20,111270,107501,3769,3.4
37027,2/1/20,37083,35738,1345,3.6
37029,2/1/20,4659,4490,169,3.6
37031,2/1/20,31808,30483,1325,4.2
37033,2/1/20,10017,9587,430,4.3
37035,2/1/20,80096,77360,2736,3.4
37037,2/1/20,36659,35498,1161,3.2
37039,2/1/20,11190,10697,493,4.4
37041,2/1/20,5598,5355,243,4.3
37043,2/1/20,4148,3972,176,4.2
37045,2/1/20,49651,47707,1944,3.9
37047,2/1/20,23251,22103,1148,4.9
37049,2/1/20,42194,40610,1584,3.8
37051,2/1/20,128595,122294,6301,4.9
37053,2/1/20,14143,13592,551,3.9
37055,2/1/20,17923,16524,1399,7.8
37057,2/1/20,82142,79160,2982,3.6
37059,2/1/20,20964,20275,689,3.3
37061,2/1/20,26183,25197,986,3.8
37063,2/1/20,174924,169476,5448,3.1
37065,2/1/20,21479,20341,1138,5.3
37067,2/1/20,190155,183477,6678,3.5
37069,2/1/20,32126,30920,1206,3.8
37071,2/1/20,113431,109106,4325,3.8
37073,2/1/20,5355,5144,211,3.9
37075,2/1/20,3090,2892,198,6.4
37077,2/1/20,30489,29517,972,3.2
37079,2/1/20,9712,9370,342,3.5
37081,2/1/20,265716,255466,10250,3.9
37083,2/1/20,20701,19481,1220,5.9
37085,2/1/20,54314,52035,2279,4.2
37087,2/1/20,30475,29422,1053,3.5
37089,2/1/20,55977,54229,1748,3.1
37091,2/1/20,9250,8782,468,5.1
37093,2/1/20,20327,19344,983,4.8
37095,2/1/20,1814,1573,241,13.3
37097,2/1/20,91450,88226,3224,3.5
37099,2/1/20,19679,18862,817,4.2
37101,2/1/20,101811,98379,3432,3.4
37103,2/1/20,4478,4318,160,3.6
37105,2/1/20,26107,25040,1067,4.1
37107,2/1/20,28179,27160,1019,3.6
37109,2/1/20,44478,42952,1526,3.4
37111,2/1/20,20801,20014,787,3.8
37113,2/1/20,15373,14730,643,4.2
37115,2/1/20,10345,9972,373,3.6
37117,2/1/20,9107,8689,418,4.6
37119,2/1/20,634202,612420,21782,3.4
37121,2/1/20,6007,5708,299,5
37123,2/1/20,11675,11236,439,3.8
37125,2/1/20,43022,41483,1539,3.6
37127,2/1/20,43781,41825,1956,4.5
37129,2/1/20,126103,121805,4298,3.4
37131,2/1/20,7899,7467,432,5.5
37133,2/1/20,66647,63830,2817,4.2
37135,2/1/20,80673,78303,2370,2.9
37137,2/1/20,5408,5219,189,3.5
37139,2/1/20,16776,16011,765,4.6
37141,2/1/20,29429,28329,1100,3.7
37143,2/1/20,5013,4777,236,4.7
37145,2/1/20,18878,18133,745,3.9
37147,2/1/20,91120,87605,3515,3.9
37149,2/1/20,9045,8726,319,3.5
37151,2/1/20,67182,64786,2396,3.6
37153,2/1/20,16867,15978,889,5.3
37155,2/1/20,51077,48482,2595,5.1
37157,2/1/20,40722,38998,1724,4.2
37159,2/1/20,67752,65059,2693,4
37161,2/1/20,25674,24423,1251,4.9
37163,2/1/20,30186,29056,1130,3.7
37165,2/1/20,11792,11013,779,6.6
37167,2/1/20,30733,29604,1129,3.7
37169,2/1/20,22070,21291,779,3.5
37171,2/1/20,34201,32957,1244,3.6
37173,2/1/20,6728,6406,322,4.8
37175,2/1/20,14664,14158,506,3.5
37177,2/1/20,1335,1238,97,7.3
37179,2/1/20,126547,122420,4127,3.3
37181,2/1/20,17489,16533,956,5.5
37183,2/1/20,611060,592098,18962,3.1
37185,2/1/20,6737,6370,367,5.4
37187,2/1/20,4447,4152,295,6.6
37189,2/1/20,29828,28888,940,3.2
37191,2/1/20,52631,50574,2057,3.9
37193,2/1/20,29309,28135,1174,4
37195,2/1/20,35134,33267,1867,5.3
37197,2/1/20,18044,17428,616,3.4
37199,2/1/20,8524,8182,342,4
38001,2/1/20,1059,1027,32,3
38003,2/1/20,5148,5013,135,2.6
38005,2/1/20,2293,2187,106,4.6
38007,2/1/20,351,341,10,2.8
38009,2/1/20,2841,2721,120,4.2
38011,2/1/20,1695,1662,33,1.9
38013,2/1/20,1037,1007,30,2.9
38015,2/1/20,49194,47786,1408,2.9
38017,2/1/20,103062,100712,2350,2.3
38019,2/1/20,1837,1774,63,3.4
38021,2/1/20,2234,2190,44,2
38023,2/1/20,1345,1326,19,1.4
38025,2/1/20,3137,3083,54,1.7
38027,2/1/20,1180,1125,55,4.7
38029,2/1/20,1414,1332,82,5.8
38031,2/1/20,1442,1399,43,3
38033,2/1/20,811,794,17,2.1
38035,2/1/20,37093,36230,863,2.3
38037,2/1/20,1174,1143,31,2.6
38039,2/1/20,988,966,22,2.2
38041,2/1/20,1306,1271,35,2.7
38043,2/1/20,1233,1167,66,5.4
38045,2/1/20,1978,1931,47,2.4
38047,2/1/20,866,835,31,3.6
38049,2/1/20,3008,2853,155,5.2
38051,2/1/20,1090,1054,36,3.3
38053,2/1/20,10267,10063,204,2
38055,2/1/20,4519,4321,198,4.4
38057,2/1/20,3348,3159,189,5.6
38059,2/1/20,16261,15643,618,3.8
38061,2/1/20,7344,7223,121,1.6
38063,2/1/20,1350,1298,52,3.9
38065,2/1/20,867,817,50,5.8
38067,2/1/20,3207,3072,135,4.2
38069,2/1/20,1663,1599,64,3.8
38071,2/1/20,5402,5220,182,3.4
38073,2/1/20,2771,2710,61,2.2
38075,2/1/20,1199,1158,41,3.4
38077,2/1/20,8394,8185,209,2.5
38079,2/1/20,4557,4162,395,8.7
38081,2/1/20,2607,2565,42,1.6
38083,2/1/20,659,607,52,7.9
38085,2/1/20,1204,1168,36,3
38087,2/1/20,387,378,9,2.3
38089,2/1/20,18147,17696,451,2.5
38091,2/1/20,938,921,17,1.8
38093,2/1/20,10055,9788,267,2.7
38095,2/1/20,1028,999,29,2.8
38097,2/1/20,4311,4195,116,2.7
38099,2/1/20,4928,4757,171,3.5
38101,2/1/20,30942,29980,962,3.1
38103,2/1/20,1829,1743,86,4.7
38105,2/1/20,23774,23280,494,2.1
39001,2/1/20,10946,10006,940,8.6
39003,2/1/20,48084,45744,2340,4.9
39005,2/1/20,27418,26111,1307,4.8
39007,2/1/20,44761,42065,2696,6
39009,2/1/20,29728,28128,1600,5.4
39011,2/1/20,25205,24297,908,3.6
39013,2/1/20,30041,27683,2358,7.8
39015,2/1/20,19918,18676,1242,6.2
39017,2/1/20,196194,188212,7982,4.1
39019,2/1/20,13157,12317,840,6.4
39021,2/1/20,20398,19545,853,4.2
39023,2/1/20,63996,60825,3171,5
39025,2/1/20,107586,103059,4527,4.2
39027,2/1/20,18166,17205,961,5.3
39029,2/1/20,47701,44911,2790,5.8
39031,2/1/20,14293,13308,985,6.9
39033,2/1/20,18381,17399,982,5.3
39035,2/1/20,610371,579164,31207,5.1
39037,2/1/20,26125,24960,1165,4.5
39039,2/1/20,18101,17266,835,4.6
39041,2/1/20,111885,108227,3658,3.3
39043,2/1/20,35697,33548,2149,6
39045,2/1/20,79466,76188,3278,4.1
39047,2/1/20,14080,13472,608,4.3
39049,2/1/20,707424,681575,25849,3.7
39051,2/1/20,22808,21616,1192,5.2
39053,2/1/20,12534,11661,873,7
39055,2/1/20,49065,46808,2257,4.6
39057,2/1/20,83757,80479,3278,3.9
39059,2/1/20,18758,17336,1422,7.6
39061,2/1/20,417725,401045,16680,4
39063,2/1/20,42295,40849,1446,3.4
39065,2/1/20,13962,13299,663,4.7
39067,2/1/20,6711,6233,478,7.1
39069,2/1/20,13321,12513,808,6.1
39071,2/1/20,17348,16278,1070,6.2
39073,2/1/20,13394,12632,762,5.7
39075,2/1/20,20904,20209,695,3.3
39077,2/1/20,28211,25989,2222,7.9
39079,2/1/20,12920,11879,1041,8.1
39081,2/1/20,27724,25770,1954,7
39083,2/1/20,32119,30717,1402,4.4
39085,2/1/20,126382,120116,6266,5
39087,2/1/20,24082,22663,1419,5.9
39089,2/1/20,92094,88333,3761,4.1
39091,2/1/20,23189,22215,974,4.2
39093,2/1/20,153941,145353,8588,5.6
39095,2/1/20,210832,200280,10552,5
39097,2/1/20,21251,20456,795,3.7
39099,2/1/20,102573,96111,6462,6.3
39101,2/1/20,28429,27201,1228,4.3
39103,2/1/20,97352,93074,4278,4.4
39105,2/1/20,9255,8436,819,8.8
39107,2/1/20,23441,22710,731,3.1
39109,2/1/20,54685,52391,2294,4.2
39111,2/1/20,5467,4862,605,11.1
39113,2/1/20,254038,242711,11327,4.5
39115,2/1/20,6880,6255,625,9.1
39117,2/1/20,17188,16341,847,4.9
39119,2/1/20,40083,37555,2528,6.3
39121,2/1/20,4725,4302,423,9
39123,2/1/20,20372,18699,1673,8.2
39125,2/1/20,8728,8271,457,5.2
39127,2/1/20,16393,15314,1079,6.6
39129,2/1/20,27056,25792,1264,4.7
39131,2/1/20,10949,10093,856,7.8
39133,2/1/20,87756,83405,4351,5
39135,2/1/20,21285,20326,959,4.5
39137,2/1/20,18953,18243,710,3.7
39139,2/1/20,52476,49745,2731,5.2
39141,2/1/20,35934,34014,1920,5.3
39143,2/1/20,30600,29042,1558,5.1
39145,2/1/20,29379,27106,2273,7.7
39147,2/1/20,27516,26215,1301,4.7
39149,2/1/20,24011,23025,986,4.1
39151,2/1/20,186802,176912,9890,5.3
39153,2/1/20,273136,259938,13198,4.8
39155,2/1/20,86368,80509,5859,6.8
39157,2/1/20,45010,42549,2461,5.5
39159,2/1/20,29507,28485,1022,3.5
39161,2/1/20,15340,14680,660,4.3
39163,2/1/20,5725,5244,481,8.4
39165,2/1/20,119729,115266,4463,3.7
39167,2/1/20,27662,25784,1878,6.8
39169,2/1/20,63496,61199,2297,3.6
39171,2/1/20,19005,18282,723,3.8
39173,2/1/20,71399,68575,2824,4
39175,2/1/20,13226,12743,483,3.7
40001,2/1/20,7997,7698,299,3.7
40003,2/1/20,2825,2765,60,2.1
40005,2/1/20,4966,4740,226,4.6
40007,2/1/20,2887,2838,49,1.7
40009,2/1/20,9713,9310,403,4.1
40011,2/1/20,4696,4586,110,2.3
40013,2/1/20,21573,20989,584,2.7
40015,2/1/20,11708,11290,418,3.6
40017,2/1/20,74424,72403,2021,2.7
40019,2/1/20,21277,20576,701,3.3
40021,2/1/20,18770,18104,666,3.5
40023,2/1/20,5436,5176,260,4.8
40025,2/1/20,1329,1309,20,1.5
40027,2/1/20,142830,139365,3465,2.4
40029,2/1/20,2522,2421,101,4
40031,2/1/20,48016,46590,1426,3
40033,2/1/20,2707,2639,68,2.5
40035,2/1/20,5807,5601,206,3.5
40037,2/1/20,31372,30315,1057,3.4
40039,2/1/20,15871,15442,429,2.7
40041,2/1/20,17981,17364,617,3.4
40043,2/1/20,2904,2839,65,2.2
40045,2/1/20,2121,2072,49,2.3
40047,2/1/20,26416,25633,783,3
40049,2/1/20,12511,12080,431,3.4
40051,2/1/20,26594,25754,840,3.2
40053,2/1/20,2593,2540,53,2
40055,2/1/20,1789,1726,63,3.5
40057,2/1/20,1153,1123,30,2.6
40059,2/1/20,1738,1696,42,2.4
40061,2/1/20,4231,3999,232,5.5
40063,2/1/20,5343,5081,262,4.9
40065,2/1/20,10696,10422,274,2.6
40067,2/1/20,2530,2446,84,3.3
40069,2/1/20,3297,3130,167,5.1
40071,2/1/20,17978,17302,676,3.8
40073,2/1/20,9163,8978,185,2
40075,2/1/20,3441,3340,101,2.9
40077,2/1/20,3121,2896,225,7.2
40079,2/1/20,18963,18157,806,4.3
40081,2/1/20,15788,15283,505,3.2
40083,2/1/20,22119,21528,591,2.7
40085,2/1/20,6172,6036,136,2.2
40087,2/1/20,19661,19165,496,2.5
40089,2/1/20,14707,13970,737,5
40091,2/1/20,7155,6705,450,6.3
40093,2/1/20,3829,3751,78,2
40095,2/1/20,6909,6682,227,3.3
40097,2/1/20,19347,18804,543,2.8
40099,2/1/20,6306,6121,185,2.9
40101,2/1/20,29718,28688,1030,3.5
40103,2/1/20,5645,5512,133,2.4
40105,2/1/20,4588,4454,134,2.9
40107,2/1/20,4606,4386,220,4.8
40109,2/1/20,384589,374238,10351,2.7
40111,2/1/20,15555,14864,691,4.4
40113,2/1/20,20517,19813,704,3.4
40115,2/1/20,13992,13582,410,2.9
40117,2/1/20,7296,7041,255,3.5
40119,2/1/20,37727,36739,988,2.6
40121,2/1/20,16946,16233,713,4.2
40123,2/1/20,19464,18937,527,2.7
40125,2/1/20,32411,31359,1052,3.2
40127,2/1/20,4262,4041,221,5.2
40129,2/1/20,1827,1769,58,3.2
40131,2/1/20,44800,43514,1286,2.9
40133,2/1/20,9484,9062,422,4.4
40135,2/1/20,16169,15520,649,4
40137,2/1/20,18410,17634,776,4.2
40139,2/1/20,11641,11444,197,1.7
40141,2/1/20,2944,2851,93,3.2
40143,2/1/20,321107,311849,9258,2.9
40145,2/1/20,37734,36617,1117,3
40147,2/1/20,22033,21350,683,3.1
40149,2/1/20,5128,4934,194,3.8
40151,2/1/20,4604,4529,75,1.6
40153,2/1/20,8742,8468,274,3.1
41001,2/1/20,7007,6633,374,5.3
41003,2/1/20,49165,47799,1366,2.8
41005,2/1/20,220005,212657,7348,3.3
41007,2/1/20,18858,18119,739,3.9
41009,2/1/20,24614,23492,1122,4.6
41011,2/1/20,26106,24896,1210,4.6
41013,2/1/20,9509,8966,543,5.7
41015,2/1/20,8675,8202,473,5.5
41017,2/1/20,95545,91639,3906,4.1
41019,2/1/20,46167,43920,2247,4.9
41021,2/1/20,904,852,52,5.8
41023,2/1/20,3065,2776,289,9.4
41025,2/1/20,3445,3229,216,6.3
41027,2/1/20,13378,12968,410,3.1
41029,2/1/20,102457,97889,4568,4.5
41031,2/1/20,9968,9395,573,5.7
41033,2/1/20,35658,33848,1810,5.1
41035,2/1/20,28539,26409,2130,7.5
41037,2/1/20,3522,3338,184,5.2
41039,2/1/20,181565,174499,7066,3.9
41041,2/1/20,20318,19381,937,4.6
41043,2/1/20,58835,56338,2497,4.2
41045,2/1/20,12136,11586,550,4.5
41047,2/1/20,161123,154679,6444,4
41049,2/1/20,5586,5329,257,4.6
41051,2/1/20,457070,442361,14709,3.2
41053,2/1/20,39786,38187,1599,4
41055,2/1/20,933,885,48,5.1
41057,2/1/20,11677,11199,478,4.1
41059,2/1/20,35720,33878,1842,5.2
41061,2/1/20,11840,11184,656,5.5
41063,2/1/20,3260,3020,240,7.4
41065,2/1/20,12250,11664,586,4.8
41067,2/1/20,326045,316467,9578,2.9
41069,2/1/20,742,715,27,3.6
41071,2/1/20,54821,52976,1845,3.4
42001,2/1/20,55530,53405,2125,3.8
42003,2/1/20,653843,623137,30706,4.7
42005,2/1/20,33018,30646,2372,7.2
42007,2/1/20,85267,80365,4902,5.7
42009,2/1/20,23988,22375,1613,6.7
42011,2/1/20,219141,208261,10880,5
42013,2/1/20,59624,56430,3194,5.4
42015,2/1/20,29090,27484,1606,5.5
42017,2/1/20,346768,331291,15477,4.5
42019,2/1/20,101028,96055,4973,4.9
42021,2/1/20,58729,54970,3759,6.4
42023,2/1/20,2053,1888,165,8
42025,2/1/20,32552,30533,2019,6.2
42027,2/1/20,84354,81208,3146,3.7
42029,2/1/20,286237,276243,9994,3.5
42031,2/1/20,17411,16293,1118,6.4
42033,2/1/20,36896,34318,2578,7
42035,2/1/20,18640,17365,1275,6.8
42037,2/1/20,34308,32387,1921,5.6
42039,2/1/20,38632,36302,2330,6
42041,2/1/20,133228,128174,5054,3.8
42043,2/1/20,145593,139089,6504,4.5
42045,2/1/20,303488,290146,13342,4.4
42047,2/1/20,15470,14435,1035,6.7
42049,2/1/20,129882,122423,7459,5.7
42051,2/1/20,58431,53847,4584,7.8
42053,2/1/20,1822,1648,174,9.5
42055,2/1/20,79314,75601,3713,4.7
42057,2/1/20,8338,7697,641,7.7
42059,2/1/20,16921,15806,1115,6.6
42061,2/1/20,20451,18729,1722,8.4
42063,2/1/20,39975,37491,2484,6.2
42065,2/1/20,20723,19434,1289,6.2
42067,2/1/20,12811,12084,727,5.7
42069,2/1/20,105993,100078,5915,5.6
42071,2/1/20,287211,276006,11205,3.9
42073,2/1/20,41092,37992,3100,7.5
42075,2/1/20,73302,70001,3301,4.5
42077,2/1/20,194272,184812,9460,4.9
42079,2/1/20,159306,148749,10557,6.6
42081,2/1/20,57374,53865,3509,6.1
42083,2/1/20,17502,16239,1263,7.2
42085,2/1/20,48982,46065,2917,6
42087,2/1/20,21380,20133,1247,5.8
42089,2/1/20,84686,79450,5236,6.2
42091,2/1/20,457239,439436,17803,3.9
42093,2/1/20,9285,8915,370,4
42095,2/1/20,162939,154766,8173,5
42097,2/1/20,42846,39949,2897,6.8
42099,2/1/20,24799,23635,1164,4.7
42101,2/1/20,741171,697676,43495,5.9
42103,2/1/20,25554,23853,1701,6.7
42105,2/1/20,7299,6645,654,9
42107,2/1/20,67027,62947,4080,6.1
42109,2/1/20,20550,19384,1166,5.7
42111,2/1/20,34435,32032,2403,7
42113,2/1/20,2628,2450,178,6.8
42115,2/1/20,20674,19446,1228,5.9
42117,2/1/20,19412,18035,1377,7.1
42119,2/1/20,19896,19030,866,4.4
42121,2/1/20,22389,20917,1472,6.6
42123,2/1/20,19007,17875,1132,6
42125,2/1/20,108535,102453,6082,5.6
42127,2/1/20,22256,20708,1548,7
42129,2/1/20,183512,173276,10236,5.6
42131,2/1/20,13785,12929,856,6.2
42133,2/1/20,237712,227258,10454,4.4
44001,2/1/20,26104,25251,853,3.3
44003,2/1/20,91238,87903,3335,3.7
44005,2/1/20,44665,42949,1716,3.8
44007,2/1/20,326887,313239,13648,4.2
44009,2/1/20,69123,66542,2581,3.7
45001,2/1/20,10143,9770,373,3.7
45003,2/1/20,75735,73409,2326,3.1
45005,2/1/20,2707,2532,175,6.5
45007,2/1/20,92454,89784,2670,2.9
45009,2/1/20,5015,4727,288,5.7
45011,2/1/20,8280,7896,384,4.6
45013,2/1/20,78974,76769,2205,2.8
45015,2/1/20,105158,102298,2860,2.7
45017,2/1/20,6684,6451,233,3.5
45019,2/1/20,214408,209190,5218,2.4
45021,2/1/20,25344,24485,859,3.4
45023,2/1/20,13629,13035,594,4.4
45025,2/1/20,22321,21623,698,3.1
45027,2/1/20,12808,12274,534,4.2
45029,2/1/20,16916,16342,574,3.4
45031,2/1/20,30396,29356,1040,3.4
45033,2/1/20,13317,12741,576,4.3
45035,2/1/20,78975,76913,2062,2.6
45037,2/1/20,10875,10548,327,3
45039,2/1/20,9744,9297,447,4.6
45041,2/1/20,67088,65034,2054,3.1
45043,2/1/20,25777,24695,1082,4.2
45045,2/1/20,258298,251534,6764,2.6
45047,2/1/20,31599,30496,1103,3.5
45049,2/1/20,8472,8223,249,2.9
45051,2/1/20,147419,141180,6239,4.2
45053,2/1/20,12985,12640,345,2.7
45055,2/1/20,29755,28753,1002,3.4
45057,2/1/20,41995,40478,1517,3.6
45059,2/1/20,30665,29671,994,3.2
45061,2/1/20,6722,6367,355,5.3
45063,2/1/20,152154,148400,3754,2.5
45065,2/1/20,3449,3306,143,4.1
45067,2/1/20,12953,12366,587,4.5
45069,2/1/20,9230,8795,435,4.7
45071,2/1/20,19374,18824,550,2.8
45073,2/1/20,35434,34391,1043,2.9
45075,2/1/20,35576,33885,1691,4.8
45077,2/1/20,58269,56552,1717,2.9
45079,2/1/20,201083,195349,5734,2.9
45081,2/1/20,9055,8802,253,2.8
45083,2/1/20,154912,150637,4275,2.8
45085,2/1/20,44385,42756,1629,3.7
45087,2/1/20,11823,11367,456,3.9
45089,2/1/20,12134,11538,596,4.9
45091,2/1/20,142501,138426,4075,2.9
46003,2/1/20,1469,1427,42,2.9
46005,2/1/20,9503,9189,314,3.3
46007,2/1/20,1072,1012,60,5.6
46009,2/1/20,2821,2722,99,3.5
46011,2/1/20,19468,18866,602,3.1
46013,2/1/20,20724,20036,688,3.3
46015,2/1/20,2356,2277,79,3.4
46017,2/1/20,665,621,44,6.6
46019,2/1/20,4965,4778,187,3.8
46021,2/1/20,768,736,32,4.2
46023,2/1/20,3633,3506,127,3.5
46025,2/1/20,1886,1796,90,4.8
46027,2/1/20,7824,7612,212,2.7
46029,2/1/20,15517,14993,524,3.4
46031,2/1/20,1346,1274,72,5.3
46033,2/1/20,4000,3788,212,5.3
46035,2/1/20,10979,10615,364,3.3
46037,2/1/20,2748,2573,175,6.4
46039,2/1/20,2120,1956,164,7.7
46041,2/1/20,2169,2030,139,6.4
46043,2/1/20,1566,1506,60,3.8
46045,2/1/20,2012,1950,62,3.1
46047,2/1/20,2883,2745,138,4.8
46049,2/1/20,1021,982,39,3.8
46051,2/1/20,4423,4185,238,5.4
46053,2/1/20,1978,1904,74,3.7
46055,2/1/20,1029,995,34,3.3
46057,2/1/20,3281,3166,115,3.5
46059,2/1/20,1741,1693,48,2.8
46061,2/1/20,1736,1628,108,6.2
46063,2/1/20,706,688,18,2.5
46065,2/1/20,9925,9609,316,3.2
46067,2/1/20,3597,3445,152,4.2
46069,2/1/20,683,658,25,3.7
46071,2/1/20,1116,1047,69,6.2
46073,2/1/20,1088,1062,26,2.4
46075,2/1/20,502,483,19,3.8
46077,2/1/20,2615,2516,99,3.8
46079,2/1/20,6733,6505,228,3.4
46081,2/1/20,13395,12996,399,3
46083,2/1/20,34838,33876,962,2.8
46085,2/1/20,1601,1518,83,5.2
46087,2/1/20,3085,2979,106,3.4
46089,2/1/20,989,938,51,5.2
46091,2/1/20,2327,2198,129,5.5
46093,2/1/20,14098,13581,517,3.7
46095,2/1/20,727,683,44,6.1
46097,2/1/20,1159,1124,35,3
46099,2/1/20,114217,110463,3754,3.3
46101,2/1/20,3975,3820,155,3.9
46102,2/1/20,3543,3250,293,8.3
46103,2/1/20,56799,54717,2082,3.7
46105,2/1/20,1397,1351,46,3.3
46107,2/1/20,983,949,34,3.5
46109,2/1/20,4872,4565,307,6.3
46111,2/1/20,1142,1100,42,3.7
46115,2/1/20,3145,2995,150,4.8
46117,2/1/20,1832,1756,76,4.1
46119,2/1/20,775,754,21,2.7
46121,2/1/20,3136,2938,198,6.3
46123,2/1/20,2966,2876,90,3
46125,2/1/20,4720,4538,182,3.9
46127,2/1/20,8591,8272,319,3.7
46129,2/1/20,2104,1952,152,7.2
46135,2/1/20,11959,11587,372,3.1
46137,2/1/20,903,869,34,3.8
47001,2/1/20,34916,33577,1339,3.8
47003,2/1/20,21279,20407,872,4.1
47005,2/1/20,6994,6599,395,5.6
47007,2/1/20,4444,4179,265,6
47009,2/1/20,64379,61936,2443,3.8
47011,2/1/20,53296,51330,1966,3.7
47013,2/1/20,15049,14257,792,5.3
47015,2/1/20,6748,6534,214,3.2
47017,2/1/20,12160,11517,643,5.3
47019,2/1/20,23998,22930,1068,4.5
47021,2/1/20,22348,21695,653,2.9
47023,2/1/20,8648,8331,317,3.7
47025,2/1/20,13228,12595,633,4.8
47027,2/1/20,2780,2576,204,7.3
47029,2/1/20,15038,14072,966,6.4
47031,2/1/20,25891,24845,1046,4
47033,2/1/20,7213,6884,329,4.6
47035,2/1/20,23920,22417,1503,6.3
47037,2/1/20,412072,400902,11170,2.7
47039,2/1/20,4591,4316,275,6
47041,2/1/20,7818,7435,383,4.9
47043,2/1/20,27625,26735,890,3.2
47045,2/1/20,16671,15799,872,5.2
47047,2/1/20,19405,18684,721,3.7
47049,2/1/20,7639,7278,361,4.7
47051,2/1/20,20725,19873,852,4.1
47053,2/1/20,22400,21348,1052,4.7
47055,2/1/20,15261,14514,747,4.9
47057,2/1/20,9715,9236,479,4.9
47059,2/1/20,29598,28039,1559,5.3
47061,2/1/20,5111,4869,242,4.7
47063,2/1/20,28688,27424,1264,4.4
47065,2/1/20,186076,179377,6699,3.6
47067,2/1/20,2165,2021,144,6.7
47069,2/1/20,9631,9096,535,5.6
47071,2/1/20,10599,10022,577,5.4
47073,2/1/20,23831,22677,1154,4.8
47075,2/1/20,7853,7456,397,5.1
47077,2/1/20,12434,11795,639,5.1
47079,2/1/20,14318,13544,774,5.4
47081,2/1/20,11715,11314,401,3.4
47083,2/1/20,3374,3162,212,6.3
47085,2/1/20,9022,8589,433,4.8
47087,2/1/20,4765,4496,269,5.6
47089,2/1/20,25196,23996,1200,4.8
47091,2/1/20,7781,7438,343,4.4
47093,2/1/20,246029,238268,7761,3.2
47095,2/1/20,1788,1672,116,6.5
47097,2/1/20,9879,9312,567,5.7
47099,2/1/20,19628,18786,842,4.3
47101,2/1/20,5230,5016,214,4.1
47103,2/1/20,16487,15295,1192,7.2
47105,2/1/20,23862,22964,898,3.8
47107,2/1/20,24233,23223,1010,4.2
47109,2/1/20,8686,8153,533,6.1
47111,2/1/20,11684,11287,397,3.4
47113,2/1/20,49280,47390,1890,3.8
47115,2/1/20,12667,12056,611,4.8
47117,2/1/20,15814,15197,617,3.9
47119,2/1/20,50468,48835,1633,3.2
47121,2/1/20,5246,4977,269,5.1
47123,2/1/20,20320,19474,846,4.2
47125,2/1/20,87398,83813,3585,4.1
47127,2/1/20,3706,3584,122,3.3
47129,2/1/20,8036,7643,393,4.9
47131,2/1/20,12695,12040,655,5.2
47133,2/1/20,10284,9803,481,4.7
47135,2/1/20,3127,2943,184,5.9
47137,2/1/20,2378,2252,126,5.3
47139,2/1/20,7733,7382,351,4.5
47141,2/1/20,35460,34087,1373,3.9
47143,2/1/20,13671,12871,800,5.9
47145,2/1/20,23745,22629,1116,4.7
47147,2/1/20,39007,37795,1212,3.1
47149,2/1/20,187941,182711,5230,2.8
47151,2/1/20,8307,7884,423,5.1
47153,2/1/20,6290,5993,297,4.7
47155,2/1/20,53001,49735,3266,6.2
47157,2/1/20,448202,428604,19598,4.4
47159,2/1/20,9705,9378,327,3.4
47161,2/1/20,5629,5336,293,5.2
47163,2/1/20,70247,67309,2938,4.2
47165,2/1/20,104522,101430,3092,3
47167,2/1/20,28491,27243,1248,4.4
47169,2/1/20,5561,5377,184,3.3
47171,2/1/20,7254,6793,461,6.4
47173,2/1/20,7693,7364,329,4.3
47175,2/1/20,2063,1953,110,5.3
47177,2/1/20,16638,15873,765,4.6
47179,2/1/20,60450,58053,2397,4
47181,2/1/20,6300,5945,355,5.6
47183,2/1/20,16338,15695,643,3.9
47185,2/1/20,12351,11838,513,4.2
47187,2/1/20,130950,127581,3369,2.6
47189,2/1/20,78389,76076,2313,3
48001,2/1/20,24199,23492,707,2.9
48003,2/1/20,10002,9757,245,2.4
48005,2/1/20,36097,34569,1528,4.2
48007,2/1/20,9472,9057,415,4.4
48009,2/1/20,4162,4038,124,3
48011,2/1/20,944,915,29,3.1
48013,2/1/20,22089,21274,815,3.7
48015,2/1/20,14361,13850,511,3.6
48017,2/1/20,2460,2368,92,3.7
48019,2/1/20,10237,9905,332,3.2
48021,2/1/20,43768,42487,1281,2.9
48023,2/1/20,1784,1737,47,2.6
48025,2/1/20,9938,9459,479,4.8
48027,2/1/20,146172,140688,5484,3.8
48029,2/1/20,965548,935392,30156,3.1
48031,2/1/20,6651,6494,157,2.4
48033,2/1/20,429,419,10,2.3
48035,2/1/20,8412,8109,303,3.6
48037,2/1/20,40277,38570,1707,4.2
48039,2/1/20,183026,175105,7921,4.3
48041,2/1/20,123495,120249,3246,2.6
48043,2/1/20,4249,4127,122,2.9
48045,2/1/20,570,548,22,3.9
48047,2/1/20,2686,2540,146,5.4
48049,2/1/20,15650,15038,612,3.9
48051,2/1/20,8707,8401,306,3.5
48053,2/1/20,23887,23225,662,2.8
48055,2/1/20,20060,19414,646,3.2
48057,2/1/20,12394,11982,412,3.3
48059,2/1/20,6218,6025,193,3.1
48061,2/1/20,169601,159781,9820,5.8
48063,2/1/20,5031,4808,223,4.4
48065,2/1/20,3056,2967,89,2.9
48067,2/1/20,12464,11912,552,4.4
48069,2/1/20,3432,3336,96,2.8
48071,2/1/20,19861,18940,921,4.6
48073,2/1/20,21024,20160,864,4.1
48075,2/1/20,2915,2829,86,3
48077,2/1/20,4944,4798,146,3
48079,2/1/20,1128,1085,43,3.8
48081,2/1/20,1464,1422,42,2.9
48083,2/1/20,2876,2745,131,4.6
48085,2/1/20,575019,557811,17208,3
48087,2/1/20,1138,1098,40,3.5
48089,2/1/20,9906,9571,335,3.4
48091,2/1/20,74589,72366,2223,3
48093,2/1/20,5642,5437,205,3.6
48095,2/1/20,1352,1314,38,2.8
48097,2/1/20,20005,19378,627,3.1
48099,2/1/20,24506,23560,946,3.9
48101,2/1/20,547,521,26,4.8
48103,2/1/20,1558,1481,77,4.9
48105,2/1/20,1647,1577,70,4.3
48107,2/1/20,2499,2409,90,3.6
48109,2/1/20,1048,1013,35,3.3
48111,2/1/20,3883,3800,83,2.1
48113,2/1/20,1391595,1345276,46319,3.3
48115,2/1/20,4746,4540,206,4.3
48117,2/1/20,8523,8285,238,2.8
48119,2/1/20,2466,2376,90,3.6
48121,2/1/20,504760,490095,14665,2.9
48123,2/1/20,9952,9689,263,2.6
48125,2/1/20,669,641,28,4.2
48127,2/1/20,7500,7290,210,2.8
48129,2/1/20,1393,1347,46,3.3
48131,2/1/20,4935,4678,257,5.2
48133,2/1/20,8170,7881,289,3.5
48135,2/1/20,87979,85051,2928,3.3
48137,2/1/20,1145,1121,24,2.1
48139,2/1/20,94564,91705,2859,3
48141,2/1/20,369281,355091,14190,3.8
48143,2/1/20,21224,20516,708,3.3
48145,2/1/20,6654,6424,230,3.5
48147,2/1/20,17649,17173,476,2.7
48149,2/1/20,12114,11791,323,2.7
48151,2/1/20,1620,1575,45,2.8
48153,2/1/20,2578,2443,135,5.2
48155,2/1/20,589,572,17,2.9
48157,2/1/20,399429,385518,13911,3.5
48159,2/1/20,4675,4515,160,3.4
48161,2/1/20,6435,6108,327,5.1
48163,2/1/20,10489,10195,294,2.8
48165,2/1/20,10004,9742,262,2.6
48167,2/1/20,168425,161671,6754,4
48169,2/1/20,2188,2120,68,3.1
48171,2/1/20,13608,13259,349,2.6
48173,2/1/20,791,774,17,2.1
48175,2/1/20,3272,3148,124,3.8
48177,2/1/20,9714,9429,285,2.9
48179,2/1/20,8092,7768,324,4
48181,2/1/20,64444,62366,2078,3.2
48183,2/1/20,58054,55703,2351,4
48185,2/1/20,11360,10891,469,4.1
48187,2/1/20,82783,80417,2366,2.9
48189,2/1/20,12007,11469,538,4.5
48191,2/1/20,1054,1005,49,4.6
48193,2/1/20,3677,3556,121,3.3
48195,2/1/20,2733,2672,61,2.2
48197,2/1/20,1735,1685,50,2.9
48199,2/1/20,25505,24368,1137,4.5
48201,2/1/20,2360924,2269233,91691,3.9
48203,2/1/20,29536,28287,1249,4.2
48205,2/1/20,2794,2745,49,1.8
48207,2/1/20,2286,2211,75,3.3
48209,2/1/20,122377,119078,3299,2.7
48211,2/1/20,1882,1819,63,3.3
48213,2/1/20,36938,35608,1330,3.6
48215,2/1/20,362715,338363,24352,6.7
48217,2/1/20,16568,16006,562,3.4
48219,2/1/20,11294,10945,349,3.1
48221,2/1/20,28140,27143,997,3.5
48223,2/1/20,17652,17086,566,3.2
48225,2/1/20,10360,10019,341,3.3
48227,2/1/20,14194,13739,455,3.2
48229,2/1/20,1851,1773,78,4.2
48231,2/1/20,44314,42743,1571,3.5
48233,2/1/20,8757,8345,412,4.7
48235,2/1/20,768,749,19,2.5
48237,2/1/20,3419,3273,146,4.3
48239,2/1/20,7703,7458,245,3.2
48241,2/1/20,12853,11999,854,6.6
48243,2/1/20,1002,970,32,3.2
48245,2/1/20,107914,101626,6288,5.8
48247,2/1/20,1868,1780,88,4.7
48249,2/1/20,16871,15988,883,5.2
48251,2/1/20,83824,81089,2735,3.3
48253,2/1/20,5807,5576,231,4
48255,2/1/20,7437,7248,189,2.5
48257,2/1/20,65983,63795,2188,3.3
48259,2/1/20,22511,21889,622,2.8
48261,2/1/20,204,197,7,3.4
48263,2/1/20,486,471,15,3.1
48265,2/1/20,22505,21780,725,3.2
48267,2/1/20,1817,1757,60,3.3
48269,2/1/20,238,232,6,2.5
48271,2/1/20,1400,1339,61,4.4
48273,2/1/20,13675,13060,615,4.5
48275,2/1/20,1428,1377,51,3.6
48277,2/1/20,24484,23684,800,3.3
48279,2/1/20,5382,5179,203,3.8
48281,2/1/20,9367,9055,312,3.3
48283,2/1/20,4430,4294,136,3.1
48285,2/1/20,8425,8180,245,2.9
48287,2/1/20,10078,9801,277,2.7
48289,2/1/20,6354,6056,298,4.7
48291,2/1/20,33842,31992,1850,5.5
48293,2/1/20,8729,8374,355,4.1
48295,2/1/20,1645,1600,45,2.7
48297,2/1/20,5705,5519,186,3.3
48299,2/1/20,8743,8444,299,3.4
48301,2/1/20,685,681,4,0.6
48303,2/1/20,158979,154606,4373,2.8
48305,2/1/20,2803,2703,100,3.6
48307,2/1/20,3323,3169,154,4.6
48309,2/1/20,121021,117078,3943,3.3
48311,2/1/20,904,890,14,1.5
48313,2/1/20,4500,4319,181,4
48315,2/1/20,4217,4017,200,4.7
48317,2/1/20,2913,2828,85,2.9
48319,2/1/20,1782,1722,60,3.4
48321,2/1/20,16755,15783,972,5.8
48323,2/1/20,24553,22196,2357,9.6
48325,2/1/20,22209,21486,723,3.3
48327,2/1/20,865,836,29,3.4
48329,2/1/20,108462,105958,2504,2.3
48331,2/1/20,9704,9263,441,4.5
48333,2/1/20,1907,1850,57,3
48335,2/1/20,2347,2270,77,3.3
48337,2/1/20,9463,9158,305,3.2
48339,2/1/20,289511,279401,10110,3.5
48341,2/1/20,10818,10549,269,2.5
48343,2/1/20,4864,4595,269,5.5
48345,2/1/20,470,453,17,3.6
48347,2/1/20,28245,27177,1068,3.8
48349,2/1/20,24470,23630,840,3.4
48351,2/1/20,5229,4898,331,6.3
48353,2/1/20,7319,7096,223,3
48355,2/1/20,168073,161038,7035,4.2
48357,2/1/20,4335,4189,146,3.4
48359,2/1/20,928,899,29,3.1
48361,2/1/20,36660,34828,1832,5
48363,2/1/20,13593,13166,427,3.1
48365,2/1/20,10229,9764,465,4.5
48367,2/1/20,68742,66645,2097,3.1
48369,2/1/20,4890,4773,117,2.4
48371,2/1/20,6392,6154,238,3.7
48373,2/1/20,18337,17412,925,5
48375,2/1/20,55911,54407,1504,2.7
48377,2/1/20,3195,2928,267,8.4
48379,2/1/20,6225,6044,181,2.9
48381,2/1/20,73044,71249,1795,2.5
48383,2/1/20,1936,1882,54,2.8
48385,2/1/20,1023,974,49,4.8
48387,2/1/20,5160,4917,243,4.7
48389,2/1/20,12557,12312,245,2
48391,2/1/20,3155,3037,118,3.7
48393,2/1/20,416,405,11,2.6
48395,2/1/20,7938,7649,289,3.6
48397,2/1/20,53140,51544,1596,3
48399,2/1/20,4633,4487,146,3.2
48401,2/1/20,23003,22076,927,4
48403,2/1/20,3698,3439,259,7
48405,2/1/20,3556,3377,179,5
48407,2/1/20,11929,11373,556,4.7
48409,2/1/20,30008,28351,1657,5.5
48411,2/1/20,2597,2505,92,3.5
48413,2/1/20,1317,1277,40,3
48415,2/1/20,6772,6513,259,3.8
48417,2/1/20,1903,1856,47,2.5
48419,2/1/20,11192,10715,477,4.3
48421,2/1/20,1387,1354,33,2.4
48423,2/1/20,107519,103804,3715,3.5
48425,2/1/20,4454,4291,163,3.7
48427,2/1/20,26392,22984,3408,12.9
48429,2/1/20,4084,3949,135,3.3
48431,2/1/20,573,554,19,3.3
48433,2/1/20,576,557,19,3.3
48435,2/1/20,1351,1298,53,3.9
48437,2/1/20,2612,2512,100,3.8
48439,2/1/20,1102921,1067597,35324,3.2
48441,2/1/20,68064,66093,1971,2.9
48443,2/1/20,370,356,14,3.8
48445,2/1/20,4899,4728,171,3.5
48447,2/1/20,642,618,24,3.7
48449,2/1/20,13197,12647,550,4.2
48451,2/1/20,54928,53285,1643,3
48453,2/1/20,756954,737623,19331,2.6
48455,2/1/20,5344,5071,273,5.1
48457,2/1/20,7207,6780,427,5.9
48459,2/1/20,17872,17115,757,4.2
48461,2/1/20,1715,1659,56,3.3
48463,2/1/20,11436,11020,416,3.6
48465,2/1/20,23296,22368,928,4
48467,2/1/20,26335,25422,913,3.5
48469,2/1/20,42805,41175,1630,3.8
48471,2/1/20,24471,23539,932,3.8
48473,2/1/20,23893,22993,900,3.8
48475,2/1/20,8004,7797,207,2.6
48477,2/1/20,15493,14989,504,3.3
48479,2/1/20,120412,115667,4745,3.9
48481,2/1/20,21862,21068,794,3.6
48483,2/1/20,2293,2219,74,3.2
48485,2/1/20,56563,54774,1789,3.2
48487,2/1/20,5000,4798,202,4
48489,2/1/20,6842,6279,563,8.2
48491,2/1/20,320549,311694,8855,2.8
48493,2/1/20,25339,24578,761,3
48495,2/1/20,4046,3912,134,3.3
48497,2/1/20,32573,31457,1116,3.4
48499,2/1/20,17951,17214,737,4.1
48501,2/1/20,3786,3652,134,3.5
48503,2/1/20,7949,7710,239,3
48505,2/1/20,4905,4602,303,6.2
48507,2/1/20,3429,3119,310,9
49001,2/1/20,2824,2739,85,3
49003,2/1/20,26156,25401,755,2.9
49005,2/1/20,65242,63761,1481,2.3
49007,2/1/20,8559,8195,364,4.3
49009,2/1/20,326,311,15,4.6
49011,2/1/20,175836,171328,4508,2.6
49013,2/1/20,7883,7508,375,4.8
49015,2/1/20,4262,4033,229,5.4
49017,2/1/20,2350,2058,292,12.4
49019,2/1/20,5722,5262,460,8
49021,2/1/20,25102,24319,783,3.1
49023,2/1/20,5879,5713,166,2.8
49025,2/1/20,3583,3448,135,3.8
49027,2/1/20,5875,5694,181,3.1
49029,2/1/20,5623,5476,147,2.6
49031,2/1/20,485,456,29,6
49033,2/1/20,961,913,48,5
49035,2/1/20,644832,627294,17538,2.7
49037,2/1/20,5583,5172,411,7.4
49039,2/1/20,12621,12168,453,3.6
49041,2/1/20,9726,9354,372,3.8
49043,2/1/20,27745,27148,597,2.2
49045,2/1/20,34515,33500,1015,2.9
49047,2/1/20,13772,13006,766,5.6
49049,2/1/20,315464,307503,7961,2.5
49051,2/1/20,17043,16579,464,2.7
49053,2/1/20,77754,75114,2640,3.4
49055,2/1/20,1307,1163,144,11
49057,2/1/20,129184,125089,4095,3.2
50001,2/1/20,20079,19538,541,2.7
50003,2/1/20,17810,17248,562,3.2
50005,2/1/20,14175,13661,514,3.6
50007,2/1/20,94466,92772,1694,1.8
50009,2/1/20,2636,2521,115,4.4
50011,2/1/20,26732,26017,715,2.7
50013,2/1/20,3988,3845,143,3.6
50015,2/1/20,13894,13377,517,3.7
50017,2/1/20,15742,15233,509,3.2
50019,2/1/20,13388,12620,768,5.7
50021,2/1/20,30070,29218,852,2.8
50023,2/1/20,34357,33489,868,2.5
50025,2/1/20,21911,21392,519,2.4
50027,2/1/20,28910,28320,590,2
51001,2/1/20,16492,15778,714,4.3
51003,2/1/20,59061,57750,1311,2.2
51005,2/1/20,6945,6655,290,4.2
51007,2/1/20,6433,6230,203,3.2
51009,2/1/20,15186,14681,505,3.3
51011,2/1/20,7249,6970,279,3.8
51013,2/1/20,158516,155674,2842,1.8
51015,2/1/20,38413,37534,879,2.3
51017,2/1/20,2527,2458,69,2.7
51019,2/1/20,38805,37683,1122,2.9
51021,2/1/20,2912,2818,94,3.2
51023,2/1/20,17667,17209,458,2.6
51025,2/1/20,6042,5758,284,4.7
51027,2/1/20,6743,6271,472,7
51029,2/1/20,6674,6364,310,4.6
51031,2/1/20,26260,25406,854,3.3
51033,2/1/20,15687,15174,513,3.3
51035,2/1/20,13560,12926,634,4.7
51036,2/1/20,3755,3631,124,3.3
51037,2/1/20,5314,5117,197,3.7
51041,2/1/20,192602,187580,5022,2.6
51043,2/1/20,7767,7593,174,2.2
51045,2/1/20,2327,2259,68,2.9
51047,2/1/20,25271,24575,696,2.8
51049,2/1/20,4716,4564,152,3.2
51051,2/1/20,4855,4560,295,6.1
51053,2/1/20,14015,13565,450,3.2
51057,2/1/20,5564,5338,226,4.1
51059,2/1/20,651766,637960,13806,2.1
51061,2/1/20,38148,37258,890,2.3
51063,2/1/20,8424,8179,245,2.9
51065,2/1/20,14400,14073,327,2.3
51067,2/1/20,26800,25963,837,3.1
51069,2/1/20,49304,48172,1132,2.3
51071,2/1/20,8156,7858,298,3.7
51073,2/1/20,19797,19271,526,2.7
51075,2/1/20,11485,11196,289,2.5
51077,2/1/20,8300,8003,297,3.6
51079,2/1/20,10844,10604,240,2.2
51081,2/1/20,4312,4167,145,3.4
51083,2/1/20,15703,15021,682,4.3
51085,2/1/20,60825,59432,1393,2.3
51087,2/1/20,186954,182060,4894,2.6
51089,2/1/20,24062,23262,800,3.3
51091,2/1/20,1207,1170,37,3.1
51093,2/1/20,19632,19085,547,2.8
51095,2/1/20,37019,36013,1006,2.7
51097,2/1/20,3932,3832,100,2.5
51099,2/1/20,13861,13495,366,2.6
51101,2/1/20,9401,9143,258,2.7
51103,2/1/20,5502,5151,351,6.4
51105,2/1/20,8382,7992,390,4.7
51107,2/1/20,228400,223501,4899,2.1
51109,2/1/20,20413,19833,580,2.8
51111,2/1/20,5350,5186,164,3.1
51113,2/1/20,7567,7407,160,2.1
51115,2/1/20,4182,4064,118,2.8
51117,2/1/20,12384,11867,517,4.2
51119,2/1/20,5331,5175,156,2.9
51121,2/1/20,51601,50236,1365,2.6
51125,2/1/20,7663,7466,197,2.6
51127,2/1/20,12808,12518,290,2.3
51131,2/1/20,5368,5081,287,5.3
51133,2/1/20,5726,5360,366,6.4
51135,2/1/20,7400,7195,205,2.8
51137,2/1/20,17733,17224,509,2.9
51139,2/1/20,12118,11462,656,5.4
51141,2/1/20,7162,6894,268,3.7
51143,2/1/20,30339,29188,1151,3.8
51145,2/1/20,14544,14165,379,2.6
51147,2/1/20,10449,10070,379,3.6
51149,2/1/20,15500,14995,505,3.3
51153,2/1/20,252271,246105,6166,2.4
51155,2/1/20,16812,16001,811,4.8
51157,2/1/20,3772,3683,89,2.4
51159,2/1/20,4139,4012,127,3.1
51161,2/1/20,50143,48831,1312,2.6
51163,2/1/20,10798,10506,292,2.7
51165,2/1/20,43359,42395,964,2.2
51167,2/1/20,11455,10888,567,4.9
51169,2/1/20,9255,8929,326,3.5
51171,2/1/20,22817,22246,571,2.5
51173,2/1/20,13896,13332,564,4.1
51175,2/1/20,9065,8822,243,2.7
51177,2/1/20,68809,66908,1901,2.8
51179,2/1/20,73978,72060,1918,2.6
51181,2/1/20,3682,3551,131,3.6
51183,2/1/20,3887,3710,177,4.6
51185,2/1/20,15785,14987,798,5.1
51187,2/1/20,20980,20388,592,2.8
51191,2/1/20,27072,26122,950,3.5
51193,2/1/20,9615,9235,380,4
51195,2/1/20,13621,12968,653,4.8
51197,2/1/20,13887,13260,627,4.5
51199,2/1/20,33107,32259,848,2.6
51510,2/1/20,104120,101966,2154,2.1
51520,2/1/20,7281,7000,281,3.9
51530,2/1/20,3715,3631,84,2.3
51540,2/1/20,27331,26744,587,2.1
51550,2/1/20,123922,120514,3408,2.8
51570,2/1/20,9026,8770,256,2.8
51580,2/1/20,2436,2293,143,5.9
51590,2/1/20,19366,18302,1064,5.5
51595,2/1/20,2285,2182,103,4.5
51600,2/1/20,13810,13528,282,2
51610,2/1/20,8811,8655,156,1.8
51620,2/1/20,3585,3443,142,4
51630,2/1/20,14503,14068,435,3
51640,2/1/20,2953,2853,100,3.4
51650,2/1/20,65109,62647,2462,3.8
51660,2/1/20,25856,25161,695,2.7
51670,2/1/20,9948,9537,411,4.1
51678,2/1/20,2118,2034,84,4
51680,2/1/20,36611,35331,1280,3.5
51683,2/1/20,22677,22103,574,2.5
51685,2/1/20,9634,9397,237,2.5
51690,2/1/20,5554,5298,256,4.6
51700,2/1/20,89958,86726,3232,3.6
51710,2/1/20,112794,109010,3784,3.4
51720,2/1/20,1715,1638,77,4.5
51730,2/1/20,13448,12652,796,5.9
51735,2/1/20,6442,6294,148,2.3
51740,2/1/20,44750,43036,1714,3.8
51750,2/1/20,8900,8607,293,3.3
51760,2/1/20,121597,117713,3884,3.2
51770,2/1/20,49942,48381,1561,3.1
51775,2/1/20,13167,12807,360,2.7
51790,2/1/20,12572,12243,329,2.6
51800,2/1/20,45089,43765,1324,2.9
51810,2/1/20,235483,229315,6168,2.6
51820,2/1/20,10993,10680,313,2.8
51830,2/1/20,6760,6505,255,3.8
51840,2/1/20,15146,14737,409,2.7
53001,2/1/20,8490,7871,619,7.3
53003,2/1/20,10652,10209,443,4.2
53005,2/1/20,105345,99538,5807,5.5
53007,2/1/20,43022,40468,2554,5.9
53009,2/1/20,29299,27390,1909,6.5
53011,2/1/20,248817,237463,11354,4.6
53013,2/1/20,1781,1673,108,6.1
53015,2/1/20,49036,46140,2896,5.9
53017,2/1/20,20982,19555,1427,6.8
53019,2/1/20,2503,2168,335,13.4
53021,2/1/20,42513,39423,3090,7.3
53023,2/1/20,814,757,57,7
53025,2/1/20,44972,41094,3878,8.6
53027,2/1/20,29438,27346,2092,7.1
53029,2/1/20,37065,35246,1819,4.9
53031,2/1/20,13315,12573,742,5.6
53033,2/1/20,1310351,1278178,32173,2.5
53035,2/1/20,133381,127725,5656,4.2
53037,2/1/20,24182,22803,1379,5.7
53039,2/1/20,9835,9187,648,6.6
53041,2/1/20,35368,33109,2259,6.4
53043,2/1/20,4752,4461,291,6.1
53045,2/1/20,26561,24911,1650,6.2
53047,2/1/20,18929,17253,1676,8.9
53049,2/1/20,8553,7983,570,6.7
53051,2/1/20,5183,4707,476,9.2
53053,2/1/20,456701,433877,22824,5
53055,2/1/20,8482,8118,364,4.3
53057,2/1/20,63548,59892,3656,5.8
53059,2/1/20,5667,5353,314,5.5
53061,2/1/20,446199,433814,12385,2.8
53063,2/1/20,262800,248010,14790,5.6
53065,2/1/20,19365,17690,1675,8.6
53067,2/1/20,148186,141197,6989,4.7
53069,2/1/20,1356,1262,94,6.9
53071,2/1/20,30292,28808,1484,4.9
53073,2/1/20,118137,112220,5917,5
53075,2/1/20,24577,23628,949,3.9
53077,2/1/20,130075,119595,10480,8.1
54001,2/1/20,7528,7016,512,6.8
54003,2/1/20,58816,56904,1912,3.3
54005,2/1/20,7538,7038,500,6.6
54007,2/1/20,5361,4841,520,9.7
54009,2/1/20,9996,9452,544,5.4
54011,2/1/20,42113,40395,1718,4.1
54013,2/1/20,2745,2218,527,19.2
54015,2/1/20,3285,2879,406,12.4
54017,2/1/20,4047,3836,211,5.2
54019,2/1/20,16436,15247,1189,7.2
54021,2/1/20,2472,2266,206,8.3
54023,2/1/20,6084,5740,344,5.7
54025,2/1/20,15965,15091,874,5.5
54027,2/1/20,11058,10630,428,3.9
54029,2/1/20,13072,12373,699,5.3
54031,2/1/20,5932,5613,319,5.4
54033,2/1/20,35043,33240,1803,5.1
54035,2/1/20,13476,12652,824,6.1
54037,2/1/20,30471,29605,866,2.8
54039,2/1/20,82625,78659,3966,4.8
54041,2/1/20,6666,6145,521,7.8
54043,2/1/20,7410,6836,574,7.7
54045,2/1/20,11554,10690,864,7.5
54047,2/1/20,4677,4155,522,11.2
54049,2/1/20,26280,24940,1340,5.1
54051,2/1/20,14190,13079,1111,7.8
54053,2/1/20,10419,9731,688,6.6
54055,2/1/20,21224,20017,1207,5.7
54057,2/1/20,12859,12136,723,5.6
54059,2/1/20,7188,6494,694,9.7
54061,2/1/20,56264,54344,1920,3.4
54063,2/1/20,6173,5835,338,5.5
54065,2/1/20,8209,7889,320,3.9
54067,2/1/20,9731,8892,839,8.6
54069,2/1/20,20968,19974,994,4.7
54071,2/1/20,3796,3642,154,4.1
54073,2/1/20,2998,2739,259,8.6
54075,2/1/20,4254,4022,232,5.5
54077,2/1/20,16129,15302,827,5.1
54079,2/1/20,27238,25987,1251,4.6
54081,2/1/20,30525,28899,1626,5.3
54083,2/1/20,12476,11618,858,6.9
54085,2/1/20,4473,4155,318,7.1
54087,2/1/20,5363,4740,623,11.6
54089,2/1/20,4374,4088,286,6.5
54091,2/1/20,8044,7603,441,5.5
54093,2/1/20,3439,3216,223,6.5
54095,2/1/20,3191,2906,285,8.9
54097,2/1/20,9770,9098,672,6.9
54099,2/1/20,16161,15185,976,6
54101,2/1/20,3450,3144,306,8.9
54103,2/1/20,6803,6193,610,9
54105,2/1/20,2403,2151,252,10.5
54107,2/1/20,37552,35386,2166,5.8
54109,2/1/20,6757,6192,565,8.4
55001,2/1/20,8029,7403,626,7.8
55003,2/1/20,7615,7158,457,6
55005,2/1/20,23987,22577,1410,5.9
55007,2/1/20,7370,6784,586,8
55009,2/1/20,141911,136991,4920,3.5
55011,2/1/20,6286,5901,385,6.1
55013,2/1/20,6958,6390,568,8.2
55015,2/1/20,27231,26341,890,3.3
55017,2/1/20,33532,31629,1903,5.7
55019,2/1/20,17334,16518,816,4.7
55021,2/1/20,31937,30605,1332,4.2
55023,2/1/20,7453,6905,548,7.4
55025,2/1/20,323269,315183,8086,2.5
55027,2/1/20,46984,45199,1785,3.8
55029,2/1/20,13775,12957,818,5.9
55031,2/1/20,23276,21868,1408,6
55033,2/1/20,24536,23373,1163,4.7
55035,2/1/20,58846,56861,1985,3.4
55037,2/1/20,2172,2048,124,5.7
55039,2/1/20,57068,55105,1963,3.4
55041,2/1/20,3959,3710,249,6.3
55043,2/1/20,27894,26657,1237,4.4
55045,2/1/20,21145,20313,832,3.9
55047,2/1/20,9028,8493,535,5.9
55049,2/1/20,13761,13173,588,4.3
55051,2/1/20,2522,2337,185,7.3
55053,2/1/20,10036,9400,636,6.3
55055,2/1/20,45772,43919,1853,4
55057,2/1/20,13311,12639,672,5
55059,2/1/20,88336,84189,4147,4.7
55061,2/1/20,10899,10488,411,3.8
55063,2/1/20,66942,64774,2168,3.2
55065,2/1/20,9987,9622,365,3.7
55067,2/1/20,9207,8692,515,5.6
55069,2/1/20,15095,14281,814,5.4
55071,2/1/20,40552,38775,1777,4.4
55073,2/1/20,73918,71513,2405,3.3
55075,2/1/20,19189,18070,1119,5.8
55077,2/1/20,7798,7299,499,6.4
55078,2/1/20,1554,1452,102,6.6
55079,2/1/20,469250,449211,20039,4.3
55081,2/1/20,23076,22190,886,3.8
55083,2/1/20,20722,19597,1125,5.4
55085,2/1/20,17145,16034,1111,6.5
55087,2/1/20,102306,98887,3419,3.3
55089,2/1/20,48917,47515,1402,2.9
55091,2/1/20,4008,3781,227,5.7
55093,2/1/20,25395,24125,1270,5
55095,2/1/20,24599,22930,1669,6.8
55097,2/1/20,38477,36967,1510,3.9
55099,2/1/20,6347,5952,395,6.2
55101,2/1/20,98029,93162,4867,5
55103,2/1/20,9005,8624,381,4.2
55105,2/1/20,85541,81590,3951,4.6
55107,2/1/20,6794,6319,475,7
55109,2/1/20,50581,48142,2439,4.8
55111,2/1/20,34786,33426,1360,3.9
55113,2/1/20,7691,7129,562,7.3
55115,2/1/20,20603,19680,923,4.5
55117,2/1/20,61140,59195,1945,3.2
55119,2/1/20,10900,10216,684,6.3
55121,2/1/20,15743,14947,796,5.1
55123,2/1/20,15042,14322,720,4.8
55125,2/1/20,9573,8989,584,6.1
55127,2/1/20,57236,54857,2379,4.2
55129,2/1/20,7654,7205,449,5.9
55131,2/1/20,77483,74950,2533,3.3
55133,2/1/20,225608,218458,7150,3.2
55135,2/1/20,25460,24457,1003,3.9
55137,2/1/20,11209,10581,628,5.6
55139,2/1/20,91222,88336,2886,3.2
55141,2/1/20,34872,33244,1628,4.7
56001,2/1/20,20671,20029,642,3.1
56003,2/1/20,5303,5010,293,5.5
56005,2/1/20,23786,22873,913,3.8
56007,2/1/20,7956,7605,351,4.4
56009,2/1/20,9062,8776,286,3.2
56011,2/1/20,3668,3552,116,3.2
56013,2/1/20,18960,17927,1033,5.4
56015,2/1/20,6633,6399,234,3.5
56017,2/1/20,2161,2064,97,4.5
56019,2/1/20,4081,3908,173,4.2
56021,2/1/20,49166,47167,1999,4.1
56023,2/1/20,8857,8485,372,4.2
56025,2/1/20,39546,37693,1853,4.7
56027,2/1/20,1227,1185,42,3.4
56029,2/1/20,14801,14068,733,5
56031,2/1/20,4554,4342,212,4.7
56033,2/1/20,15733,15053,680,4.3
56035,2/1/20,4203,3949,254,6
56037,2/1/20,21479,20316,1163,5.4
56039,2/1/20,15358,14954,404,2.6
56041,2/1/20,8783,8385,398,4.5
56043,2/1/20,3917,3720,197,5
56045,2/1/20,3829,3706,123,3.2
72001,2/1/20,4145,3378,767,18.5
72003,2/1/20,11322,10219,1103,9.7
72005,2/1/20,13724,12498,1226,8.9
72007,2/1/20,6229,5677,552,8.9
72009,2/1/20,6102,5516,586,9.6
72011,2/1/20,8398,7707,691,8.2
72013,2/1/20,22898,20843,2055,9
72015,2/1/20,4456,3834,622,14
72017,2/1/20,5621,5014,607,10.8
72019,2/1/20,6889,6351,538,7.8
72021,2/1/20,61841,58386,3455,5.6
72023,2/1/20,12884,11815,1069,8.3
72025,2/1/20,45245,42506,2739,6.1
72027,2/1/20,9070,8329,741,8.2
72029,2/1/20,15239,14303,936,6.1
72031,2/1/20,58206,55203,3003,5.2
72033,2/1/20,7399,6937,462,6.2
72035,2/1/20,15282,14301,981,6.4
72037,2/1/20,3464,3185,279,8.1
72039,2/1/20,3487,3132,355,10.2
72041,2/1/20,14641,13791,850,5.8
72043,2/1/20,9441,8346,1095,11.6
72045,2/1/20,4674,4243,431,9.2
72047,2/1/20,8383,7702,681,8.1
72049,2/1/20,849,823,26,3.1
72051,2/1/20,12498,11843,655,5.2
72053,2/1/20,10216,9363,853,8.3
72054,2/1/20,3155,2829,326,10.3
72055,2/1/20,3985,3354,631,15.8
72057,2/1/20,10306,9220,1086,10.5
72059,2/1/20,4659,3971,688,14.8
72061,2/1/20,35740,34411,1329,3.7
72063,2/1/20,17184,16255,929,5.4
72065,2/1/20,13384,11450,1934,14.5
72067,2/1/20,5050,4659,391,7.7
72069,2/1/20,16294,14760,1534,9.4
72071,2/1/20,11139,10148,991,8.9
72073,2/1/20,4049,3537,512,12.6
72075,2/1/20,14659,13392,1267,8.6
72077,2/1/20,11597,10730,867,7.5
72079,2/1/20,4936,4338,598,12.1
72081,2/1/20,6828,5694,1134,16.6
72083,2/1/20,2535,2240,295,11.6
72085,2/1/20,10661,9811,850,8
72087,2/1/20,8027,7422,605,7.5
72089,2/1/20,5822,5355,467,8
72091,2/1/20,10895,10104,791,7.3
72093,2/1/20,1874,1572,302,16.1
72095,2/1/20,2901,2391,510,17.6
72097,2/1/20,20475,18556,1919,9.4
72099,2/1/20,9937,8934,1003,10.1
72101,2/1/20,7530,6911,619,8.2
72103,2/1/20,7696,7082,614,8
72105,2/1/20,6685,6152,533,8
72107,2/1/20,4721,4192,529,11.2
72109,2/1/20,4126,3445,681,16.5
72111,2/1/20,5528,4830,698,12.6
72113,2/1/20,42914,39282,3632,8.5
72115,2/1/20,5808,5165,643,11.1
72117,2/1/20,4769,3924,845,17.7
72119,2/1/20,15993,14969,1024,6.4
72121,2/1/20,5855,5074,781,13.3
72123,2/1/20,6569,5693,876,13.3
72125,2/1/20,9184,8212,972,10.6
72127,2/1/20,127066,120870,6196,4.9
72129,2/1/20,11147,10180,967,8.7
72131,2/1/20,9828,8392,1436,14.6
72133,2/1/20,8841,8096,745,8.4
72135,2/1/20,25678,24371,1307,5.1
72137,2/1/20,27667,26236,1431,5.2
72139,2/1/20,25662,24550,1112,4.3
72141,2/1/20,6423,5630,793,12.3
72143,2/1/20,9236,8519,717,7.8
72145,2/1/20,12505,11436,1069,8.5
72147,2/1/20,2486,2338,148,6
72149,2/1/20,7334,6000,1334,18.2
72151,2/1/20,8396,7329,1067,12.7
72153,2/1/20,9718,8063,1655,17